StartTime,EndTime,quantity_B01,quantity_B16,quantity_B18,quantity_B19,total_green_energy,Load
2022-01-01 00:00:00,2022-01-01 01:00:00,511,1,1904,1189,3605,3218
2022-01-01 01:00:00,2022-01-01 02:00:00,519,1,1738,1051,3309,3126
2022-01-01 02:00:00,2022-01-01 03:00:00,558,1,1436,1048,3043,3080
2022-01-01 03:00:00,2022-01-01 04:00:00,468,1,1505,878,2852,3044
2022-01-01 04:00:00,2022-01-01 05:00:00,505,1,1391,827,2724,3130
2022-01-01 05:00:00,2022-01-01 06:00:00,554,1,1407,617,2579,3238
2022-01-01 06:00:00,2022-01-01 07:00:00,720,1,1098,474,2293,3378
2022-01-01 07:00:00,2022-01-01 08:00:00,714,12,734,346,1806,3537
2022-01-01 08:00:00,2022-01-01 09:00:00,675,45,703,232,1655,3714
2022-01-01 09:00:00,2022-01-01 10:00:00,668,67,610,256,1601,3818
2022-01-01 10:00:00,2022-01-01 11:00:00,732,62,653,385,1832,3893
2022-01-01 11:00:00,2022-01-01 12:00:00,649,40,714,501,1904,3943
2022-01-01 12:00:00,2022-01-01 13:00:00,756,20,763,577,2116,3915
2022-01-01 13:00:00,2022-01-01 14:00:00,803,3,893,799,2498,3988
2022-01-01 14:00:00,2022-01-01 15:00:00,851,1,1034,1314,3200,4213
2022-01-01 15:00:00,2022-01-01 16:00:00,875,1,1102,1793,3771,4473
2022-01-01 16:00:00,2022-01-01 17:00:00,850,1,1415,2073,4339,4407
2022-01-01 17:00:00,2022-01-01 18:00:00,838,1,1748,2205,4792,4133
2022-01-01 18:00:00,2022-01-01 19:00:00,693,1,1962,2396,5052,3970
2022-01-01 19:00:00,2022-01-01 20:00:00,545,1,2075,2476,5097,3821
2022-01-01 20:00:00,2022-01-01 21:00:00,472,1,2048,2371,4892,3619
2022-01-01 21:00:00,2022-01-01 22:00:00,415,1,2056,2275,4747,3462
2022-01-01 22:00:00,2022-01-01 23:00:00,365,1,1950,1762,4078,3351
2022-01-01 23:00:00,2022-01-02 00:00:00,361,1,1838,1760,3960,3173
2022-01-02 00:00:00,2022-01-02 01:00:00,353,1,1861,1744,3959,3128
2022-01-02 01:00:00,2022-01-02 02:00:00,384,1,1853,1494,3732,3093
2022-01-02 02:00:00,2022-01-02 03:00:00,421,1,1826,1569,3817,3063
2022-01-02 03:00:00,2022-01-02 04:00:00,344,1,1831,1638,3814,3149
2022-01-02 04:00:00,2022-01-02 05:00:00,395,1,1680,1624,3700,3260
2022-01-02 05:00:00,2022-01-02 06:00:00,423,1,1660,1579,3663,3455
2022-01-02 06:00:00,2022-01-02 07:00:00,548,1,1579,1511,3639,3722
2022-01-02 07:00:00,2022-01-02 08:00:00,575,3,1534,1385,3497,3905
2022-01-02 08:00:00,2022-01-02 09:00:00,651,16,1386,1288,3341,4097
2022-01-02 09:00:00,2022-01-02 10:00:00,710,24,1197,1046,2977,4167
2022-01-02 10:00:00,2022-01-02 11:00:00,716,30,1052,837,2635,4198
2022-01-02 11:00:00,2022-01-02 12:00:00,678,26,736,740,2180,4212
2022-01-02 12:00:00,2022-01-02 13:00:00,754,14,709,736,2213,4191
2022-01-02 13:00:00,2022-01-02 14:00:00,743,2,976,773,2494,4301
2022-01-02 14:00:00,2022-01-02 15:00:00,854,1,1289,929,3073,4521
2022-01-02 15:00:00,2022-01-02 16:00:00,861,1,1436,1280,3578,4873
2022-01-02 16:00:00,2022-01-02 17:00:00,823,1,1747,1618,4189,4735
2022-01-02 17:00:00,2022-01-02 18:00:00,810,1,1908,2078,4797,4433
2022-01-02 18:00:00,2022-01-02 19:00:00,570,1,1997,2317,4885,4183
2022-01-02 19:00:00,2022-01-02 20:00:00,495,1,1970,2262,4728,3974
2022-01-02 20:00:00,2022-01-02 21:00:00,528,1,1839,2014,4382,3769
2022-01-02 21:00:00,2022-01-02 22:00:00,467,1,1747,1733,3948,3559
2022-01-02 22:00:00,2022-01-02 23:00:00,464,1,1585,1565,3615,3394
2022-01-02 23:00:00,2022-01-03 00:00:00,432,1,1395,1596,3424,3345
2022-01-03 00:00:00,2022-01-03 01:00:00,409,1,1284,1579,3273,3308
2022-01-03 01:00:00,2022-01-03 02:00:00,381,1,1132,1783,3297,3285
2022-01-03 02:00:00,2022-01-03 03:00:00,360,1,1396,1943,3700,3361
2022-01-03 03:00:00,2022-01-03 04:00:00,486,1,1725,2100,4312,3584
2022-01-03 04:00:00,2022-01-03 05:00:00,539,1,1852,2414,4806,4201
2022-01-03 05:00:00,2022-01-03 06:00:00,722,1,1846,2464,5033,4772
2022-01-03 06:00:00,2022-01-03 07:00:00,790,1,1970,2401,5162,5079
2022-01-03 07:00:00,2022-01-03 08:00:00,809,12,2032,2900,5753,5072
2022-01-03 08:00:00,2022-01-03 09:00:00,843,38,2071,3072,6024,5190
2022-01-03 09:00:00,2022-01-03 10:00:00,841,65,2086,3280,6272,5246
2022-01-03 10:00:00,2022-01-03 11:00:00,852,83,2091,3356,6382,5134
2022-01-03 11:00:00,2022-01-03 12:00:00,800,84,2088,3418,6390,5078
2022-01-03 12:00:00,2022-01-03 13:00:00,757,59,2060,3433,6309,5043
2022-01-03 13:00:00,2022-01-03 14:00:00,813,14,2081,3470,6378,5021
2022-01-03 14:00:00,2022-01-03 15:00:00,827,1,2035,3498,6361,5200
2022-01-03 15:00:00,2022-01-03 16:00:00,840,1,2070,3571,6482,5535
2022-01-03 16:00:00,2022-01-03 17:00:00,706,1,2000,3444,6151,5326
2022-01-03 17:00:00,2022-01-03 18:00:00,725,1,2013,2844,5583,4973
2022-01-03 18:00:00,2022-01-03 19:00:00,701,1,1955,2384,5041,4586
2022-01-03 19:00:00,2022-01-03 20:00:00,816,1,1650,1984,4451,4316
2022-01-03 20:00:00,2022-01-03 21:00:00,841,1,1527,1711,4080,4040
2022-01-03 21:00:00,2022-01-03 22:00:00,688,1,1481,1522,3692,3758
2022-01-03 22:00:00,2022-01-03 23:00:00,558,1,1401,1278,3238,3577
2022-01-03 23:00:00,2022-01-04 00:00:00,597,1,1293,1042,2933,3488
2022-01-04 00:00:00,2022-01-04 01:00:00,660,1,1191,884,2736,3429
2022-01-04 01:00:00,2022-01-04 02:00:00,745,1,1176,866,2788,3454
2022-01-04 02:00:00,2022-01-04 03:00:00,825,1,1073,845,2744,3528
2022-01-04 03:00:00,2022-01-04 04:00:00,887,1,772,815,2475,3716
2022-01-04 04:00:00,2022-01-04 05:00:00,939,1,705,876,2521,4255
2022-01-04 05:00:00,2022-01-04 06:00:00,928,1,858,982,2769,4878
2022-01-04 06:00:00,2022-01-04 07:00:00,906,1,819,1000,2726,5205
2022-01-04 07:00:00,2022-01-04 08:00:00,887,19,918,1025,2849,5238
2022-01-04 08:00:00,2022-01-04 09:00:00,886,101,1021,1009,3017,5314
2022-01-04 09:00:00,2022-01-04 10:00:00,866,169,1227,1047,3309,5333
2022-01-04 10:00:00,2022-01-04 11:00:00,865,247,1436,1099,3647,5260
2022-01-04 11:00:00,2022-01-04 12:00:00,843,245,1205,1232,3525,5227
2022-01-04 12:00:00,2022-01-04 13:00:00,858,146,1308,1422,3734,5188
2022-01-04 13:00:00,2022-01-04 14:00:00,841,44,1437,1538,3860,5091
2022-01-04 14:00:00,2022-01-04 15:00:00,863,4,1251,1773,3891,5299
2022-01-04 15:00:00,2022-01-04 16:00:00,901,3,1324,1889,4117,5641
2022-01-04 16:00:00,2022-01-04 17:00:00,930,3,1608,1895,4436,5430
2022-01-04 17:00:00,2022-01-04 18:00:00,919,3,1963,2138,5023,5147
2022-01-04 18:00:00,2022-01-04 19:00:00,918,3,1957,2477,5355,4855
2022-01-04 19:00:00,2022-01-04 20:00:00,877,3,1998,2677,5555,4594
2022-01-04 20:00:00,2022-01-04 21:00:00,861,3,2049,2630,5543,4322
2022-01-04 21:00:00,2022-01-04 22:00:00,830,3,2096,2510,5439,4036
2022-01-04 22:00:00,2022-01-04 23:00:00,803,3,2026,2670,5502,3905
2022-01-04 23:00:00,2022-01-05 00:00:00,827,3,2098,2662,5590,3780
2022-01-05 00:00:00,2022-01-05 01:00:00,769,3,2053,2234,5059,3879
2022-01-05 01:00:00,2022-01-05 02:00:00,774,3,2013,2072,4862,3864
2022-01-05 02:00:00,2022-01-05 03:00:00,808,3,2060,1877,4748,3871
2022-01-05 03:00:00,2022-01-05 04:00:00,835,3,2092,1778,4708,3959
2022-01-05 04:00:00,2022-01-05 05:00:00,840,3,2040,1753,4636,4512
2022-01-05 05:00:00,2022-01-05 06:00:00,877,3,1980,1468,4328,5145
2022-01-05 06:00:00,2022-01-05 07:00:00,877,5,1943,1139,3964,5389
2022-01-05 07:00:00,2022-01-05 08:00:00,846,33,1938,875,3692,5428
2022-01-05 08:00:00,2022-01-05 09:00:00,859,115,1954,924,3852,5469
2022-01-05 09:00:00,2022-01-05 10:00:00,889,187,1859,1178,4113,5472
2022-01-05 10:00:00,2022-01-05 11:00:00,902,177,1804,1458,4341,5433
2022-01-05 11:00:00,2022-01-05 12:00:00,898,118,1788,1806,4610,5414
2022-01-05 12:00:00,2022-01-05 13:00:00,886,59,1959,1924,4828,5362
2022-01-05 13:00:00,2022-01-05 14:00:00,853,23,1924,1755,4555,5284
2022-01-05 14:00:00,2022-01-05 15:00:00,907,3,1707,1707,4324,5458
2022-01-05 15:00:00,2022-01-05 16:00:00,921,3,1614,1829,4367,5818
2022-01-05 16:00:00,2022-01-05 17:00:00,843,3,1521,1917,4284,5596
2022-01-05 17:00:00,2022-01-05 18:00:00,831,3,1638,1950,4422,5287
2022-01-05 18:00:00,2022-01-05 19:00:00,785,3,1783,1803,4374,5031
2022-01-05 19:00:00,2022-01-05 20:00:00,806,3,1820,1575,4204,4844
2022-01-05 20:00:00,2022-01-05 21:00:00,803,3,1631,1443,3880,4572
2022-01-05 21:00:00,2022-01-05 22:00:00,865,3,1645,1380,3893,4315
2022-01-05 22:00:00,2022-01-05 23:00:00,834,3,1933,1262,4032,4051
2022-01-05 23:00:00,2022-01-06 00:00:00,839,3,1874,1100,3816,3967
2022-01-06 00:00:00,2022-01-06 01:00:00,833,3,1686,954,3476,3895
2022-01-06 01:00:00,2022-01-06 02:00:00,839,3,1504,739,3085,3864
2022-01-06 02:00:00,2022-01-06 03:00:00,838,3,1387,569,2797,3941
2022-01-06 03:00:00,2022-01-06 04:00:00,847,3,1161,435,2446,4163
2022-01-06 04:00:00,2022-01-06 05:00:00,869,3,898,308,2078,4765
2022-01-06 05:00:00,2022-01-06 06:00:00,854,3,810,242,1909,5371
2022-01-06 06:00:00,2022-01-06 07:00:00,882,5,797,235,1919,5633
2022-01-06 07:00:00,2022-01-06 08:00:00,921,78,650,292,1941,5608
2022-01-06 08:00:00,2022-01-06 09:00:00,898,275,512,379,2064,5592
2022-01-06 09:00:00,2022-01-06 10:00:00,883,449,400,291,2023,5447
2022-01-06 10:00:00,2022-01-06 11:00:00,868,498,348,197,1911,5326
2022-01-06 11:00:00,2022-01-06 12:00:00,869,418,354,166,1807,5293
2022-01-06 12:00:00,2022-01-06 13:00:00,875,196,332,226,1629,5205
2022-01-06 13:00:00,2022-01-06 14:00:00,841,50,295,317,1503,5163
2022-01-06 14:00:00,2022-01-06 15:00:00,848,4,379,493,1724,5410
2022-01-06 15:00:00,2022-01-06 16:00:00,831,3,504,649,1987,5817
2022-01-06 16:00:00,2022-01-06 17:00:00,834,3,743,782,2362,5655
2022-01-06 17:00:00,2022-01-06 18:00:00,820,3,962,942,2727,5309
2022-01-06 18:00:00,2022-01-06 19:00:00,827,3,1127,1059,3016,5009
2022-01-06 19:00:00,2022-01-06 20:00:00,842,3,1235,1142,3222,4730
2022-01-06 20:00:00,2022-01-06 21:00:00,835,3,1335,1351,3524,4498
2022-01-06 21:00:00,2022-01-06 22:00:00,826,3,1446,1463,3738,4232
2022-01-06 22:00:00,2022-01-06 23:00:00,826,3,1556,1645,4030,3987
2022-01-06 23:00:00,2022-01-07 00:00:00,826,3,1737,1827,4393,3853
2022-01-07 00:00:00,2022-01-07 01:00:00,821,3,1774,2081,4679,3869
2022-01-07 01:00:00,2022-01-07 02:00:00,833,3,1958,2433,5227,3872
2022-01-07 02:00:00,2022-01-07 03:00:00,816,3,2029,2630,5478,3852
2022-01-07 03:00:00,2022-01-07 04:00:00,807,3,2040,2728,5578,4171
2022-01-07 04:00:00,2022-01-07 05:00:00,821,3,2064,2853,5741,4794
2022-01-07 05:00:00,2022-01-07 06:00:00,862,3,2055,2741,5661,5394
2022-01-07 06:00:00,2022-01-07 07:00:00,927,3,1968,2445,5343,5609
2022-01-07 07:00:00,2022-01-07 08:00:00,864,8,1583,2243,4698,5619
2022-01-07 08:00:00,2022-01-07 09:00:00,864,46,1845,1908,4663,5591
2022-01-07 09:00:00,2022-01-07 10:00:00,843,84,1869,1804,4600,5597
2022-01-07 10:00:00,2022-01-07 11:00:00,839,142,1880,1619,4480,5519
2022-01-07 11:00:00,2022-01-07 12:00:00,841,191,1917,1546,4495,5388
2022-01-07 12:00:00,2022-01-07 13:00:00,843,98,1714,1455,4110,5191
2022-01-07 13:00:00,2022-01-07 14:00:00,837,18,1687,1371,3913,5138
2022-01-07 14:00:00,2022-01-07 15:00:00,860,4,1386,1340,3590,5283
2022-01-07 15:00:00,2022-01-07 16:00:00,910,3,1259,1160,3332,5579
2022-01-07 16:00:00,2022-01-07 17:00:00,929,3,1297,1304,3533,5438
2022-01-07 17:00:00,2022-01-07 18:00:00,883,3,1588,1315,3789,5066
2022-01-07 18:00:00,2022-01-07 19:00:00,860,3,1566,1280,3709,4717
2022-01-07 19:00:00,2022-01-07 20:00:00,856,3,1459,1189,3507,4432
2022-01-07 20:00:00,2022-01-07 21:00:00,846,3,1390,1136,3375,4267
2022-01-07 21:00:00,2022-01-07 22:00:00,852,3,1452,1156,3463,3991
2022-01-07 22:00:00,2022-01-07 23:00:00,845,3,1194,1263,3305,3824
2022-01-07 23:00:00,2022-01-08 00:00:00,848,3,1016,1229,3096,3685
2022-01-08 00:00:00,2022-01-08 01:00:00,850,3,987,1333,3173,3584
2022-01-08 01:00:00,2022-01-08 02:00:00,852,3,1249,1450,3554,3533
2022-01-08 02:00:00,2022-01-08 03:00:00,831,3,1098,1542,3474,3529
2022-01-08 03:00:00,2022-01-08 04:00:00,856,3,1115,1680,3654,3600
2022-01-08 04:00:00,2022-01-08 05:00:00,848,3,1559,1780,4190,3788
2022-01-08 05:00:00,2022-01-08 06:00:00,860,3,1749,1970,4582,4014
2022-01-08 06:00:00,2022-01-08 07:00:00,863,4,1756,2036,4659,4328
2022-01-08 07:00:00,2022-01-08 08:00:00,899,20,1839,1858,4616,4580
2022-01-08 08:00:00,2022-01-08 09:00:00,916,149,1848,1795,4708,4783
2022-01-08 09:00:00,2022-01-08 10:00:00,907,228,1671,1466,4272,4768
2022-01-08 10:00:00,2022-01-08 11:00:00,925,250,1672,1186,4033,4645
2022-01-08 11:00:00,2022-01-08 12:00:00,921,224,1753,1015,3913,4578
2022-01-08 12:00:00,2022-01-08 13:00:00,913,140,1652,946,3651,4535
2022-01-08 13:00:00,2022-01-08 14:00:00,930,41,1717,904,3592,4581
2022-01-08 14:00:00,2022-01-08 15:00:00,924,4,1775,889,3592,4834
2022-01-08 15:00:00,2022-01-08 16:00:00,925,3,1687,985,3600,5239
2022-01-08 16:00:00,2022-01-08 17:00:00,908,3,1669,1191,3771,5146
2022-01-08 17:00:00,2022-01-08 18:00:00,934,4,1699,1427,4064,4788
2022-01-08 18:00:00,2022-01-08 19:00:00,927,4,1744,1509,4184,4523
2022-01-08 19:00:00,2022-01-08 20:00:00,842,4,1797,1609,4252,4330
2022-01-08 20:00:00,2022-01-08 21:00:00,837,4,1773,1760,4374,4159
2022-01-08 21:00:00,2022-01-08 22:00:00,842,3,1853,1928,4626,3981
2022-01-08 22:00:00,2022-01-08 23:00:00,829,3,1954,2041,4827,3915
2022-01-08 23:00:00,2022-01-09 00:00:00,820,4,2008,2159,4991,3813
2022-01-09 00:00:00,2022-01-09 01:00:00,742,4,2057,2170,4973,3723
2022-01-09 01:00:00,2022-01-09 02:00:00,743,4,2105,2091,4943,3759
2022-01-09 02:00:00,2022-01-09 03:00:00,817,3,2096,2033,4949,3755
2022-01-09 03:00:00,2022-01-09 04:00:00,835,3,2090,1960,4888,3805
2022-01-09 04:00:00,2022-01-09 05:00:00,836,4,2046,1882,4768,3892
2022-01-09 05:00:00,2022-01-09 06:00:00,844,4,2000,1778,4626,4045
2022-01-09 06:00:00,2022-01-09 07:00:00,848,4,1946,1698,4496,4322
2022-01-09 07:00:00,2022-01-09 08:00:00,918,11,1829,1552,4310,4486
2022-01-09 08:00:00,2022-01-09 09:00:00,858,33,1629,1413,3933,4651
2022-01-09 09:00:00,2022-01-09 10:00:00,852,67,1481,1294,3694,4716
2022-01-09 10:00:00,2022-01-09 11:00:00,857,83,1263,1175,3378,4724
2022-01-09 11:00:00,2022-01-09 12:00:00,909,70,1100,1075,3154,4655
2022-01-09 12:00:00,2022-01-09 13:00:00,915,43,998,1036,2992,4602
2022-01-09 13:00:00,2022-01-09 14:00:00,932,13,959,1011,2915,4646
2022-01-09 14:00:00,2022-01-09 15:00:00,1023,3,1191,987,3204,4819
2022-01-09 15:00:00,2022-01-09 16:00:00,1084,3,1177,1019,3283,5241
2022-01-09 16:00:00,2022-01-09 17:00:00,1079,3,1024,1043,3149,5106
2022-01-09 17:00:00,2022-01-09 18:00:00,945,3,932,1049,2929,4812
2022-01-09 18:00:00,2022-01-09 19:00:00,890,3,883,1092,2868,4617
2022-01-09 19:00:00,2022-01-09 20:00:00,873,3,791,1073,2740,4342
2022-01-09 20:00:00,2022-01-09 21:00:00,878,3,717,1037,2635,4114
2022-01-09 21:00:00,2022-01-09 22:00:00,877,3,642,1027,2549,3893
2022-01-09 22:00:00,2022-01-09 23:00:00,854,3,623,1051,2531,3720
2022-01-09 23:00:00,2022-01-10 00:00:00,838,3,747,1020,2608,3619
2022-01-10 00:00:00,2022-01-10 01:00:00,836,3,850,1021,2710,3560
2022-01-10 01:00:00,2022-01-10 02:00:00,835,3,942,998,2778,3545
2022-01-10 02:00:00,2022-01-10 03:00:00,831,3,1160,975,2969,3666
2022-01-10 03:00:00,2022-01-10 04:00:00,830,3,1315,937,3085,3925
2022-01-10 04:00:00,2022-01-10 05:00:00,856,3,1132,896,2887,4531
2022-01-10 05:00:00,2022-01-10 06:00:00,908,3,1103,864,2878,5132
2022-01-10 06:00:00,2022-01-10 07:00:00,976,4,978,831,2789,5384
2022-01-10 07:00:00,2022-01-10 08:00:00,1114,24,958,779,2875,5344
2022-01-10 08:00:00,2022-01-10 09:00:00,1021,79,948,731,2779,5369
2022-01-10 09:00:00,2022-01-10 10:00:00,1039,188,915,704,2846,5342
2022-01-10 10:00:00,2022-01-10 11:00:00,1055,257,838,712,2862,5193
2022-01-10 11:00:00,2022-01-10 12:00:00,1104,265,807,691,2867,5252
2022-01-10 12:00:00,2022-01-10 13:00:00,1039,136,853,651,2679,5191
2022-01-10 13:00:00,2022-01-10 14:00:00,972,29,995,487,2483,5105
2022-01-10 14:00:00,2022-01-10 15:00:00,996,4,972,455,2427,5318
2022-01-10 15:00:00,2022-01-10 16:00:00,1108,3,996,445,2552,5641
2022-01-10 16:00:00,2022-01-10 17:00:00,1093,3,928,473,2497,5485
2022-01-10 17:00:00,2022-01-10 18:00:00,1079,3,905,550,2537,5129
2022-01-10 18:00:00,2022-01-10 19:00:00,1060,3,955,644,2662,4903
2022-01-10 19:00:00,2022-01-10 20:00:00,928,3,930,769,2630,4673
2022-01-10 20:00:00,2022-01-10 21:00:00,905,3,926,911,2745,4426
2022-01-10 21:00:00,2022-01-10 22:00:00,864,3,917,969,2753,4165
2022-01-10 22:00:00,2022-01-10 23:00:00,848,3,924,900,2675,3930
2022-01-10 23:00:00,2022-01-11 00:00:00,833,3,980,831,2647,3816
2022-01-11 00:00:00,2022-01-11 01:00:00,829,3,926,847,2605,3767
2022-01-11 01:00:00,2022-01-11 02:00:00,829,3,893,838,2563,3744
2022-01-11 02:00:00,2022-01-11 03:00:00,828,3,875,819,2525,3803
2022-01-11 03:00:00,2022-01-11 04:00:00,831,3,889,860,2583,4051
2022-01-11 04:00:00,2022-01-11 05:00:00,847,3,977,1018,2845,4659
2022-01-11 05:00:00,2022-01-11 06:00:00,1009,3,1064,1245,3321,5287
2022-01-11 06:00:00,2022-01-11 07:00:00,1042,5,1062,1395,3504,5517
2022-01-11 07:00:00,2022-01-11 08:00:00,1040,25,1106,1515,3686,5498
2022-01-11 08:00:00,2022-01-11 09:00:00,1027,54,1125,1576,3782,5569
2022-01-11 09:00:00,2022-01-11 10:00:00,944,90,1201,1709,3944,5535
2022-01-11 10:00:00,2022-01-11 11:00:00,888,93,1156,1818,3955,5419
2022-01-11 11:00:00,2022-01-11 12:00:00,895,70,1215,1876,4056,5394
2022-01-11 12:00:00,2022-01-11 13:00:00,905,42,1324,1837,4108,5339
2022-01-11 13:00:00,2022-01-11 14:00:00,898,11,1367,1858,4134,5265
2022-01-11 14:00:00,2022-01-11 15:00:00,888,1,1384,1836,4109,5471
2022-01-11 15:00:00,2022-01-11 16:00:00,998,1,1358,1620,3977,5794
2022-01-11 16:00:00,2022-01-11 17:00:00,1001,1,1243,1207,3452,5563
2022-01-11 17:00:00,2022-01-11 18:00:00,892,1,1133,899,2925,5177
2022-01-11 18:00:00,2022-01-11 19:00:00,882,1,1080,705,2668,4875
2022-01-11 19:00:00,2022-01-11 20:00:00,881,1,966,543,2391,4629
2022-01-11 20:00:00,2022-01-11 21:00:00,891,1,772,436,2100,4362
2022-01-11 21:00:00,2022-01-11 22:00:00,897,1,688,367,1953,4076
2022-01-11 22:00:00,2022-01-11 23:00:00,855,1,618,453,1927,3888
2022-01-11 23:00:00,2022-01-12 00:00:00,853,1,629,522,2005,3770
2022-01-12 00:00:00,2022-01-12 01:00:00,846,1,661,563,2071,3708
2022-01-12 01:00:00,2022-01-12 02:00:00,841,1,517,575,1934,3682
2022-01-12 02:00:00,2022-01-12 03:00:00,838,1,449,701,1989,3742
2022-01-12 03:00:00,2022-01-12 04:00:00,834,1,441,761,2037,3993
2022-01-12 04:00:00,2022-01-12 05:00:00,855,1,457,737,2050,4560
2022-01-12 05:00:00,2022-01-12 06:00:00,973,1,398,825,2197,5160
2022-01-12 06:00:00,2022-01-12 07:00:00,1011,2,442,1103,2558,5400
2022-01-12 07:00:00,2022-01-12 08:00:00,1001,30,620,1303,2954,5396
2022-01-12 08:00:00,2022-01-12 09:00:00,1004,101,749,1336,3190,5476
2022-01-12 09:00:00,2022-01-12 10:00:00,902,130,844,1392,3268,5436
2022-01-12 10:00:00,2022-01-12 11:00:00,827,129,911,1485,3352,5338
2022-01-12 11:00:00,2022-01-12 12:00:00,800,111,1102,1649,3662,5311
2022-01-12 12:00:00,2022-01-12 13:00:00,763,89,1260,1892,4004,5259
2022-01-12 13:00:00,2022-01-12 14:00:00,785,24,1463,2024,4296,5107
2022-01-12 14:00:00,2022-01-12 15:00:00,826,3,1457,2058,4344,5228
2022-01-12 15:00:00,2022-01-12 16:00:00,820,3,1413,2159,4395,5603
2022-01-12 16:00:00,2022-01-12 17:00:00,823,3,1465,2150,4441,5365
2022-01-12 17:00:00,2022-01-12 18:00:00,780,3,1709,2229,4721,5057
2022-01-12 18:00:00,2022-01-12 19:00:00,662,3,1806,2411,4882,4782
2022-01-12 19:00:00,2022-01-12 20:00:00,611,3,1861,2592,5067,4514
2022-01-12 20:00:00,2022-01-12 21:00:00,609,3,1862,2753,5227,4234
2022-01-12 21:00:00,2022-01-12 22:00:00,549,3,1861,2877,5290,4025
2022-01-12 22:00:00,2022-01-12 23:00:00,485,3,1873,2771,5132,3839
2022-01-12 23:00:00,2022-01-13 00:00:00,453,3,1934,2885,5275,3711
2022-01-13 00:00:00,2022-01-13 01:00:00,427,3,1911,2876,5217,3641
2022-01-13 01:00:00,2022-01-13 02:00:00,446,3,1993,2780,5222,3602
2022-01-13 02:00:00,2022-01-13 03:00:00,488,3,1958,2770,5219,3713
2022-01-13 03:00:00,2022-01-13 04:00:00,435,3,1918,2685,5041,3943
2022-01-13 04:00:00,2022-01-13 05:00:00,465,3,1987,2678,5133,4460
2022-01-13 05:00:00,2022-01-13 06:00:00,611,3,2008,2501,5123,5105
2022-01-13 06:00:00,2022-01-13 07:00:00,587,3,2001,2756,5347,5373
2022-01-13 07:00:00,2022-01-13 08:00:00,509,28,2010,2962,5509,5253
2022-01-13 08:00:00,2022-01-13 09:00:00,525,110,2003,3061,5699,5319
2022-01-13 09:00:00,2022-01-13 10:00:00,524,153,1981,3055,5713,5337
2022-01-13 10:00:00,2022-01-13 11:00:00,526,172,1941,3151,5790,5257
2022-01-13 11:00:00,2022-01-13 12:00:00,526,143,1931,2941,5541,5350
2022-01-13 12:00:00,2022-01-13 13:00:00,550,111,1911,2948,5520,5265
2022-01-13 13:00:00,2022-01-13 14:00:00,500,55,1903,2815,5273,5139
2022-01-13 14:00:00,2022-01-13 15:00:00,553,7,1910,3029,5499,5272
2022-01-13 15:00:00,2022-01-13 16:00:00,621,3,1986,3120,5730,5685
2022-01-13 16:00:00,2022-01-13 17:00:00,531,3,1925,3239,5698,5528
2022-01-13 17:00:00,2022-01-13 18:00:00,489,3,1905,2916,5313,5206
2022-01-13 18:00:00,2022-01-13 19:00:00,429,3,1948,2829,5209,4916
2022-01-13 19:00:00,2022-01-13 20:00:00,420,3,1905,2698,5026,4661
2022-01-13 20:00:00,2022-01-13 21:00:00,401,3,1999,2663,5066,4424
2022-01-13 21:00:00,2022-01-13 22:00:00,418,3,1934,3058,5413,4106
2022-01-13 22:00:00,2022-01-13 23:00:00,376,3,1828,2598,4805,3951
2022-01-13 23:00:00,2022-01-14 00:00:00,351,3,1797,2477,4628,3856
2022-01-14 00:00:00,2022-01-14 01:00:00,350,3,1813,2402,4568,3785
2022-01-14 01:00:00,2022-01-14 02:00:00,363,3,1784,2419,4569,3740
2022-01-14 02:00:00,2022-01-14 03:00:00,359,3,1813,2385,4560,3777
2022-01-14 03:00:00,2022-01-14 04:00:00,370,3,1862,2375,4610,3991
2022-01-14 04:00:00,2022-01-14 05:00:00,470,3,1850,2314,4637,4573
2022-01-14 05:00:00,2022-01-14 06:00:00,582,3,1741,2611,4937,5186
2022-01-14 06:00:00,2022-01-14 07:00:00,599,4,1633,2729,4965,5362
2022-01-14 07:00:00,2022-01-14 08:00:00,613,62,1722,2739,5136,5331
2022-01-14 08:00:00,2022-01-14 09:00:00,637,223,1957,2247,5064,5336
2022-01-14 09:00:00,2022-01-14 10:00:00,628,419,1947,2046,5040,5272
2022-01-14 10:00:00,2022-01-14 11:00:00,585,533,1886,2016,5020,5126
2022-01-14 11:00:00,2022-01-14 12:00:00,572,488,1855,1900,4815,5000
2022-01-14 12:00:00,2022-01-14 13:00:00,495,325,1784,1695,4299,4862
2022-01-14 13:00:00,2022-01-14 14:00:00,569,102,1787,1395,3853,4795
2022-01-14 14:00:00,2022-01-14 15:00:00,647,8,1647,1243,3545,4987
2022-01-14 15:00:00,2022-01-14 16:00:00,791,3,1367,1281,3442,5319
2022-01-14 16:00:00,2022-01-14 17:00:00,768,3,1309,1288,3368,5164
2022-01-14 17:00:00,2022-01-14 18:00:00,846,3,1247,1203,3299,4808
2022-01-14 18:00:00,2022-01-14 19:00:00,903,3,1110,1048,3064,4488
2022-01-14 19:00:00,2022-01-14 20:00:00,938,4,944,891,2777,4273
2022-01-14 20:00:00,2022-01-14 21:00:00,874,4,698,693,2269,4091
2022-01-14 21:00:00,2022-01-14 22:00:00,878,5,568,600,2051,3902
2022-01-14 22:00:00,2022-01-14 23:00:00,900,4,447,500,1851,3758
2022-01-14 23:00:00,2022-01-15 00:00:00,874,4,415,460,1753,3640
2022-01-15 00:00:00,2022-01-15 01:00:00,853,5,356,488,1702,3577
2022-01-15 01:00:00,2022-01-15 02:00:00,835,5,317,629,1786,3541
2022-01-15 02:00:00,2022-01-15 03:00:00,814,5,228,650,1697,3521
2022-01-15 03:00:00,2022-01-15 04:00:00,828,4,181,559,1572,3599
2022-01-15 04:00:00,2022-01-15 05:00:00,855,5,179,535,1574,3807
2022-01-15 05:00:00,2022-01-15 06:00:00,914,4,142,545,1605,4122
2022-01-15 06:00:00,2022-01-15 07:00:00,964,8,138,450,1560,4340
2022-01-15 07:00:00,2022-01-15 08:00:00,996,88,131,474,1689,4537
2022-01-15 08:00:00,2022-01-15 09:00:00,942,220,134,495,1791,4564
2022-01-15 09:00:00,2022-01-15 10:00:00,905,283,202,510,1900,4579
2022-01-15 10:00:00,2022-01-15 11:00:00,878,322,282,503,1985,4523
2022-01-15 11:00:00,2022-01-15 12:00:00,897,256,285,518,1956,4414
2022-01-15 12:00:00,2022-01-15 13:00:00,886,142,345,517,1890,4342
2022-01-15 13:00:00,2022-01-15 14:00:00,897,52,381,590,1920,4391
2022-01-15 14:00:00,2022-01-15 15:00:00,900,5,450,732,2087,4622
2022-01-15 15:00:00,2022-01-15 16:00:00,931,3,538,898,2370,5053
2022-01-15 16:00:00,2022-01-15 17:00:00,934,3,594,1034,2565,4913
2022-01-15 17:00:00,2022-01-15 18:00:00,898,3,665,1057,2623,4574
2022-01-15 18:00:00,2022-01-15 19:00:00,898,3,750,1076,2727,4298
2022-01-15 19:00:00,2022-01-15 20:00:00,863,3,820,1143,2829,4082
2022-01-15 20:00:00,2022-01-15 21:00:00,856,3,897,1261,3017,3905
2022-01-15 21:00:00,2022-01-15 22:00:00,873,3,977,1343,3196,3694
2022-01-15 22:00:00,2022-01-15 23:00:00,877,3,1017,1484,3381,3523
2022-01-15 23:00:00,2022-01-16 00:00:00,893,3,1135,1573,3604,3402
2022-01-16 00:00:00,2022-01-16 01:00:00,787,3,1158,1701,3649,3326
2022-01-16 01:00:00,2022-01-16 02:00:00,850,3,1159,1690,3702,3280
2022-01-16 02:00:00,2022-01-16 03:00:00,930,3,1126,1550,3609,3285
2022-01-16 03:00:00,2022-01-16 04:00:00,922,3,1283,1413,3621,3314
2022-01-16 04:00:00,2022-01-16 05:00:00,810,3,1349,1347,3509,3469
2022-01-16 05:00:00,2022-01-16 06:00:00,823,3,1381,1472,3679,3735
2022-01-16 06:00:00,2022-01-16 07:00:00,888,3,1358,1529,3778,4034
2022-01-16 07:00:00,2022-01-16 08:00:00,862,13,1277,1612,3764,4242
2022-01-16 08:00:00,2022-01-16 09:00:00,718,37,1465,1906,4126,4396
2022-01-16 09:00:00,2022-01-16 10:00:00,653,93,1675,2286,4707,4546
2022-01-16 10:00:00,2022-01-16 11:00:00,586,120,1893,2580,5179,4666
2022-01-16 11:00:00,2022-01-16 12:00:00,497,108,1991,2442,5038,4662
2022-01-16 12:00:00,2022-01-16 13:00:00,499,75,2002,2357,4933,4641
2022-01-16 13:00:00,2022-01-16 14:00:00,611,38,2030,2568,5247,4592
2022-01-16 14:00:00,2022-01-16 15:00:00,639,6,2034,2692,5371,4791
2022-01-16 15:00:00,2022-01-16 16:00:00,625,3,2082,2989,5699,5232
2022-01-16 16:00:00,2022-01-16 17:00:00,527,3,2009,2902,5441,5085
2022-01-16 17:00:00,2022-01-16 18:00:00,479,3,2056,2552,5090,4755
2022-01-16 18:00:00,2022-01-16 19:00:00,395,3,1925,2487,4810,4565
2022-01-16 19:00:00,2022-01-16 20:00:00,521,3,2005,2613,5142,4345
2022-01-16 20:00:00,2022-01-16 21:00:00,504,3,1913,2700,5120,4142
2022-01-16 21:00:00,2022-01-16 22:00:00,515,3,1890,2720,5128,3887
2022-01-16 22:00:00,2022-01-16 23:00:00,498,3,1850,2556,4907,3832
2022-01-16 23:00:00,2022-01-17 00:00:00,444,3,1855,2593,4895,3735
2022-01-17 00:00:00,2022-01-17 01:00:00,538,3,1849,2573,4963,3701
2022-01-17 01:00:00,2022-01-17 02:00:00,608,3,1871,2787,5269,3713
2022-01-17 02:00:00,2022-01-17 03:00:00,613,3,1856,2600,5072,3740
2022-01-17 03:00:00,2022-01-17 04:00:00,623,3,1795,2441,4862,3985
2022-01-17 04:00:00,2022-01-17 05:00:00,629,3,1822,2691,5145,4621
2022-01-17 05:00:00,2022-01-17 06:00:00,669,3,1785,3273,5730,5261
2022-01-17 06:00:00,2022-01-17 07:00:00,864,7,2060,2909,5840,5361
2022-01-17 07:00:00,2022-01-17 08:00:00,745,98,2065,3159,6067,5425
2022-01-17 08:00:00,2022-01-17 09:00:00,724,309,2007,2872,5912,5453
2022-01-17 09:00:00,2022-01-17 10:00:00,714,501,2007,2814,6036,5438
2022-01-17 10:00:00,2022-01-17 11:00:00,708,579,1994,2757,6038,5331
2022-01-17 11:00:00,2022-01-17 12:00:00,653,528,1989,2727,5897,5308
2022-01-17 12:00:00,2022-01-17 13:00:00,668,338,1961,2703,5670,5243
2022-01-17 13:00:00,2022-01-17 14:00:00,669,116,2006,2425,5216,5193
2022-01-17 14:00:00,2022-01-17 15:00:00,689,10,1901,1682,4282,5375
2022-01-17 15:00:00,2022-01-17 16:00:00,735,3,1900,1258,3896,5834
2022-01-17 16:00:00,2022-01-17 17:00:00,731,3,1687,1369,3790,5617
2022-01-17 17:00:00,2022-01-17 18:00:00,779,3,1605,1571,3958,5243
2022-01-17 18:00:00,2022-01-17 19:00:00,729,3,1664,1582,3978,4825
2022-01-17 19:00:00,2022-01-17 20:00:00,761,3,1506,1467,3737,4588
2022-01-17 20:00:00,2022-01-17 21:00:00,860,3,1229,1340,3432,4325
2022-01-17 21:00:00,2022-01-17 22:00:00,891,3,1142,1217,3253,4020
2022-01-17 22:00:00,2022-01-17 23:00:00,855,3,1055,1263,3176,3831
2022-01-17 23:00:00,2022-01-18 00:00:00,815,3,1047,1118,2983,3734
2022-01-18 00:00:00,2022-01-18 01:00:00,868,3,970,1013,2854,3680
2022-01-18 01:00:00,2022-01-18 02:00:00,879,3,920,1092,2894,3599
2022-01-18 02:00:00,2022-01-18 03:00:00,877,3,1010,1173,3063,3675
2022-01-18 03:00:00,2022-01-18 04:00:00,888,3,985,1184,3060,3886
2022-01-18 04:00:00,2022-01-18 05:00:00,908,3,944,1241,3096,4521
2022-01-18 05:00:00,2022-01-18 06:00:00,1060,3,811,1186,3060,5024
2022-01-18 06:00:00,2022-01-18 07:00:00,1091,6,620,1268,2985,5174
2022-01-18 07:00:00,2022-01-18 08:00:00,1104,42,551,1472,3169,5161
2022-01-18 08:00:00,2022-01-18 09:00:00,1016,103,545,1675,3339,5237
2022-01-18 09:00:00,2022-01-18 10:00:00,983,130,724,1793,3630,5198
2022-01-18 10:00:00,2022-01-18 11:00:00,917,165,1036,1960,4078,5129
2022-01-18 11:00:00,2022-01-18 12:00:00,923,152,1192,2301,4568,5102
2022-01-18 12:00:00,2022-01-18 13:00:00,920,121,1168,2367,4576,4993
2022-01-18 13:00:00,2022-01-18 14:00:00,907,69,1306,2170,4452,4903
2022-01-18 14:00:00,2022-01-18 15:00:00,912,9,1450,2089,4460,5075
2022-01-18 15:00:00,2022-01-18 16:00:00,916,1,1409,2233,4559,5518
2022-01-18 16:00:00,2022-01-18 17:00:00,918,1,1340,2148,4407,5298
2022-01-18 17:00:00,2022-01-18 18:00:00,900,1,1409,2037,4347,4942
2022-01-18 18:00:00,2022-01-18 19:00:00,881,1,1636,1960,4478,4663
2022-01-18 19:00:00,2022-01-18 20:00:00,887,1,1801,1947,4636,4352
2022-01-18 20:00:00,2022-01-18 21:00:00,875,1,1855,1993,4724,4090
2022-01-18 21:00:00,2022-01-18 22:00:00,811,1,1888,2083,4783,3869
2022-01-18 22:00:00,2022-01-18 23:00:00,538,1,1834,2281,4654,3833
2022-01-18 23:00:00,2022-01-19 00:00:00,394,1,1846,2154,4395,3809
2022-01-19 00:00:00,2022-01-19 01:00:00,414,1,1846,2004,4265,3730
2022-01-19 01:00:00,2022-01-19 02:00:00,375,1,1871,1902,4149,3729
2022-01-19 02:00:00,2022-01-19 03:00:00,358,1,1758,1945,4062,3783
2022-01-19 03:00:00,2022-01-19 04:00:00,571,1,1763,2287,4622,3955
2022-01-19 04:00:00,2022-01-19 05:00:00,688,1,1874,2810,5373,4564
2022-01-19 05:00:00,2022-01-19 06:00:00,796,1,1906,3215,5918,5093
2022-01-19 06:00:00,2022-01-19 07:00:00,808,2,1907,3266,5983,5287
2022-01-19 07:00:00,2022-01-19 08:00:00,846,17,2011,3265,6139,5361
2022-01-19 08:00:00,2022-01-19 09:00:00,792,37,2022,3346,6197,5466
2022-01-19 09:00:00,2022-01-19 10:00:00,735,40,1962,3446,6183,5408
2022-01-19 10:00:00,2022-01-19 11:00:00,777,36,2000,3506,6319,5396
2022-01-19 11:00:00,2022-01-19 12:00:00,735,28,1943,3505,6211,5539
2022-01-19 12:00:00,2022-01-19 13:00:00,592,20,1968,3493,6073,5505
2022-01-19 13:00:00,2022-01-19 14:00:00,621,11,2011,3161,5804,5376
2022-01-19 14:00:00,2022-01-19 15:00:00,694,1,2077,3421,6193,5490
2022-01-19 15:00:00,2022-01-19 16:00:00,695,1,2053,3692,6441,5805
2022-01-19 16:00:00,2022-01-19 17:00:00,677,1,2006,3327,6011,5646
2022-01-19 17:00:00,2022-01-19 18:00:00,686,1,1997,3147,5831,5327
2022-01-19 18:00:00,2022-01-19 19:00:00,655,1,2009,2967,5632,5082
2022-01-19 19:00:00,2022-01-19 20:00:00,615,1,2056,2839,5511,4883
2022-01-19 20:00:00,2022-01-19 21:00:00,662,1,2060,3010,5733,4546
2022-01-19 21:00:00,2022-01-19 22:00:00,568,1,2040,3266,5875,4301
2022-01-19 22:00:00,2022-01-19 23:00:00,526,1,1950,3362,5839,4122
2022-01-19 23:00:00,2022-01-20 00:00:00,565,1,1949,3438,5953,4069
2022-01-20 00:00:00,2022-01-20 01:00:00,639,1,2014,3421,6075,4029
2022-01-20 01:00:00,2022-01-20 02:00:00,563,1,2027,3448,6039,4074
2022-01-20 02:00:00,2022-01-20 03:00:00,539,1,1968,3555,6063,4160
2022-01-20 03:00:00,2022-01-20 04:00:00,579,1,1964,3193,5737,4352
2022-01-20 04:00:00,2022-01-20 05:00:00,695,1,2005,2902,5603,4958
2022-01-20 05:00:00,2022-01-20 06:00:00,818,1,2083,3211,6113,5449
2022-01-20 06:00:00,2022-01-20 07:00:00,865,5,2083,3438,6391,5677
2022-01-20 07:00:00,2022-01-20 08:00:00,866,84,2081,3390,6421,5628
2022-01-20 08:00:00,2022-01-20 09:00:00,834,257,2048,3545,6684,5675
2022-01-20 09:00:00,2022-01-20 10:00:00,802,397,2073,3426,6698,5656
2022-01-20 10:00:00,2022-01-20 11:00:00,819,446,2048,3595,6908,5545
2022-01-20 11:00:00,2022-01-20 12:00:00,809,442,2063,3614,6928,5477
2022-01-20 12:00:00,2022-01-20 13:00:00,788,298,2065,3408,6559,5452
2022-01-20 13:00:00,2022-01-20 14:00:00,813,120,2090,3115,6138,5250
2022-01-20 14:00:00,2022-01-20 15:00:00,910,15,2090,2763,5778,5402
2022-01-20 15:00:00,2022-01-20 16:00:00,966,3,2082,2524,5575,5756
2022-01-20 16:00:00,2022-01-20 17:00:00,853,3,2005,2234,5095,5672
2022-01-20 17:00:00,2022-01-20 18:00:00,853,3,2065,2171,5092,5275
2022-01-20 18:00:00,2022-01-20 19:00:00,748,3,2072,2053,4876,5132
2022-01-20 19:00:00,2022-01-20 20:00:00,788,3,2085,1741,4617,4904
2022-01-20 20:00:00,2022-01-20 21:00:00,825,3,2087,1634,4549,4716
2022-01-20 21:00:00,2022-01-20 22:00:00,819,3,2091,1650,4563,4457
2022-01-20 22:00:00,2022-01-20 23:00:00,736,3,2092,1559,4390,4144
2022-01-20 23:00:00,2022-01-21 00:00:00,771,3,2034,1511,4319,3985
2022-01-21 00:00:00,2022-01-21 01:00:00,772,3,1939,1453,4167,3927
2022-01-21 01:00:00,2022-01-21 02:00:00,773,3,1833,1268,3877,3903
2022-01-21 02:00:00,2022-01-21 03:00:00,783,3,1857,1250,3893,3948
2022-01-21 03:00:00,2022-01-21 04:00:00,803,3,1885,1248,3939,4215
2022-01-21 04:00:00,2022-01-21 05:00:00,855,3,1929,1204,3991,4716
2022-01-21 05:00:00,2022-01-21 06:00:00,847,3,1942,1340,4132,5300
2022-01-21 06:00:00,2022-01-21 07:00:00,846,11,1791,1366,4014,5505
2022-01-21 07:00:00,2022-01-21 08:00:00,862,116,1550,1275,3803,5418
2022-01-21 08:00:00,2022-01-21 09:00:00,847,324,1570,1207,3948,5449
2022-01-21 09:00:00,2022-01-21 10:00:00,847,407,1400,1226,3880,5285
2022-01-21 10:00:00,2022-01-21 11:00:00,801,336,1364,1477,3978,5092
2022-01-21 11:00:00,2022-01-21 12:00:00,637,283,1545,1670,4135,5153
2022-01-21 12:00:00,2022-01-21 13:00:00,553,151,1637,1887,4228,5073
2022-01-21 13:00:00,2022-01-21 14:00:00,514,49,1661,1552,3776,5127
2022-01-21 14:00:00,2022-01-21 15:00:00,531,9,1589,1868,3997,5225
2022-01-21 15:00:00,2022-01-21 16:00:00,546,3,1567,1804,3920,5652
2022-01-21 16:00:00,2022-01-21 17:00:00,515,3,1666,1637,3821,5520
2022-01-21 17:00:00,2022-01-21 18:00:00,550,3,1645,1331,3529,5139
2022-01-21 18:00:00,2022-01-21 19:00:00,571,3,1556,1203,3333,4756
2022-01-21 19:00:00,2022-01-21 20:00:00,635,3,1401,1275,3314,4374
2022-01-21 20:00:00,2022-01-21 21:00:00,637,3,1298,942,2880,4190
2022-01-21 21:00:00,2022-01-21 22:00:00,675,3,1341,687,2706,3965
2022-01-21 22:00:00,2022-01-21 23:00:00,613,3,1134,638,2388,3840
2022-01-21 23:00:00,2022-01-22 00:00:00,610,3,990,570,2173,3758
2022-01-22 00:00:00,2022-01-22 01:00:00,490,3,936,466,1895,3687
2022-01-22 01:00:00,2022-01-22 02:00:00,482,3,893,421,1799,3549
2022-01-22 02:00:00,2022-01-22 03:00:00,595,3,837,570,2005,3564
2022-01-22 03:00:00,2022-01-22 04:00:00,596,3,735,673,2007,3784
2022-01-22 04:00:00,2022-01-22 05:00:00,607,3,574,668,1852,3803
2022-01-22 05:00:00,2022-01-22 06:00:00,604,3,496,676,1779,4242
2022-01-22 06:00:00,2022-01-22 07:00:00,589,7,487,760,1843,4510
2022-01-22 07:00:00,2022-01-22 08:00:00,550,62,514,742,1868,4647
2022-01-22 08:00:00,2022-01-22 09:00:00,593,176,667,765,2201,4695
2022-01-22 09:00:00,2022-01-22 10:00:00,567,200,800,821,2388,4624
2022-01-22 10:00:00,2022-01-22 11:00:00,545,210,782,931,2468,4547
2022-01-22 11:00:00,2022-01-22 12:00:00,512,157,791,1149,2609,4583
2022-01-22 12:00:00,2022-01-22 13:00:00,500,99,667,1141,2407,4544
2022-01-22 13:00:00,2022-01-22 14:00:00,555,50,606,1207,2418,4480
2022-01-22 14:00:00,2022-01-22 15:00:00,605,7,648,1297,2557,4697
2022-01-22 15:00:00,2022-01-22 16:00:00,632,3,686,1358,2679,5066
2022-01-22 16:00:00,2022-01-22 17:00:00,616,3,784,1393,2796,4996
2022-01-22 17:00:00,2022-01-22 18:00:00,580,3,795,1383,2761,4685
2022-01-22 18:00:00,2022-01-22 19:00:00,566,3,667,1407,2643,4461
2022-01-22 19:00:00,2022-01-22 20:00:00,588,3,741,1439,2771,4223
2022-01-22 20:00:00,2022-01-22 21:00:00,545,3,896,1302,2746,4043
2022-01-22 21:00:00,2022-01-22 22:00:00,594,3,820,1151,2568,3812
2022-01-22 22:00:00,2022-01-22 23:00:00,693,3,793,1108,2597,3507
2022-01-22 23:00:00,2022-01-23 00:00:00,718,3,825,1017,2563,3354
2022-01-23 00:00:00,2022-01-23 01:00:00,652,3,729,999,2383,3264
2022-01-23 01:00:00,2022-01-23 02:00:00,725,3,571,944,2243,3203
2022-01-23 02:00:00,2022-01-23 03:00:00,677,3,629,1043,2352,3188
2022-01-23 03:00:00,2022-01-23 04:00:00,619,3,778,1091,2491,3246
2022-01-23 04:00:00,2022-01-23 05:00:00,610,3,916,1084,2613,3368
2022-01-23 05:00:00,2022-01-23 06:00:00,632,3,858,1113,2606,3587
2022-01-23 06:00:00,2022-01-23 07:00:00,692,5,972,1016,2685,3893
2022-01-23 07:00:00,2022-01-23 08:00:00,705,37,944,924,2610,4108
2022-01-23 08:00:00,2022-01-23 09:00:00,714,109,944,868,2635,4231
2022-01-23 09:00:00,2022-01-23 10:00:00,695,131,1001,896,2723,4258
2022-01-23 10:00:00,2022-01-23 11:00:00,626,156,1100,884,2766,4266
2022-01-23 11:00:00,2022-01-23 12:00:00,672,139,914,966,2691,4206
2022-01-23 12:00:00,2022-01-23 13:00:00,671,82,905,1264,2922,4199
2022-01-23 13:00:00,2022-01-23 14:00:00,833,38,649,1371,2891,4203
2022-01-23 14:00:00,2022-01-23 15:00:00,846,6,564,1300,2716,4431
2022-01-23 15:00:00,2022-01-23 16:00:00,845,3,832,1121,2801,4909
2022-01-23 16:00:00,2022-01-23 17:00:00,873,3,970,1011,2857,4782
2022-01-23 17:00:00,2022-01-23 18:00:00,937,3,931,1000,2871,4428
2022-01-23 18:00:00,2022-01-23 19:00:00,920,3,1127,1063,3113,4181
2022-01-23 19:00:00,2022-01-23 20:00:00,847,3,1273,1208,3331,3975
2022-01-23 20:00:00,2022-01-23 21:00:00,831,3,1337,1430,3601,3816
2022-01-23 21:00:00,2022-01-23 22:00:00,718,3,1401,1668,3790,3586
2022-01-23 22:00:00,2022-01-23 23:00:00,653,3,1362,1908,3926,3437
2022-01-23 23:00:00,2022-01-24 00:00:00,616,3,1356,1918,3893,3335
2022-01-24 00:00:00,2022-01-24 01:00:00,536,3,1329,1802,3670,3283
2022-01-24 01:00:00,2022-01-24 02:00:00,590,3,1181,1801,3575,3268
2022-01-24 02:00:00,2022-01-24 03:00:00,564,3,1264,1839,3670,3347
2022-01-24 03:00:00,2022-01-24 04:00:00,662,3,1248,1796,3709,3602
2022-01-24 04:00:00,2022-01-24 05:00:00,793,3,1283,1740,3819,4206
2022-01-24 05:00:00,2022-01-24 06:00:00,884,3,1304,1685,3876,4847
2022-01-24 06:00:00,2022-01-24 07:00:00,856,4,1359,1629,3848,5123
2022-01-24 07:00:00,2022-01-24 08:00:00,881,10,1289,1622,3802,5151
2022-01-24 08:00:00,2022-01-24 09:00:00,904,26,1262,1677,3869,5224
2022-01-24 09:00:00,2022-01-24 10:00:00,896,42,1244,1744,3926,5233
2022-01-24 10:00:00,2022-01-24 11:00:00,855,50,1355,1789,4049,5172
2022-01-24 11:00:00,2022-01-24 12:00:00,840,51,1414,1728,4033,5156
2022-01-24 12:00:00,2022-01-24 13:00:00,856,47,1406,1669,3978,5149
2022-01-24 13:00:00,2022-01-24 14:00:00,901,25,1269,1677,3872,5048
2022-01-24 14:00:00,2022-01-24 15:00:00,836,7,1256,1747,3846,5176
2022-01-24 15:00:00,2022-01-24 16:00:00,891,3,1296,1807,3997,5447
2022-01-24 16:00:00,2022-01-24 17:00:00,939,3,1375,1811,4128,5134
2022-01-24 17:00:00,2022-01-24 18:00:00,895,3,1372,1687,3957,4808
2022-01-24 18:00:00,2022-01-24 19:00:00,779,3,1389,1537,3708,4513
2022-01-24 19:00:00,2022-01-24 20:00:00,711,3,1442,1545,3701,4238
2022-01-24 20:00:00,2022-01-24 21:00:00,643,3,1485,1666,3797,4005
2022-01-24 21:00:00,2022-01-24 22:00:00,506,3,1557,1842,3908,3732
2022-01-24 22:00:00,2022-01-24 23:00:00,487,3,1633,2015,4138,3596
2022-01-24 23:00:00,2022-01-25 00:00:00,433,3,1681,1989,4106,3541
2022-01-25 00:00:00,2022-01-25 01:00:00,342,3,1613,1875,3833,3463
2022-01-25 01:00:00,2022-01-25 02:00:00,379,3,1587,1652,3621,3353
2022-01-25 02:00:00,2022-01-25 03:00:00,376,3,1586,1388,3353,3397
2022-01-25 03:00:00,2022-01-25 04:00:00,367,3,1339,1270,2979,3687
2022-01-25 04:00:00,2022-01-25 05:00:00,374,3,1198,1194,2769,4182
2022-01-25 05:00:00,2022-01-25 06:00:00,379,3,1126,1151,2659,4835
2022-01-25 06:00:00,2022-01-25 07:00:00,376,7,1094,1154,2631,5042
2022-01-25 07:00:00,2022-01-25 08:00:00,435,62,1038,941,2476,4944
2022-01-25 08:00:00,2022-01-25 09:00:00,408,189,1119,808,2524,4953
2022-01-25 09:00:00,2022-01-25 10:00:00,413,276,1057,846,2592,4970
2022-01-25 10:00:00,2022-01-25 11:00:00,380,291,948,975,2594,4915
2022-01-25 11:00:00,2022-01-25 12:00:00,350,241,1017,1048,2656,4915
2022-01-25 12:00:00,2022-01-25 13:00:00,403,165,1011,1040,2619,4889
2022-01-25 13:00:00,2022-01-25 14:00:00,438,56,1058,977,2529,4693
2022-01-25 14:00:00,2022-01-25 15:00:00,447,4,1045,904,2400,4842
2022-01-25 15:00:00,2022-01-25 16:00:00,477,1,935,881,2294,5171
2022-01-25 16:00:00,2022-01-25 17:00:00,383,1,1037,887,2308,4915
2022-01-25 17:00:00,2022-01-25 18:00:00,385,1,1272,950,2608,4798
2022-01-25 18:00:00,2022-01-25 19:00:00,340,1,1209,1134,2684,4559
2022-01-25 19:00:00,2022-01-25 20:00:00,360,1,1233,1323,2917,4213
2022-01-25 20:00:00,2022-01-25 21:00:00,338,1,1507,1583,3429,3952
2022-01-25 21:00:00,2022-01-25 22:00:00,270,1,1756,1978,4005,3734
2022-01-25 22:00:00,2022-01-25 23:00:00,235,1,1874,2180,4290,3537
2022-01-25 23:00:00,2022-01-26 00:00:00,230,1,1934,2284,4449,3507
2022-01-26 00:00:00,2022-01-26 01:00:00,274,1,1981,2377,4633,3492
2022-01-26 01:00:00,2022-01-26 02:00:00,267,1,1885,2498,4651,3467
2022-01-26 02:00:00,2022-01-26 03:00:00,281,1,1906,2652,4840,3509
2022-01-26 03:00:00,2022-01-26 04:00:00,274,1,1938,2618,4831,3735
2022-01-26 04:00:00,2022-01-26 05:00:00,221,1,1953,2787,4962,4326
2022-01-26 05:00:00,2022-01-26 06:00:00,327,1,2009,3030,5367,4954
2022-01-26 06:00:00,2022-01-26 07:00:00,377,1,2024,3071,5473,5182
2022-01-26 07:00:00,2022-01-26 08:00:00,335,17,2016,2964,5332,5180
2022-01-26 08:00:00,2022-01-26 09:00:00,328,72,2010,2955,5365,5323
2022-01-26 09:00:00,2022-01-26 10:00:00,309,137,2026,2869,5341,5334
2022-01-26 10:00:00,2022-01-26 11:00:00,324,140,1995,2875,5334,5220
2022-01-26 11:00:00,2022-01-26 12:00:00,332,134,1978,2961,5405,5257
2022-01-26 12:00:00,2022-01-26 13:00:00,277,88,1927,3173,5465,5254
2022-01-26 13:00:00,2022-01-26 14:00:00,236,64,1932,3190,5422,5114
2022-01-26 14:00:00,2022-01-26 15:00:00,237,17,2006,3079,5339,5234
2022-01-26 15:00:00,2022-01-26 16:00:00,236,1,2028,2934,5199,5609
2022-01-26 16:00:00,2022-01-26 17:00:00,258,1,2062,2740,5061,5437
2022-01-26 17:00:00,2022-01-26 18:00:00,222,1,2044,2516,4783,5157
2022-01-26 18:00:00,2022-01-26 19:00:00,239,1,2032,2208,4480,4894
2022-01-26 19:00:00,2022-01-26 20:00:00,217,1,1924,1933,4075,4643
2022-01-26 20:00:00,2022-01-26 21:00:00,226,1,1789,2036,4052,4436
2022-01-26 21:00:00,2022-01-26 22:00:00,234,1,1913,2107,4255,4205
2022-01-26 22:00:00,2022-01-26 23:00:00,203,1,1861,2207,4272,3984
2022-01-26 23:00:00,2022-01-27 00:00:00,234,1,1954,2506,4695,3912
2022-01-27 00:00:00,2022-01-27 01:00:00,287,2,1971,2377,4637,3825
2022-01-27 01:00:00,2022-01-27 02:00:00,307,4,1979,2499,4789,3786
2022-01-27 02:00:00,2022-01-27 03:00:00,352,4,1969,2427,4752,3838
2022-01-27 03:00:00,2022-01-27 04:00:00,291,4,1963,2574,4832,4065
2022-01-27 04:00:00,2022-01-27 05:00:00,311,4,1937,2628,4880,4521
2022-01-27 05:00:00,2022-01-27 06:00:00,459,4,1858,2846,5167,5135
2022-01-27 06:00:00,2022-01-27 07:00:00,449,6,1792,2895,5142,5315
2022-01-27 07:00:00,2022-01-27 08:00:00,494,57,1780,2823,5154,5324
2022-01-27 08:00:00,2022-01-27 09:00:00,482,171,1768,2936,5357,5435
2022-01-27 09:00:00,2022-01-27 10:00:00,488,327,1850,2776,5441,5376
2022-01-27 10:00:00,2022-01-27 11:00:00,421,421,1874,2742,5458,5384
2022-01-27 11:00:00,2022-01-27 12:00:00,406,368,1922,2626,5322,5367
2022-01-27 12:00:00,2022-01-27 13:00:00,442,250,1887,2588,5167,5294
2022-01-27 13:00:00,2022-01-27 14:00:00,370,110,1853,2613,4946,5186
2022-01-27 14:00:00,2022-01-27 15:00:00,377,20,1888,2625,4910,5316
2022-01-27 15:00:00,2022-01-27 16:00:00,394,3,1769,3353,5519,5750
2022-01-27 16:00:00,2022-01-27 17:00:00,360,3,1880,3034,5277,5611
2022-01-27 17:00:00,2022-01-27 18:00:00,358,3,1869,2718,4948,5337
2022-01-27 18:00:00,2022-01-27 19:00:00,360,3,1859,2493,4715,4978
2022-01-27 19:00:00,2022-01-27 20:00:00,394,3,1926,2577,4900,4718
2022-01-27 20:00:00,2022-01-27 21:00:00,397,3,1871,2691,4962,4478
2022-01-27 21:00:00,2022-01-27 22:00:00,401,3,1865,2534,4803,4187
2022-01-27 22:00:00,2022-01-27 23:00:00,386,3,1864,2333,4586,4043
2022-01-27 23:00:00,2022-01-28 00:00:00,369,3,1895,2446,4713,3955
2022-01-28 00:00:00,2022-01-28 01:00:00,365,3,1906,2324,4598,3900
2022-01-28 01:00:00,2022-01-28 02:00:00,419,3,1931,2159,4512,3849
2022-01-28 02:00:00,2022-01-28 03:00:00,368,3,1884,2057,4312,3941
2022-01-28 03:00:00,2022-01-28 04:00:00,414,3,1867,1814,4098,4135
2022-01-28 04:00:00,2022-01-28 05:00:00,504,3,1747,1528,3782,4733
2022-01-28 05:00:00,2022-01-28 06:00:00,560,3,1564,1911,4038,5252
2022-01-28 06:00:00,2022-01-28 07:00:00,494,19,1555,1645,3713,5433
2022-01-28 07:00:00,2022-01-28 08:00:00,499,189,1745,1399,3832,5289
2022-01-28 08:00:00,2022-01-28 09:00:00,406,459,1648,1025,3538,5306
2022-01-28 09:00:00,2022-01-28 10:00:00,412,610,1298,666,2986,5258
2022-01-28 10:00:00,2022-01-28 11:00:00,425,642,970,627,2664,5155
2022-01-28 11:00:00,2022-01-28 12:00:00,458,555,862,739,2614,4934
2022-01-28 12:00:00,2022-01-28 13:00:00,468,342,791,719,2320,4772
2022-01-28 13:00:00,2022-01-28 14:00:00,533,138,848,823,2342,4675
2022-01-28 14:00:00,2022-01-28 15:00:00,526,20,920,792,2258,4845
2022-01-28 15:00:00,2022-01-28 16:00:00,529,3,855,820,2207,5294
2022-01-28 16:00:00,2022-01-28 17:00:00,596,3,917,1034,2550,5060
2022-01-28 17:00:00,2022-01-28 18:00:00,591,3,1212,1376,3182,4721
2022-01-28 18:00:00,2022-01-28 19:00:00,549,3,1507,1766,3825,4454
2022-01-28 19:00:00,2022-01-28 20:00:00,424,3,1505,2189,4121,4261
2022-01-28 20:00:00,2022-01-28 21:00:00,418,3,1538,2505,4464,4061
2022-01-28 21:00:00,2022-01-28 22:00:00,404,3,1721,2792,4920,3914
2022-01-28 22:00:00,2022-01-28 23:00:00,431,3,1892,2840,5166,3786
2022-01-28 23:00:00,2022-01-29 00:00:00,405,3,1942,2458,4808,3687
2022-01-29 00:00:00,2022-01-29 01:00:00,440,3,2026,2283,4752,3598
2022-01-29 01:00:00,2022-01-29 02:00:00,468,3,1849,2167,4487,3651
2022-01-29 02:00:00,2022-01-29 03:00:00,456,3,1970,2311,4740,3600
2022-01-29 03:00:00,2022-01-29 04:00:00,402,3,1905,2247,4557,3634
2022-01-29 04:00:00,2022-01-29 05:00:00,402,3,1900,2109,4414,3929
2022-01-29 05:00:00,2022-01-29 06:00:00,404,3,1804,2236,4447,4197
2022-01-29 06:00:00,2022-01-29 07:00:00,395,4,1843,2322,4564,4422
2022-01-29 07:00:00,2022-01-29 08:00:00,394,21,1851,2365,4631,4683
2022-01-29 08:00:00,2022-01-29 09:00:00,390,59,1893,2966,5308,4745
2022-01-29 09:00:00,2022-01-29 10:00:00,389,84,1927,2970,5370,4671
2022-01-29 10:00:00,2022-01-29 11:00:00,403,94,1989,3045,5531,4648
2022-01-29 11:00:00,2022-01-29 12:00:00,401,79,1878,3208,5566,4623
2022-01-29 12:00:00,2022-01-29 13:00:00,413,69,1840,3093,5415,4478
2022-01-29 13:00:00,2022-01-29 14:00:00,416,64,1739,3251,5470,4487
2022-01-29 14:00:00,2022-01-29 15:00:00,415,8,1669,3001,5093,4527
2022-01-29 15:00:00,2022-01-29 16:00:00,530,3,1588,2428,4549,4893
2022-01-29 16:00:00,2022-01-29 17:00:00,621,3,975,2236,3835,4791
2022-01-29 17:00:00,2022-01-29 18:00:00,576,3,608,2164,3351,4467
2022-01-29 18:00:00,2022-01-29 19:00:00,561,4,662,2190,3417,4260
2022-01-29 19:00:00,2022-01-29 20:00:00,452,4,615,2142,3213,4051
2022-01-29 20:00:00,2022-01-29 21:00:00,533,4,635,2072,3244,3875
2022-01-29 21:00:00,2022-01-29 22:00:00,590,4,569,1847,3010,3699
2022-01-29 22:00:00,2022-01-29 23:00:00,435,4,590,1949,2978,3607
2022-01-29 23:00:00,2022-01-30 00:00:00,403,4,618,1909,2934,3512
2022-01-30 00:00:00,2022-01-30 01:00:00,435,4,658,1546,2643,3417
2022-01-30 01:00:00,2022-01-30 02:00:00,443,4,621,1377,2445,3386
2022-01-30 02:00:00,2022-01-30 03:00:00,401,4,583,1543,2531,3384
2022-01-30 03:00:00,2022-01-30 04:00:00,402,4,623,1880,2909,3408
2022-01-30 04:00:00,2022-01-30 05:00:00,402,4,749,2303,3458,3606
2022-01-30 05:00:00,2022-01-30 06:00:00,452,4,978,2520,3954,3850
2022-01-30 06:00:00,2022-01-30 07:00:00,380,20,1059,2749,4208,4071
2022-01-30 07:00:00,2022-01-30 08:00:00,375,162,1124,3049,4710,4263
2022-01-30 08:00:00,2022-01-30 09:00:00,380,413,1395,3213,5401,4317
2022-01-30 09:00:00,2022-01-30 10:00:00,378,608,1830,3370,6186,4508
2022-01-30 10:00:00,2022-01-30 11:00:00,394,671,2019,2977,6061,4493
2022-01-30 11:00:00,2022-01-30 12:00:00,370,638,1982,3198,6188,4450
2022-01-30 12:00:00,2022-01-30 13:00:00,368,440,2033,3156,5997,4449
2022-01-30 13:00:00,2022-01-30 14:00:00,437,196,2020,2659,5312,4465
2022-01-30 14:00:00,2022-01-30 15:00:00,511,28,2010,2341,4890,4592
2022-01-30 15:00:00,2022-01-30 16:00:00,580,3,1903,1895,4381,5011
2022-01-30 16:00:00,2022-01-30 17:00:00,561,3,1899,1526,3989,5016
2022-01-30 17:00:00,2022-01-30 18:00:00,518,3,1849,1201,3571,4776
2022-01-30 18:00:00,2022-01-30 19:00:00,500,3,1563,991,3057,4441
2022-01-30 19:00:00,2022-01-30 20:00:00,608,3,1174,551,2336,4224
2022-01-30 20:00:00,2022-01-30 21:00:00,589,3,968,315,1875,3968
2022-01-30 21:00:00,2022-01-30 22:00:00,506,3,794,270,1573,3760
2022-01-30 22:00:00,2022-01-30 23:00:00,564,3,665,276,1508,3552
2022-01-30 23:00:00,2022-01-31 00:00:00,618,3,557,297,1475,3519
2022-01-31 00:00:00,2022-01-31 01:00:00,578,3,572,309,1462,3458
2022-01-31 01:00:00,2022-01-31 02:00:00,585,3,402,375,1365,3452
2022-01-31 02:00:00,2022-01-31 03:00:00,562,3,428,368,1361,3519
2022-01-31 03:00:00,2022-01-31 04:00:00,615,3,574,409,1601,3733
2022-01-31 04:00:00,2022-01-31 05:00:00,678,3,521,333,1535,4360
2022-01-31 05:00:00,2022-01-31 06:00:00,705,3,415,251,1374,4792
2022-01-31 06:00:00,2022-01-31 07:00:00,733,12,345,168,1258,5059
2022-01-31 07:00:00,2022-01-31 08:00:00,650,75,296,122,1143,5243
2022-01-31 08:00:00,2022-01-31 09:00:00,668,158,159,73,1058,5291
2022-01-31 09:00:00,2022-01-31 10:00:00,673,211,13,45,942,5188
2022-01-31 10:00:00,2022-01-31 11:00:00,690,182,0,37,909,5022
2022-01-31 11:00:00,2022-01-31 12:00:00,653,209,18,31,911,5019
2022-01-31 12:00:00,2022-01-31 13:00:00,679,175,60,28,942,4973
2022-01-31 13:00:00,2022-01-31 14:00:00,698,92,63,34,887,4954
2022-01-31 14:00:00,2022-01-31 15:00:00,696,23,52,45,816,5049
2022-01-31 15:00:00,2022-01-31 16:00:00,743,3,71,74,891,5533
2022-01-31 16:00:00,2022-01-31 17:00:00,736,3,112,101,952,5383
2022-01-31 17:00:00,2022-01-31 18:00:00,735,3,492,147,1377,5014
2022-01-31 18:00:00,2022-01-31 19:00:00,755,3,855,367,1980,4756
2022-01-31 19:00:00,2022-01-31 20:00:00,725,3,836,647,2211,4523
2022-01-31 20:00:00,2022-01-31 21:00:00,722,3,895,909,2529,4269
2022-01-31 21:00:00,2022-01-31 22:00:00,725,3,1016,1234,2978,4004
2022-01-31 22:00:00,2022-01-31 23:00:00,748,3,1090,1404,3245,3805
2022-01-31 23:00:00,2022-02-01 00:00:00,740,3,1214,1359,3316,3652
2022-02-01 00:00:00,2022-02-01 01:00:00,743,3,1287,1521,3554,3598
2022-02-01 01:00:00,2022-02-01 02:00:00,750,3,1484,1590,3827,3565
2022-02-01 02:00:00,2022-02-01 03:00:00,768,3,1583,1470,3824,3661
2022-02-01 03:00:00,2022-02-01 04:00:00,758,3,1756,1215,3732,3911
2022-02-01 04:00:00,2022-02-01 05:00:00,759,3,1807,1010,3579,4518
2022-02-01 05:00:00,2022-02-01 06:00:00,830,3,1819,1086,3738,5142
2022-02-01 06:00:00,2022-02-01 07:00:00,895,7,1737,1344,3983,5309
2022-02-01 07:00:00,2022-02-01 08:00:00,860,38,1693,1980,4571,5369
2022-02-01 08:00:00,2022-02-01 09:00:00,851,64,1633,2468,5016,5457
2022-02-01 09:00:00,2022-02-01 10:00:00,800,93,1898,2830,5621,5503
2022-02-01 10:00:00,2022-02-01 11:00:00,798,113,2066,3088,6065,5450
2022-02-01 11:00:00,2022-02-01 12:00:00,801,127,2069,3396,6393,5447
2022-02-01 12:00:00,2022-02-01 13:00:00,792,172,2085,3514,6563,5318
2022-02-01 13:00:00,2022-02-01 14:00:00,812,103,2081,3631,6627,5151
2022-02-01 14:00:00,2022-02-01 15:00:00,805,18,2073,3701,6597,5149
2022-02-01 15:00:00,2022-02-01 16:00:00,811,3,2071,3665,6550,5592
2022-02-01 16:00:00,2022-02-01 17:00:00,828,3,2076,3499,6406,5497
2022-02-01 17:00:00,2022-02-01 18:00:00,808,3,2085,3395,6291,5195
2022-02-01 18:00:00,2022-02-01 19:00:00,790,3,2085,3277,6155,4864
2022-02-01 19:00:00,2022-02-01 20:00:00,707,3,2040,3237,5987,4676
2022-02-01 20:00:00,2022-02-01 21:00:00,824,3,1828,3252,5907,4322
2022-02-01 21:00:00,2022-02-01 22:00:00,735,3,1694,3189,5621,4158
2022-02-01 22:00:00,2022-02-01 23:00:00,699,3,1680,3407,5789,3925
2022-02-01 23:00:00,2022-02-02 00:00:00,668,3,1922,3158,5751,3888
2022-02-02 00:00:00,2022-02-02 01:00:00,653,3,2075,3088,5819,3847
2022-02-02 01:00:00,2022-02-02 02:00:00,655,3,2037,2823,5518,3794
2022-02-02 02:00:00,2022-02-02 03:00:00,650,3,2021,2720,5394,3877
2022-02-02 03:00:00,2022-02-02 04:00:00,706,3,1910,2854,5473,4077
2022-02-02 04:00:00,2022-02-02 05:00:00,746,3,1936,2400,5085,4649
2022-02-02 05:00:00,2022-02-02 06:00:00,722,3,2029,2560,5314,5307
2022-02-02 06:00:00,2022-02-02 07:00:00,774,21,1751,2119,4665,5470
2022-02-02 07:00:00,2022-02-02 08:00:00,830,153,1616,1969,4568,5401
2022-02-02 08:00:00,2022-02-02 09:00:00,796,392,1832,2094,5114,5610
2022-02-02 09:00:00,2022-02-02 10:00:00,720,590,1743,2205,5258,5611
2022-02-02 10:00:00,2022-02-02 11:00:00,790,653,1715,2376,5534,5462
2022-02-02 11:00:00,2022-02-02 12:00:00,730,479,1513,2519,5241,5369
2022-02-02 12:00:00,2022-02-02 13:00:00,793,371,1337,2582,5083,5283
2022-02-02 13:00:00,2022-02-02 14:00:00,786,197,1134,2138,4255,5110
2022-02-02 14:00:00,2022-02-02 15:00:00,882,59,997,1690,3628,5085
2022-02-02 15:00:00,2022-02-02 16:00:00,956,3,916,1314,3189,5514
2022-02-02 16:00:00,2022-02-02 17:00:00,985,3,991,935,2914,5390
2022-02-02 17:00:00,2022-02-02 18:00:00,974,3,1015,848,2840,5055
2022-02-02 18:00:00,2022-02-02 19:00:00,918,3,1021,1199,3141,4765
2022-02-02 19:00:00,2022-02-02 20:00:00,905,3,979,1399,3286,4497
2022-02-02 20:00:00,2022-02-02 21:00:00,904,3,964,1328,3199,4190
2022-02-02 21:00:00,2022-02-02 22:00:00,893,3,989,1466,3351,3952
2022-02-02 22:00:00,2022-02-02 23:00:00,870,3,1311,1465,3649,3778
2022-02-02 23:00:00,2022-02-03 00:00:00,759,3,1089,1293,3144,3673
2022-02-03 00:00:00,2022-02-03 01:00:00,889,3,1185,923,3000,3638
2022-02-03 01:00:00,2022-02-03 02:00:00,829,3,1197,686,2715,3617
2022-02-03 02:00:00,2022-02-03 03:00:00,867,3,1102,596,2568,3661
2022-02-03 03:00:00,2022-02-03 04:00:00,799,3,1083,672,2557,3900
2022-02-03 04:00:00,2022-02-03 05:00:00,890,3,929,926,2748,4464
2022-02-03 05:00:00,2022-02-03 06:00:00,955,3,1199,1128,3285,5056
2022-02-03 06:00:00,2022-02-03 07:00:00,960,5,1407,1301,3673,5192
2022-02-03 07:00:00,2022-02-03 08:00:00,929,17,1618,1580,4144,5246
2022-02-03 08:00:00,2022-02-03 09:00:00,921,37,1667,1616,4241,5328
2022-02-03 09:00:00,2022-02-03 10:00:00,941,49,1780,1518,4288,5315
2022-02-03 10:00:00,2022-02-03 11:00:00,942,60,1826,1610,4438,5242
2022-02-03 11:00:00,2022-02-03 12:00:00,918,64,1677,1682,4341,5227
2022-02-03 12:00:00,2022-02-03 13:00:00,905,51,1455,1623,4034,5116
2022-02-03 13:00:00,2022-02-03 14:00:00,901,32,1368,1449,3750,4983
2022-02-03 14:00:00,2022-02-03 15:00:00,924,8,1205,1337,3474,5028
2022-02-03 15:00:00,2022-02-03 16:00:00,985,3,1212,1287,3487,5384
2022-02-03 16:00:00,2022-02-03 17:00:00,975,3,1192,1317,3487,5240
2022-02-03 17:00:00,2022-02-03 18:00:00,908,3,1137,1306,3354,4913
2022-02-03 18:00:00,2022-02-03 19:00:00,879,3,1219,1224,3325,4646
2022-02-03 19:00:00,2022-02-03 20:00:00,825,3,1267,1283,3378,4389
2022-02-03 20:00:00,2022-02-03 21:00:00,760,3,1345,1359,3467,4094
2022-02-03 21:00:00,2022-02-03 22:00:00,695,3,1356,1421,3475,3808
2022-02-03 22:00:00,2022-02-03 23:00:00,788,3,1197,1529,3517,3590
2022-02-03 23:00:00,2022-02-04 00:00:00,801,3,1138,1698,3640,3476
2022-02-04 00:00:00,2022-02-04 01:00:00,809,3,1469,1908,4189,3384
2022-02-04 01:00:00,2022-02-04 02:00:00,726,3,1622,2208,4559,3401
2022-02-04 02:00:00,2022-02-04 03:00:00,780,3,1758,2572,5113,3456
2022-02-04 03:00:00,2022-02-04 04:00:00,851,3,1727,2829,5410,3659
2022-02-04 04:00:00,2022-02-04 05:00:00,852,3,1758,2989,5602,4275
2022-02-04 05:00:00,2022-02-04 06:00:00,850,3,1886,2952,5691,4939
2022-02-04 06:00:00,2022-02-04 07:00:00,915,5,1803,2492,5215,5152
2022-02-04 07:00:00,2022-02-04 08:00:00,884,20,1611,1977,4492,5193
2022-02-04 08:00:00,2022-02-04 09:00:00,683,46,1503,1578,3810,5281
2022-02-04 09:00:00,2022-02-04 10:00:00,650,67,1564,1494,3775,5242
2022-02-04 10:00:00,2022-02-04 11:00:00,590,81,1587,1574,3832,5169
2022-02-04 11:00:00,2022-02-04 12:00:00,489,77,1467,1489,3522,5110
2022-02-04 12:00:00,2022-02-04 13:00:00,503,63,1321,1370,3257,4993
2022-02-04 13:00:00,2022-02-04 14:00:00,692,43,1337,1216,3288,4875
2022-02-04 14:00:00,2022-02-04 15:00:00,657,15,1392,1193,3257,4882
2022-02-04 15:00:00,2022-02-04 16:00:00,610,3,1674,1318,3605,5239
2022-02-04 16:00:00,2022-02-04 17:00:00,809,3,1654,1464,3930,5210
2022-02-04 17:00:00,2022-02-04 18:00:00,876,3,1776,1542,4197,4789
2022-02-04 18:00:00,2022-02-04 19:00:00,678,3,1802,1706,4189,4654
2022-02-04 19:00:00,2022-02-04 20:00:00,579,3,1835,1873,4290,4492
2022-02-04 20:00:00,2022-02-04 21:00:00,701,3,1841,1932,4477,4193
2022-02-04 21:00:00,2022-02-04 22:00:00,596,3,1929,1844,4372,4079
2022-02-04 22:00:00,2022-02-04 23:00:00,414,3,1947,1895,4259,3958
2022-02-04 23:00:00,2022-02-05 00:00:00,430,3,1932,1697,4062,3838
2022-02-05 00:00:00,2022-02-05 01:00:00,515,3,1988,1770,4276,3775
2022-02-05 01:00:00,2022-02-05 02:00:00,451,3,1962,1695,4111,3749
2022-02-05 02:00:00,2022-02-05 03:00:00,434,3,1956,1796,4189,3731
2022-02-05 03:00:00,2022-02-05 04:00:00,443,3,1861,1880,4187,3821
2022-02-05 04:00:00,2022-02-05 05:00:00,468,3,1809,2009,4289,3932
2022-02-05 05:00:00,2022-02-05 06:00:00,467,3,2026,2303,4799,4306
2022-02-05 06:00:00,2022-02-05 07:00:00,490,36,2004,2269,4799,4521
2022-02-05 07:00:00,2022-02-05 08:00:00,500,192,2023,2627,5342,4649
2022-02-05 08:00:00,2022-02-05 09:00:00,602,364,2035,2550,5551,4730
2022-02-05 09:00:00,2022-02-05 10:00:00,629,509,2027,2459,5624,4727
2022-02-05 10:00:00,2022-02-05 11:00:00,611,412,2014,2647,5684,4626
2022-02-05 11:00:00,2022-02-05 12:00:00,537,459,2014,2804,5814,4681
2022-02-05 12:00:00,2022-02-05 13:00:00,601,230,2049,2596,5476,4515
2022-02-05 13:00:00,2022-02-05 14:00:00,766,121,2051,2619,5557,4533
2022-02-05 14:00:00,2022-02-05 15:00:00,672,21,1990,3076,5759,4659
2022-02-05 15:00:00,2022-02-05 16:00:00,743,3,2028,3520,6294,5083
2022-02-05 16:00:00,2022-02-05 17:00:00,817,3,2059,3409,6288,5063
2022-02-05 17:00:00,2022-02-05 18:00:00,624,3,2032,3319,5978,4804
2022-02-05 18:00:00,2022-02-05 19:00:00,612,3,2059,3226,5900,4565
2022-02-05 19:00:00,2022-02-05 20:00:00,500,3,2058,3508,6069,4330
2022-02-05 20:00:00,2022-02-05 21:00:00,376,3,2051,3616,6046,4182
2022-02-05 21:00:00,2022-02-05 22:00:00,347,3,2047,3563,5960,3967
2022-02-05 22:00:00,2022-02-05 23:00:00,425,3,2038,3195,5661,3888
2022-02-05 23:00:00,2022-02-06 00:00:00,395,3,2045,2940,5383,3721
2022-02-06 00:00:00,2022-02-06 01:00:00,433,3,2000,2567,5003,3513
2022-02-06 01:00:00,2022-02-06 02:00:00,449,3,1819,2314,4585,3474
2022-02-06 02:00:00,2022-02-06 03:00:00,408,3,1909,2267,4587,3471
2022-02-06 03:00:00,2022-02-06 04:00:00,482,3,1946,2102,4533,3565
2022-02-06 04:00:00,2022-02-06 05:00:00,469,3,1939,2035,4446,3662
2022-02-06 05:00:00,2022-02-06 06:00:00,522,3,1893,1954,4372,3883
2022-02-06 06:00:00,2022-02-06 07:00:00,606,22,1835,2202,4665,4093
2022-02-06 07:00:00,2022-02-06 08:00:00,674,131,1892,2357,5054,4290
2022-02-06 08:00:00,2022-02-06 09:00:00,712,241,1719,2247,4919,4424
2022-02-06 09:00:00,2022-02-06 10:00:00,753,298,1666,1947,4664,4436
2022-02-06 10:00:00,2022-02-06 11:00:00,731,298,1573,1934,4536,4484
2022-02-06 11:00:00,2022-02-06 12:00:00,787,250,1670,1754,4461,4443
2022-02-06 12:00:00,2022-02-06 13:00:00,738,226,1818,1680,4462,4394
2022-02-06 13:00:00,2022-02-06 14:00:00,792,150,1713,1486,4141,4408
2022-02-06 14:00:00,2022-02-06 15:00:00,852,29,1555,1452,3888,4518
2022-02-06 15:00:00,2022-02-06 16:00:00,888,3,1429,1330,3650,5023
2022-02-06 16:00:00,2022-02-06 17:00:00,917,3,1363,1271,3554,5029
2022-02-06 17:00:00,2022-02-06 18:00:00,901,3,1492,1137,3533,4684
2022-02-06 18:00:00,2022-02-06 19:00:00,877,3,1506,1169,3555,4409
2022-02-06 19:00:00,2022-02-06 20:00:00,839,3,1562,1174,3578,4190
2022-02-06 20:00:00,2022-02-06 21:00:00,853,3,1654,1365,3875,3946
2022-02-06 21:00:00,2022-02-06 22:00:00,785,3,1625,1703,4116,3808
2022-02-06 22:00:00,2022-02-06 23:00:00,521,3,1900,2008,4432,3789
2022-02-06 23:00:00,2022-02-07 00:00:00,373,3,1920,2190,4486,3815
2022-02-07 00:00:00,2022-02-07 01:00:00,361,3,2009,2639,5012,3785
2022-02-07 01:00:00,2022-02-07 02:00:00,426,3,1964,2814,5207,3787
2022-02-07 02:00:00,2022-02-07 03:00:00,420,3,1961,3020,5404,3851
2022-02-07 03:00:00,2022-02-07 04:00:00,601,3,2021,3188,5813,4084
2022-02-07 04:00:00,2022-02-07 05:00:00,648,3,2027,3382,6060,4654
2022-02-07 05:00:00,2022-02-07 06:00:00,811,3,2064,3445,6323,5310
2022-02-07 06:00:00,2022-02-07 07:00:00,842,66,2043,3201,6152,5305
2022-02-07 07:00:00,2022-02-07 08:00:00,821,252,2050,3499,6622,5460
2022-02-07 08:00:00,2022-02-07 09:00:00,765,507,2055,3643,6970,5477
2022-02-07 09:00:00,2022-02-07 10:00:00,608,683,2041,3427,6759,5473
2022-02-07 10:00:00,2022-02-07 11:00:00,644,643,2010,3071,6368,5392
2022-02-07 11:00:00,2022-02-07 12:00:00,669,554,2026,2811,6060,5371
2022-02-07 12:00:00,2022-02-07 13:00:00,711,462,2026,2741,5940,5274
2022-02-07 13:00:00,2022-02-07 14:00:00,820,221,2055,2635,5731,5212
2022-02-07 14:00:00,2022-02-07 15:00:00,671,56,2022,2176,4925,5287
2022-02-07 15:00:00,2022-02-07 16:00:00,786,4,1993,1958,4741,5644
2022-02-07 16:00:00,2022-02-07 17:00:00,772,3,1961,1972,4708,5570
2022-02-07 17:00:00,2022-02-07 18:00:00,664,3,1770,1906,4343,5214
2022-02-07 18:00:00,2022-02-07 19:00:00,750,3,1817,1690,4260,4847
2022-02-07 19:00:00,2022-02-07 20:00:00,866,3,1859,1586,4314,4580
2022-02-07 20:00:00,2022-02-07 21:00:00,794,3,1776,1986,4559,4252
2022-02-07 21:00:00,2022-02-07 22:00:00,755,3,1727,2404,4889,4106
2022-02-07 22:00:00,2022-02-07 23:00:00,600,3,1820,2666,5089,3930
2022-02-07 23:00:00,2022-02-08 00:00:00,426,3,1870,2776,5075,3850
2022-02-08 00:00:00,2022-02-08 01:00:00,364,3,1876,2667,4910,3769
2022-02-08 01:00:00,2022-02-08 02:00:00,375,3,1925,2989,5292,3748
2022-02-08 02:00:00,2022-02-08 03:00:00,360,3,1996,2880,5239,3811
2022-02-08 03:00:00,2022-02-08 04:00:00,388,3,1960,3012,5363,3993
2022-02-08 04:00:00,2022-02-08 05:00:00,520,3,1996,3071,5590,4650
2022-02-08 05:00:00,2022-02-08 06:00:00,564,3,2034,3066,5667,5246
2022-02-08 06:00:00,2022-02-08 07:00:00,645,12,1991,2956,5604,5442
2022-02-08 07:00:00,2022-02-08 08:00:00,682,57,1887,3046,5672,5404
2022-02-08 08:00:00,2022-02-08 09:00:00,706,242,1867,2918,5733,5388
2022-02-08 09:00:00,2022-02-08 10:00:00,701,428,1885,2992,6006,5255
2022-02-08 10:00:00,2022-02-08 11:00:00,618,565,1869,2982,6034,5147
2022-02-08 11:00:00,2022-02-08 12:00:00,547,560,1915,2342,5364,5195
2022-02-08 12:00:00,2022-02-08 13:00:00,504,462,1878,2101,4945,5159
2022-02-08 13:00:00,2022-02-08 14:00:00,458,294,1848,1906,4506,5024
2022-02-08 14:00:00,2022-02-08 15:00:00,456,73,1666,1637,3832,5024
2022-02-08 15:00:00,2022-02-08 16:00:00,563,5,1544,1542,3654,5465
2022-02-08 16:00:00,2022-02-08 17:00:00,557,3,1655,1368,3583,5369
2022-02-08 17:00:00,2022-02-08 18:00:00,521,3,1575,1665,3764,4981
2022-02-08 18:00:00,2022-02-08 19:00:00,487,3,1631,1429,3550,4778
2022-02-08 19:00:00,2022-02-08 20:00:00,459,3,1683,1499,3644,4494
2022-02-08 20:00:00,2022-02-08 21:00:00,464,3,1789,1443,3699,4256
2022-02-08 21:00:00,2022-02-08 22:00:00,558,3,1697,1456,3714,3962
2022-02-08 22:00:00,2022-02-08 23:00:00,589,4,1550,1402,3545,3803
2022-02-08 23:00:00,2022-02-09 00:00:00,641,4,1544,1524,3713,3650
2022-02-09 00:00:00,2022-02-09 01:00:00,530,4,1593,1672,3799,3627
2022-02-09 01:00:00,2022-02-09 02:00:00,619,3,1464,1482,3568,3652
2022-02-09 02:00:00,2022-02-09 03:00:00,748,3,1480,1530,3761,3669
2022-02-09 03:00:00,2022-02-09 04:00:00,721,3,1641,1500,3865,3903
2022-02-09 04:00:00,2022-02-09 05:00:00,685,3,1690,1702,4080,4441
2022-02-09 05:00:00,2022-02-09 06:00:00,663,3,1760,2427,4853,5115
2022-02-09 06:00:00,2022-02-09 07:00:00,640,17,1813,1935,4405,5304
2022-02-09 07:00:00,2022-02-09 08:00:00,611,57,1865,2198,4731,5332
2022-02-09 08:00:00,2022-02-09 09:00:00,721,136,1947,2468,5272,5362
2022-02-09 09:00:00,2022-02-09 10:00:00,775,346,1906,2680,5707,5425
2022-02-09 10:00:00,2022-02-09 11:00:00,771,496,1879,2487,5633,5375
2022-02-09 11:00:00,2022-02-09 12:00:00,627,454,1923,2568,5572,5289
2022-02-09 12:00:00,2022-02-09 13:00:00,558,367,1929,2899,5753,5209
2022-02-09 13:00:00,2022-02-09 14:00:00,648,232,1916,2585,5381,5014
2022-02-09 14:00:00,2022-02-09 15:00:00,564,72,1888,2514,5038,4953
2022-02-09 15:00:00,2022-02-09 16:00:00,654,6,1811,2324,4795,5375
2022-02-09 16:00:00,2022-02-09 17:00:00,762,3,1841,2316,4922,5323
2022-02-09 17:00:00,2022-02-09 18:00:00,730,3,1836,2274,4843,4991
2022-02-09 18:00:00,2022-02-09 19:00:00,820,3,1796,2210,4829,4694
2022-02-09 19:00:00,2022-02-09 20:00:00,871,3,1738,2135,4747,4420
2022-02-09 20:00:00,2022-02-09 21:00:00,884,3,1707,2115,4709,4166
2022-02-09 21:00:00,2022-02-09 22:00:00,904,3,1660,1899,4466,3895
2022-02-09 22:00:00,2022-02-09 23:00:00,890,3,1565,1870,4328,3711
2022-02-09 23:00:00,2022-02-10 00:00:00,895,3,1566,1881,4345,3618
2022-02-10 00:00:00,2022-02-10 01:00:00,901,3,1523,1799,4226,3554
2022-02-10 01:00:00,2022-02-10 02:00:00,850,3,1474,1746,4073,3554
2022-02-10 02:00:00,2022-02-10 03:00:00,845,3,1298,1647,3793,3600
2022-02-10 03:00:00,2022-02-10 04:00:00,837,3,1268,1526,3634,3794
2022-02-10 04:00:00,2022-02-10 05:00:00,919,3,1264,1449,3635,4299
2022-02-10 05:00:00,2022-02-10 06:00:00,897,3,1304,1448,3652,4873
2022-02-10 06:00:00,2022-02-10 07:00:00,843,30,1340,1466,3679,5160
2022-02-10 07:00:00,2022-02-10 08:00:00,0,118,1500,1312,2930,5232
2022-02-10 08:00:00,2022-02-10 09:00:00,675,266,1296,1390,3627,5227
2022-02-10 09:00:00,2022-02-10 10:00:00,613,376,1247,1547,3783,5168
2022-02-10 10:00:00,2022-02-10 11:00:00,555,456,1233,1749,3993,5194
2022-02-10 11:00:00,2022-02-10 12:00:00,606,379,1282,1914,4181,5072
2022-02-10 12:00:00,2022-02-10 13:00:00,609,365,1307,1969,4250,5010
2022-02-10 13:00:00,2022-02-10 14:00:00,663,261,1413,1985,4322,4925
2022-02-10 14:00:00,2022-02-10 15:00:00,660,84,1242,1729,3715,4957
2022-02-10 15:00:00,2022-02-10 16:00:00,684,6,1358,1615,3663,5340
2022-02-10 16:00:00,2022-02-10 17:00:00,660,3,1477,1523,3663,5349
2022-02-10 17:00:00,2022-02-10 18:00:00,642,3,1452,1487,3584,5038
2022-02-10 18:00:00,2022-02-10 19:00:00,639,3,1478,1347,3467,4830
2022-02-10 19:00:00,2022-02-10 20:00:00,653,3,1478,1244,3378,4520
2022-02-10 20:00:00,2022-02-10 21:00:00,653,3,1232,1103,2991,4237
2022-02-10 21:00:00,2022-02-10 22:00:00,598,3,1228,962,2791,3994
2022-02-10 22:00:00,2022-02-10 23:00:00,641,3,985,726,2355,3995
2022-02-10 23:00:00,2022-02-11 00:00:00,609,3,868,609,2089,3931
2022-02-11 00:00:00,2022-02-11 01:00:00,635,3,687,619,1944,3854
2022-02-11 01:00:00,2022-02-11 02:00:00,623,3,622,514,1762,3733
2022-02-11 02:00:00,2022-02-11 03:00:00,647,3,578,449,1677,3805
2022-02-11 03:00:00,2022-02-11 04:00:00,693,3,460,582,1738,4034
2022-02-11 04:00:00,2022-02-11 05:00:00,680,3,673,823,2179,4710
2022-02-11 05:00:00,2022-02-11 06:00:00,649,3,1070,982,2704,5204
2022-02-11 06:00:00,2022-02-11 07:00:00,669,23,1066,1135,2893,5333
2022-02-11 07:00:00,2022-02-11 08:00:00,662,120,1126,1319,3227,5313
2022-02-11 08:00:00,2022-02-11 09:00:00,657,342,1302,1603,3904,5320
2022-02-11 09:00:00,2022-02-11 10:00:00,616,595,1386,1930,4527,5298
2022-02-11 10:00:00,2022-02-11 11:00:00,580,861,1543,2287,5271,5280
2022-02-11 11:00:00,2022-02-11 12:00:00,594,878,1610,2298,5380,5080
2022-02-11 12:00:00,2022-02-11 13:00:00,559,775,1589,2238,5161,4894
2022-02-11 13:00:00,2022-02-11 14:00:00,598,474,1714,2086,4872,4838
2022-02-11 14:00:00,2022-02-11 15:00:00,711,147,1547,1624,4029,4805
2022-02-11 15:00:00,2022-02-11 16:00:00,756,8,1189,1134,3087,5138
2022-02-11 16:00:00,2022-02-11 17:00:00,863,3,1041,862,2769,5168
2022-02-11 17:00:00,2022-02-11 18:00:00,869,3,852,721,2445,4804
2022-02-11 18:00:00,2022-02-11 19:00:00,983,3,594,781,2361,4436
2022-02-11 19:00:00,2022-02-11 20:00:00,1053,3,579,968,2603,4219
2022-02-11 20:00:00,2022-02-11 21:00:00,868,3,712,1185,2768,4045
2022-02-11 21:00:00,2022-02-11 22:00:00,755,3,863,1401,3022,3932
2022-02-11 22:00:00,2022-02-11 23:00:00,585,3,972,1577,3137,3869
2022-02-11 23:00:00,2022-02-12 00:00:00,590,3,1002,1714,3309,3734
2022-02-12 00:00:00,2022-02-12 01:00:00,591,3,1163,1772,3529,3662
2022-02-12 01:00:00,2022-02-12 02:00:00,593,3,1305,1888,3789,3597
2022-02-12 02:00:00,2022-02-12 03:00:00,594,3,1389,1992,3978,3559
2022-02-12 03:00:00,2022-02-12 04:00:00,594,3,1545,2074,4216,3677
2022-02-12 04:00:00,2022-02-12 05:00:00,590,3,1577,2185,4355,3866
2022-02-12 05:00:00,2022-02-12 06:00:00,589,5,1574,2303,4471,4086
2022-02-12 06:00:00,2022-02-12 07:00:00,593,67,1643,2471,4774,4289
2022-02-12 07:00:00,2022-02-12 08:00:00,552,238,1746,2687,5223,4467
2022-02-12 08:00:00,2022-02-12 09:00:00,532,447,1825,2974,5778,4598
2022-02-12 09:00:00,2022-02-12 10:00:00,495,490,1862,3225,6072,4622
2022-02-12 10:00:00,2022-02-12 11:00:00,539,425,1948,3361,6273,4511
2022-02-12 11:00:00,2022-02-12 12:00:00,503,342,1873,3412,6130,4532
2022-02-12 12:00:00,2022-02-12 13:00:00,532,232,1895,3394,6053,4567
2022-02-12 13:00:00,2022-02-12 14:00:00,520,151,1950,3032,5653,4543
2022-02-12 14:00:00,2022-02-12 15:00:00,492,46,1949,3206,5693,4660
2022-02-12 15:00:00,2022-02-12 16:00:00,493,4,1981,3273,5751,5062
2022-02-12 16:00:00,2022-02-12 17:00:00,509,3,1959,3402,5873,4946
2022-02-12 17:00:00,2022-02-12 18:00:00,505,3,1895,3378,5781,4717
2022-02-12 18:00:00,2022-02-12 19:00:00,498,3,1975,2932,5408,4500
2022-02-12 19:00:00,2022-02-12 20:00:00,526,3,1688,2455,4672,4354
2022-02-12 20:00:00,2022-02-12 21:00:00,506,3,1662,2405,4576,4195
2022-02-12 21:00:00,2022-02-12 22:00:00,482,3,1653,2302,4440,4021
2022-02-12 22:00:00,2022-02-12 23:00:00,534,3,1669,2251,4457,3836
2022-02-12 23:00:00,2022-02-13 00:00:00,568,3,1760,2569,4900,3639
2022-02-13 00:00:00,2022-02-13 01:00:00,563,3,1653,2224,4443,3613
2022-02-13 01:00:00,2022-02-13 02:00:00,550,3,1588,2217,4358,3579
2022-02-13 02:00:00,2022-02-13 03:00:00,515,3,1448,2220,4186,3595
2022-02-13 03:00:00,2022-02-13 04:00:00,497,3,1595,2144,4239,3624
2022-02-13 04:00:00,2022-02-13 05:00:00,480,3,1691,2125,4299,3812
2022-02-13 05:00:00,2022-02-13 06:00:00,517,4,1793,2073,4387,4070
2022-02-13 06:00:00,2022-02-13 07:00:00,581,27,1977,2122,4707,4292
2022-02-13 07:00:00,2022-02-13 08:00:00,548,104,1949,2845,5446,4452
2022-02-13 08:00:00,2022-02-13 09:00:00,565,164,1977,2736,5442,4577
2022-02-13 09:00:00,2022-02-13 10:00:00,508,188,1942,2833,5471,4654
2022-02-13 10:00:00,2022-02-13 11:00:00,505,190,1880,2737,5312,4627
2022-02-13 11:00:00,2022-02-13 12:00:00,553,166,1923,2389,5031,4653
2022-02-13 12:00:00,2022-02-13 13:00:00,586,135,1921,2186,4828,4642
2022-02-13 13:00:00,2022-02-13 14:00:00,623,78,1923,2314,4938,4578
2022-02-13 14:00:00,2022-02-13 15:00:00,700,24,1894,2333,4951,4507
2022-02-13 15:00:00,2022-02-13 16:00:00,678,4,1857,2376,4915,4963
2022-02-13 16:00:00,2022-02-13 17:00:00,741,3,1881,2457,5082,5097
2022-02-13 17:00:00,2022-02-13 18:00:00,791,3,1882,2411,5087,4833
2022-02-13 18:00:00,2022-02-13 19:00:00,757,3,1916,2074,4750,4594
2022-02-13 19:00:00,2022-02-13 20:00:00,734,3,1826,1613,4176,4405
2022-02-13 20:00:00,2022-02-13 21:00:00,672,3,1937,2003,4615,4139
2022-02-13 21:00:00,2022-02-13 22:00:00,511,3,1911,1898,4323,3995
2022-02-13 22:00:00,2022-02-13 23:00:00,409,3,1889,1979,4280,3897
2022-02-13 23:00:00,2022-02-14 00:00:00,410,3,1979,2464,4856,3737
2022-02-14 00:00:00,2022-02-14 01:00:00,391,3,1985,2375,4754,3659
2022-02-14 01:00:00,2022-02-14 02:00:00,378,3,1932,2650,4963,3669
2022-02-14 02:00:00,2022-02-14 03:00:00,395,3,1908,2269,4575,3736
2022-02-14 03:00:00,2022-02-14 04:00:00,396,3,1949,2181,4529,3970
2022-02-14 04:00:00,2022-02-14 05:00:00,444,3,1987,2704,5138,4485
2022-02-14 05:00:00,2022-02-14 06:00:00,601,4,1974,2924,5503,5092
2022-02-14 06:00:00,2022-02-14 07:00:00,746,28,1963,2677,5414,5216
2022-02-14 07:00:00,2022-02-14 08:00:00,839,70,1997,2967,5873,5154
2022-02-14 08:00:00,2022-02-14 09:00:00,745,124,1916,2996,5781,5236
2022-02-14 09:00:00,2022-02-14 10:00:00,714,182,1965,3057,5918,5253
2022-02-14 10:00:00,2022-02-14 11:00:00,637,197,1968,3190,5992,5146
2022-02-14 11:00:00,2022-02-14 12:00:00,608,207,1987,3349,6151,5232
2022-02-14 12:00:00,2022-02-14 13:00:00,656,166,1987,3430,6239,5204
2022-02-14 13:00:00,2022-02-14 14:00:00,689,100,1974,3454,6217,4943
2022-02-14 14:00:00,2022-02-14 15:00:00,658,43,1975,3303,5979,4972
2022-02-14 15:00:00,2022-02-14 16:00:00,897,4,1826,3280,6007,5317
2022-02-14 16:00:00,2022-02-14 17:00:00,919,3,1862,3338,6122,5190
2022-02-14 17:00:00,2022-02-14 18:00:00,860,3,1790,3360,6013,4873
2022-02-14 18:00:00,2022-02-14 19:00:00,701,3,1832,3245,5781,4546
2022-02-14 19:00:00,2022-02-14 20:00:00,500,3,1835,3259,5597,4484
2022-02-14 20:00:00,2022-02-14 21:00:00,463,3,1961,3153,5580,4308
2022-02-14 21:00:00,2022-02-14 22:00:00,444,3,1967,3042,5456,4057
2022-02-14 22:00:00,2022-02-14 23:00:00,440,3,1931,2530,4904,3864
2022-02-14 23:00:00,2022-02-15 00:00:00,391,3,1881,2820,5095,3718
2022-02-15 00:00:00,2022-02-15 01:00:00,383,3,1962,1806,4154,3701
2022-02-15 01:00:00,2022-02-15 02:00:00,390,3,1981,1946,4320,3609
2022-02-15 02:00:00,2022-02-15 03:00:00,373,3,1918,1928,4222,3714
2022-02-15 03:00:00,2022-02-15 04:00:00,387,3,1824,1850,4064,3984
2022-02-15 04:00:00,2022-02-15 05:00:00,529,3,1866,1835,4233,4435
2022-02-15 05:00:00,2022-02-15 06:00:00,693,5,1830,2131,4659,4862
2022-02-15 06:00:00,2022-02-15 07:00:00,742,33,1778,1910,4463,5127
2022-02-15 07:00:00,2022-02-15 08:00:00,709,287,1764,1714,4474,5398
2022-02-15 08:00:00,2022-02-15 09:00:00,757,647,1660,2055,5119,4962
2022-02-15 09:00:00,2022-02-15 10:00:00,795,649,1752,2425,5621,5317
2022-02-15 10:00:00,2022-02-15 11:00:00,715,593,1547,2586,5441,5159
2022-02-15 11:00:00,2022-02-15 12:00:00,600,473,1561,2487,5121,5146
2022-02-15 12:00:00,2022-02-15 13:00:00,635,271,1469,2349,4724,5020
2022-02-15 13:00:00,2022-02-15 14:00:00,645,138,1651,2625,5059,4945
2022-02-15 14:00:00,2022-02-15 15:00:00,626,47,1658,2492,4823,5009
2022-02-15 15:00:00,2022-02-15 16:00:00,630,2,1836,2932,5400,5389
2022-02-15 16:00:00,2022-02-15 17:00:00,726,1,1944,3271,5942,5310
2022-02-15 17:00:00,2022-02-15 18:00:00,671,1,1913,3542,6127,5042
2022-02-15 18:00:00,2022-02-15 19:00:00,614,1,1961,3090,5666,4879
2022-02-15 19:00:00,2022-02-15 20:00:00,583,1,1967,2797,5348,4558
2022-02-15 20:00:00,2022-02-15 21:00:00,547,1,1946,2730,5224,4317
2022-02-15 21:00:00,2022-02-15 22:00:00,451,1,1960,2548,4960,4134
2022-02-15 22:00:00,2022-02-15 23:00:00,442,1,1971,2200,4614,4002
2022-02-15 23:00:00,2022-02-16 00:00:00,413,1,1943,1517,3874,3924
2022-02-16 00:00:00,2022-02-16 01:00:00,449,1,1762,1629,3841,3809
2022-02-16 01:00:00,2022-02-16 02:00:00,461,1,1510,1352,3324,3783
2022-02-16 02:00:00,2022-02-16 03:00:00,485,1,1489,1334,3309,3752
2022-02-16 03:00:00,2022-02-16 04:00:00,589,1,1504,1579,3673,3922
2022-02-16 04:00:00,2022-02-16 05:00:00,589,1,1612,1481,3683,4388
2022-02-16 05:00:00,2022-02-16 06:00:00,628,1,1753,1198,3580,5045
2022-02-16 06:00:00,2022-02-16 07:00:00,689,15,1550,909,3163,5384
2022-02-16 07:00:00,2022-02-16 08:00:00,727,37,1628,907,3299,5462
2022-02-16 08:00:00,2022-02-16 09:00:00,736,55,1826,924,3541,5527
2022-02-16 09:00:00,2022-02-16 10:00:00,651,61,1798,1333,3843,5555
2022-02-16 10:00:00,2022-02-16 11:00:00,643,70,1840,1763,4316,5486
2022-02-16 11:00:00,2022-02-16 12:00:00,657,79,1961,2015,4712,5447
2022-02-16 12:00:00,2022-02-16 13:00:00,665,75,2010,2281,5031,5387
2022-02-16 13:00:00,2022-02-16 14:00:00,682,63,1938,2732,5415,5246
2022-02-16 14:00:00,2022-02-16 15:00:00,844,21,1686,2867,5418,5122
2022-02-16 15:00:00,2022-02-16 16:00:00,717,2,1542,2746,5007,5497
2022-02-16 16:00:00,2022-02-16 17:00:00,706,1,1752,2436,4895,5465
2022-02-16 17:00:00,2022-02-16 18:00:00,619,1,1909,2407,4936,5079
2022-02-16 18:00:00,2022-02-16 19:00:00,612,1,1941,2405,4959,4842
2022-02-16 19:00:00,2022-02-16 20:00:00,543,1,1847,2409,4800,4699
2022-02-16 20:00:00,2022-02-16 21:00:00,412,1,1814,2623,4850,4334
2022-02-16 21:00:00,2022-02-16 22:00:00,255,1,1786,2406,4448,4168
2022-02-16 22:00:00,2022-02-16 23:00:00,231,1,1728,2847,4807,3900
2022-02-16 23:00:00,2022-02-17 00:00:00,231,1,1786,2956,4974,3800
2022-02-17 00:00:00,2022-02-17 01:00:00,225,1,1685,2823,4734,3769
2022-02-17 01:00:00,2022-02-17 02:00:00,240,1,1644,2677,4562,3714
2022-02-17 02:00:00,2022-02-17 03:00:00,225,1,1821,2303,4350,3727
2022-02-17 03:00:00,2022-02-17 04:00:00,247,1,1802,2225,4275,3917
2022-02-17 04:00:00,2022-02-17 05:00:00,455,1,1871,2293,4620,4233
2022-02-17 05:00:00,2022-02-17 06:00:00,493,2,1898,1846,4239,4975
2022-02-17 06:00:00,2022-02-17 07:00:00,526,40,1909,1949,4424,5241
2022-02-17 07:00:00,2022-02-17 08:00:00,562,154,1975,1801,4492,5150
2022-02-17 08:00:00,2022-02-17 09:00:00,505,269,2001,2206,4981,5190
2022-02-17 09:00:00,2022-02-17 10:00:00,380,350,2002,2947,5679,5167
2022-02-17 10:00:00,2022-02-17 11:00:00,327,397,1979,3322,6025,5224
2022-02-17 11:00:00,2022-02-17 12:00:00,270,362,2032,3138,5802,5192
2022-02-17 12:00:00,2022-02-17 13:00:00,363,334,2022,2992,5711,5202
2022-02-17 13:00:00,2022-02-17 14:00:00,449,236,2010,3259,5954,5159
2022-02-17 14:00:00,2022-02-17 15:00:00,498,79,2019,3248,5844,5147
2022-02-17 15:00:00,2022-02-17 16:00:00,581,6,1962,3165,5714,5390
2022-02-17 16:00:00,2022-02-17 17:00:00,544,3,2000,2993,5540,5432
2022-02-17 17:00:00,2022-02-17 18:00:00,479,6,1948,3228,5661,5138
2022-02-17 18:00:00,2022-02-17 19:00:00,431,0,2012,2878,5321,4913
2022-02-17 19:00:00,2022-02-17 20:00:00,295,0,1973,2853,5121,4626
2022-02-17 20:00:00,2022-02-17 21:00:00,305,0,1946,2967,5218,4347
2022-02-17 21:00:00,2022-02-17 22:00:00,285,0,1971,3152,5408,4119
2022-02-17 22:00:00,2022-02-17 23:00:00,334,0,2000,3450,5784,3993
2022-02-17 23:00:00,2022-02-18 00:00:00,280,0,1976,3318,5574,3878
2022-02-18 00:00:00,2022-02-18 01:00:00,302,0,1979,3114,5395,3828
2022-02-18 01:00:00,2022-02-18 02:00:00,283,0,2002,3060,5345,3813
2022-02-18 02:00:00,2022-02-18 03:00:00,294,0,1973,2883,5150,3822
2022-02-18 03:00:00,2022-02-18 04:00:00,304,0,1907,2598,4809,3966
2022-02-18 04:00:00,2022-02-18 05:00:00,419,0,1842,2470,4731,4330
2022-02-18 05:00:00,2022-02-18 06:00:00,555,3,1806,2173,4537,4782
2022-02-18 06:00:00,2022-02-18 07:00:00,622,49,1589,1849,4109,5054
2022-02-18 07:00:00,2022-02-18 08:00:00,629,114,1359,1494,3596,5109
2022-02-18 08:00:00,2022-02-18 09:00:00,613,146,1525,1060,3344,5205
2022-02-18 09:00:00,2022-02-18 10:00:00,609,136,1441,935,3121,5192
2022-02-18 10:00:00,2022-02-18 11:00:00,515,87,1588,1194,3384,5233
2022-02-18 11:00:00,2022-02-18 12:00:00,544,51,1531,1747,3873,5199
2022-02-18 12:00:00,2022-02-18 13:00:00,475,28,1886,2064,4453,5188
2022-02-18 13:00:00,2022-02-18 14:00:00,476,18,1946,2590,5030,5209
2022-02-18 14:00:00,2022-02-18 15:00:00,562,17,2009,2180,4768,5273
2022-02-18 15:00:00,2022-02-18 16:00:00,574,4,2011,2448,5037,5465
2022-02-18 16:00:00,2022-02-18 17:00:00,582,0,1896,2097,4575,5420
2022-02-18 17:00:00,2022-02-18 18:00:00,550,0,1544,1335,3429,5067
2022-02-18 18:00:00,2022-02-18 19:00:00,540,0,1808,1155,3503,4737
2022-02-18 19:00:00,2022-02-18 20:00:00,502,0,1590,1210,3302,4493
2022-02-18 20:00:00,2022-02-18 21:00:00,525,0,978,1471,2974,4364
2022-02-18 21:00:00,2022-02-18 22:00:00,450,0,753,1448,2651,4194
2022-02-18 22:00:00,2022-02-18 23:00:00,368,0,1074,1976,3418,3970
2022-02-18 23:00:00,2022-02-19 00:00:00,424,0,1143,1781,3348,3785
2022-02-19 00:00:00,2022-02-19 01:00:00,314,0,1491,2772,4577,3742
2022-02-19 01:00:00,2022-02-19 02:00:00,209,0,1614,3059,4882,3734
2022-02-19 02:00:00,2022-02-19 03:00:00,238,0,1334,3140,4712,3730
2022-02-19 03:00:00,2022-02-19 04:00:00,330,0,1364,2800,4494,3755
2022-02-19 04:00:00,2022-02-19 05:00:00,385,0,1393,2983,4761,3843
2022-02-19 05:00:00,2022-02-19 06:00:00,418,4,1640,2957,5019,4132
2022-02-19 06:00:00,2022-02-19 07:00:00,516,75,1746,2906,5243,4398
2022-02-19 07:00:00,2022-02-19 08:00:00,561,214,1870,2893,5538,4612
2022-02-19 08:00:00,2022-02-19 09:00:00,450,404,1748,2714,5316,4697
2022-02-19 09:00:00,2022-02-19 10:00:00,430,502,941,2735,4608,4645
2022-02-19 10:00:00,2022-02-19 11:00:00,402,443,1061,2619,4525,4594
2022-02-19 11:00:00,2022-02-19 12:00:00,463,431,1123,2750,4767,4421
2022-02-19 12:00:00,2022-02-19 13:00:00,429,349,1798,2588,5164,4561
2022-02-19 13:00:00,2022-02-19 14:00:00,547,258,1701,2822,5328,4582
2022-02-19 14:00:00,2022-02-19 15:00:00,652,100,1880,2970,5602,4553
2022-02-19 15:00:00,2022-02-19 16:00:00,785,11,1872,2996,5664,4786
2022-02-19 16:00:00,2022-02-19 17:00:00,816,0,1964,2775,5555,5072
2022-02-19 17:00:00,2022-02-19 18:00:00,796,0,1913,2710,5419,4790
2022-02-19 18:00:00,2022-02-19 19:00:00,786,0,1924,2578,5288,4582
2022-02-19 19:00:00,2022-02-19 20:00:00,787,0,1914,2531,5232,4327
2022-02-19 20:00:00,2022-02-19 21:00:00,798,0,1867,2620,5285,4041
2022-02-19 21:00:00,2022-02-19 22:00:00,784,0,1808,2291,4883,3806
2022-02-19 22:00:00,2022-02-19 23:00:00,695,0,1670,1987,4352,3591
2022-02-19 23:00:00,2022-02-20 00:00:00,580,0,1469,1736,3785,3482
2022-02-20 00:00:00,2022-02-20 01:00:00,598,0,1276,1299,3173,3347
2022-02-20 01:00:00,2022-02-20 02:00:00,671,0,1196,985,2852,3334
2022-02-20 02:00:00,2022-02-20 03:00:00,840,0,1015,749,2604,3373
2022-02-20 03:00:00,2022-02-20 04:00:00,856,0,890,674,2420,3438
2022-02-20 04:00:00,2022-02-20 05:00:00,860,0,1093,756,2709,3642
2022-02-20 05:00:00,2022-02-20 06:00:00,867,9,1266,942,3084,3898
2022-02-20 06:00:00,2022-02-20 07:00:00,856,79,1304,1208,3447,4144
2022-02-20 07:00:00,2022-02-20 08:00:00,819,171,1251,1599,3840,4266
2022-02-20 08:00:00,2022-02-20 09:00:00,816,216,1504,2112,4648,4342
2022-02-20 09:00:00,2022-02-20 10:00:00,655,182,1684,2464,4985,4521
2022-02-20 10:00:00,2022-02-20 11:00:00,597,140,1904,2740,5381,4484
2022-02-20 11:00:00,2022-02-20 12:00:00,408,98,1933,2957,5396,4617
2022-02-20 12:00:00,2022-02-20 13:00:00,493,70,2021,3091,5675,4662
2022-02-20 13:00:00,2022-02-20 14:00:00,403,39,1990,3257,5689,4734
2022-02-20 14:00:00,2022-02-20 15:00:00,546,18,2033,3303,5900,4884
2022-02-20 15:00:00,2022-02-20 16:00:00,695,3,2009,3274,5981,5079
2022-02-20 16:00:00,2022-02-20 17:00:00,701,0,2032,3213,5946,4990
2022-02-20 17:00:00,2022-02-20 18:00:00,691,0,2020,3079,5790,4663
2022-02-20 18:00:00,2022-02-20 19:00:00,701,0,2001,2800,5502,4427
2022-02-20 19:00:00,2022-02-20 20:00:00,655,0,1997,2557,5209,4402
2022-02-20 20:00:00,2022-02-20 21:00:00,528,0,1981,2245,4754,4251
2022-02-20 21:00:00,2022-02-20 22:00:00,460,0,1950,2255,4665,3995
2022-02-20 22:00:00,2022-02-20 23:00:00,400,0,1915,2171,4486,3884
2022-02-20 23:00:00,2022-02-21 00:00:00,350,0,1934,2783,5067,3750
2022-02-21 00:00:00,2022-02-21 01:00:00,345,0,1936,2814,5095,3791
2022-02-21 01:00:00,2022-02-21 02:00:00,347,0,1936,3226,5509,3843
2022-02-21 02:00:00,2022-02-21 03:00:00,427,0,1915,3270,5612,3848
2022-02-21 03:00:00,2022-02-21 04:00:00,487,0,1889,3604,5980,4004
2022-02-21 04:00:00,2022-02-21 05:00:00,661,0,1782,3598,6041,4634
2022-02-21 05:00:00,2022-02-21 06:00:00,772,2,2011,3679,6464,5098
2022-02-21 06:00:00,2022-02-21 07:00:00,857,47,1953,3580,6437,5282
2022-02-21 07:00:00,2022-02-21 08:00:00,784,171,1938,3413,6306,5323
2022-02-21 08:00:00,2022-02-21 09:00:00,758,358,1864,3381,6361,5400
2022-02-21 09:00:00,2022-02-21 10:00:00,421,504,1723,3268,5916,5441
2022-02-21 10:00:00,2022-02-21 11:00:00,472,566,1799,3029,5866,5314
2022-02-21 11:00:00,2022-02-21 12:00:00,441,597,1716,3224,5978,5202
2022-02-21 12:00:00,2022-02-21 13:00:00,513,530,1915,3142,6100,5083
2022-02-21 13:00:00,2022-02-21 14:00:00,422,355,1998,3084,5859,5049
2022-02-21 14:00:00,2022-02-21 15:00:00,434,135,2007,3046,5622,5095
2022-02-21 15:00:00,2022-02-21 16:00:00,472,18,2001,2726,5217,5409
2022-02-21 16:00:00,2022-02-21 17:00:00,547,1,2016,2288,4852,5405
2022-02-21 17:00:00,2022-02-21 18:00:00,535,0,2021,2188,4744,5105
2022-02-21 18:00:00,2022-02-21 19:00:00,614,0,2010,2223,4847,4793
2022-02-21 19:00:00,2022-02-21 20:00:00,563,0,1957,2326,4846,4598
2022-02-21 20:00:00,2022-02-21 21:00:00,580,0,1819,2326,4725,4457
2022-02-21 21:00:00,2022-02-21 22:00:00,561,0,1762,2169,4492,4159
2022-02-21 22:00:00,2022-02-21 23:00:00,603,0,1794,2004,4401,3934
2022-02-21 23:00:00,2022-02-22 00:00:00,609,0,1726,1782,4117,3797
2022-02-22 00:00:00,2022-02-22 01:00:00,656,0,1710,1547,3913,3760
2022-02-22 01:00:00,2022-02-22 02:00:00,610,0,1615,1245,3470,3730
2022-02-22 02:00:00,2022-02-22 03:00:00,607,0,1667,847,3121,3799
2022-02-22 03:00:00,2022-02-22 04:00:00,577,0,1539,646,2762,4012
2022-02-22 04:00:00,2022-02-22 05:00:00,610,0,1178,573,2361,4574
2022-02-22 05:00:00,2022-02-22 06:00:00,645,13,773,508,1939,5091
2022-02-22 06:00:00,2022-02-22 07:00:00,633,128,533,377,1671,5292
2022-02-22 07:00:00,2022-02-22 08:00:00,603,308,439,303,1653,5367
2022-02-22 08:00:00,2022-02-22 09:00:00,531,434,356,236,1557,5473
2022-02-22 09:00:00,2022-02-22 10:00:00,635,468,512,437,2052,5395
2022-02-22 10:00:00,2022-02-22 11:00:00,692,381,764,826,2663,5109
2022-02-22 11:00:00,2022-02-22 12:00:00,687,270,1064,1293,3314,5059
2022-02-22 12:00:00,2022-02-22 13:00:00,690,181,1248,1808,3927,5031
2022-02-22 13:00:00,2022-02-22 14:00:00,722,95,1269,1896,3982,5092
2022-02-22 14:00:00,2022-02-22 15:00:00,629,31,1449,2168,4277,5151
2022-02-22 15:00:00,2022-02-22 16:00:00,600,2,1558,2270,4430,5429
2022-02-22 16:00:00,2022-02-22 17:00:00,526,1,1895,2319,4741,5556
2022-02-22 17:00:00,2022-02-22 18:00:00,459,0,1896,2337,4692,5314
2022-02-22 18:00:00,2022-02-22 19:00:00,470,0,1943,2982,5395,5041
2022-02-22 19:00:00,2022-02-22 20:00:00,485,0,1959,3347,5791,4651
2022-02-22 20:00:00,2022-02-22 21:00:00,504,0,2016,3343,5863,4383
2022-02-22 21:00:00,2022-02-22 22:00:00,473,0,1973,3763,6209,4157
2022-02-22 22:00:00,2022-02-22 23:00:00,488,0,2019,3426,5933,3963
2022-02-22 23:00:00,2022-02-23 00:00:00,493,0,2010,3323,5826,3891
2022-02-23 00:00:00,2022-02-23 01:00:00,501,0,1987,3296,5784,3811
2022-02-23 01:00:00,2022-02-23 02:00:00,495,0,1961,3116,5572,3858
2022-02-23 02:00:00,2022-02-23 03:00:00,515,0,2007,2920,5442,3882
2022-02-23 03:00:00,2022-02-23 04:00:00,608,0,2042,2861,5511,4100
2022-02-23 04:00:00,2022-02-23 05:00:00,534,0,1993,1934,4461,4773
2022-02-23 05:00:00,2022-02-23 06:00:00,543,10,1775,1663,3991,5332
2022-02-23 06:00:00,2022-02-23 07:00:00,588,117,1907,1494,4106,5425
2022-02-23 07:00:00,2022-02-23 08:00:00,568,308,1995,1652,4523,5308
2022-02-23 08:00:00,2022-02-23 09:00:00,636,485,1939,1940,5000,5265
2022-02-23 09:00:00,2022-02-23 10:00:00,616,598,1973,1948,5135,5235
2022-02-23 10:00:00,2022-02-23 11:00:00,605,677,1905,2138,5325,5151
2022-02-23 11:00:00,2022-02-23 12:00:00,595,643,1721,2076,5035,5189
2022-02-23 12:00:00,2022-02-23 13:00:00,746,544,1591,2231,5112,5051
2022-02-23 13:00:00,2022-02-23 14:00:00,788,302,1504,2369,4963,4836
2022-02-23 14:00:00,2022-02-23 15:00:00,758,89,1716,3312,5875,4911
2022-02-23 15:00:00,2022-02-23 16:00:00,869,13,1827,3357,6066,5212
2022-02-23 16:00:00,2022-02-23 17:00:00,730,1,1844,3600,6175,5303
2022-02-23 17:00:00,2022-02-23 18:00:00,716,0,1941,3669,6326,4917
2022-02-23 18:00:00,2022-02-23 19:00:00,661,0,1970,3428,6059,4790
2022-02-23 19:00:00,2022-02-23 20:00:00,674,0,1983,3319,5976,4577
2022-02-23 20:00:00,2022-02-23 21:00:00,733,0,2009,3134,5876,4320
2022-02-23 21:00:00,2022-02-23 22:00:00,671,0,1603,2493,4767,4120
2022-02-23 22:00:00,2022-02-23 23:00:00,567,0,1638,2464,4669,3962
2022-02-23 23:00:00,2022-02-24 00:00:00,522,0,1744,2508,4774,3827
2022-02-24 00:00:00,2022-02-24 01:00:00,497,0,1705,2475,4677,3767
2022-02-24 01:00:00,2022-02-24 02:00:00,531,0,1251,2234,4016,3775
2022-02-24 02:00:00,2022-02-24 03:00:00,590,0,1391,1926,3907,3829
2022-02-24 03:00:00,2022-02-24 04:00:00,665,0,1518,1643,3826,4047
2022-02-24 04:00:00,2022-02-24 05:00:00,748,0,1247,1829,3824,4594
2022-02-24 05:00:00,2022-02-24 06:00:00,877,3,999,2193,4072,5072
2022-02-24 06:00:00,2022-02-24 07:00:00,843,42,1712,1781,4378,5277
2022-02-24 07:00:00,2022-02-24 08:00:00,733,146,1835,1710,4424,5327
2022-02-24 08:00:00,2022-02-24 09:00:00,673,249,1714,2245,4881,5366
2022-02-24 09:00:00,2022-02-24 10:00:00,741,210,1679,2391,5021,5288
2022-02-24 10:00:00,2022-02-24 11:00:00,807,230,1617,2125,4779,5247
2022-02-24 11:00:00,2022-02-24 12:00:00,944,215,1648,1569,4376,5229
2022-02-24 12:00:00,2022-02-24 13:00:00,952,184,1242,1214,3592,5200
2022-02-24 13:00:00,2022-02-24 14:00:00,918,72,962,949,2901,5062
2022-02-24 14:00:00,2022-02-24 15:00:00,861,25,959,849,2694,5145
2022-02-24 15:00:00,2022-02-24 16:00:00,876,6,1104,823,2809,5477
2022-02-24 16:00:00,2022-02-24 17:00:00,847,3,1402,1007,3259,5514
2022-02-24 17:00:00,2022-02-24 18:00:00,851,3,1398,1204,3456,5131
2022-02-24 18:00:00,2022-02-24 19:00:00,817,3,1610,1486,3916,4849
2022-02-24 19:00:00,2022-02-24 20:00:00,702,3,1862,1564,4131,4842
2022-02-24 20:00:00,2022-02-24 21:00:00,752,3,1969,1884,4608,4607
2022-02-24 21:00:00,2022-02-24 22:00:00,773,3,2012,1967,4755,4217
2022-02-24 22:00:00,2022-02-24 23:00:00,704,3,2000,2172,4879,3979
2022-02-24 23:00:00,2022-02-25 00:00:00,587,3,2006,2091,4687,3967
2022-02-25 00:00:00,2022-02-25 01:00:00,528,3,1982,2010,4523,3927
2022-02-25 01:00:00,2022-02-25 02:00:00,511,3,1987,2105,4606,3950
2022-02-25 02:00:00,2022-02-25 03:00:00,550,3,1988,1984,4525,3959
2022-02-25 03:00:00,2022-02-25 04:00:00,782,3,1987,1989,4761,4037
2022-02-25 04:00:00,2022-02-25 05:00:00,732,3,1878,1998,4611,4693
2022-02-25 05:00:00,2022-02-25 06:00:00,770,8,1945,1902,4625,5260
2022-02-25 06:00:00,2022-02-25 07:00:00,877,61,1961,1731,4630,5303
2022-02-25 07:00:00,2022-02-25 08:00:00,891,189,1897,1633,4610,5289
2022-02-25 08:00:00,2022-02-25 09:00:00,850,405,1736,1623,4614,5347
2022-02-25 09:00:00,2022-02-25 10:00:00,850,725,1806,1548,4929,5409
2022-02-25 10:00:00,2022-02-25 11:00:00,822,812,1908,1873,5415,5231
2022-02-25 11:00:00,2022-02-25 12:00:00,838,686,1868,2532,5924,5092
2022-02-25 12:00:00,2022-02-25 13:00:00,709,678,1760,2775,5922,5082
2022-02-25 13:00:00,2022-02-25 14:00:00,713,524,1635,2883,5755,4946
2022-02-25 14:00:00,2022-02-25 15:00:00,806,232,1377,2458,4873,4953
2022-02-25 15:00:00,2022-02-25 16:00:00,729,33,1309,2510,4581,5239
2022-02-25 16:00:00,2022-02-25 17:00:00,782,3,1404,2226,4415,5273
2022-02-25 17:00:00,2022-02-25 18:00:00,762,3,1404,1671,3840,5019
2022-02-25 18:00:00,2022-02-25 19:00:00,723,3,1683,1555,3964,4737
2022-02-25 19:00:00,2022-02-25 20:00:00,749,3,1791,1429,3972,4529
2022-02-25 20:00:00,2022-02-25 21:00:00,759,3,1764,1049,3575,4297
2022-02-25 21:00:00,2022-02-25 22:00:00,776,3,1574,817,3170,4101
2022-02-25 22:00:00,2022-02-25 23:00:00,759,3,1348,628,2738,3948
2022-02-25 23:00:00,2022-02-26 00:00:00,714,3,1402,827,2946,3815
2022-02-26 00:00:00,2022-02-26 01:00:00,852,3,1058,768,2681,3623
2022-02-26 01:00:00,2022-02-26 02:00:00,916,3,814,671,2404,3557
2022-02-26 02:00:00,2022-02-26 03:00:00,907,3,687,533,2130,3563
2022-02-26 03:00:00,2022-02-26 04:00:00,920,3,513,412,1848,3604
2022-02-26 04:00:00,2022-02-26 05:00:00,905,3,303,292,1503,3785
2022-02-26 05:00:00,2022-02-26 06:00:00,917,27,212,216,1372,4040
2022-02-26 06:00:00,2022-02-26 07:00:00,936,264,158,124,1482,4300
2022-02-26 07:00:00,2022-02-26 08:00:00,895,632,125,68,1720,4414
2022-02-26 08:00:00,2022-02-26 09:00:00,886,937,88,53,1964,4445
2022-02-26 09:00:00,2022-02-26 10:00:00,905,1074,40,106,2125,4395
2022-02-26 10:00:00,2022-02-26 11:00:00,895,1098,45,145,2183,4301
2022-02-26 11:00:00,2022-02-26 12:00:00,870,992,73,178,2113,4141
2022-02-26 12:00:00,2022-02-26 13:00:00,912,862,107,190,2071,4035
2022-02-26 13:00:00,2022-02-26 14:00:00,911,710,116,222,1959,4065
2022-02-26 14:00:00,2022-02-26 15:00:00,889,307,123,217,1536,4097
2022-02-26 15:00:00,2022-02-26 16:00:00,975,36,158,227,1396,4447
2022-02-26 16:00:00,2022-02-26 17:00:00,1005,3,188,296,1492,4678
2022-02-26 17:00:00,2022-02-26 18:00:00,997,3,213,380,1593,4392
2022-02-26 18:00:00,2022-02-26 19:00:00,977,3,243,453,1676,4165
2022-02-26 19:00:00,2022-02-26 20:00:00,942,3,218,512,1675,3986
2022-02-26 20:00:00,2022-02-26 21:00:00,929,3,261,571,1764,3797
2022-02-26 21:00:00,2022-02-26 22:00:00,930,3,371,682,1986,3644
2022-02-26 22:00:00,2022-02-26 23:00:00,908,3,454,756,2121,3544
2022-02-26 23:00:00,2022-02-27 00:00:00,902,3,488,828,2221,3461
2022-02-27 00:00:00,2022-02-27 01:00:00,895,3,482,874,2254,3404
2022-02-27 01:00:00,2022-02-27 02:00:00,877,3,560,935,2375,3388
2022-02-27 02:00:00,2022-02-27 03:00:00,900,3,536,995,2434,3394
2022-02-27 03:00:00,2022-02-27 04:00:00,919,3,536,1043,2501,3461
2022-02-27 04:00:00,2022-02-27 05:00:00,924,3,601,1054,2582,3677
2022-02-27 05:00:00,2022-02-27 06:00:00,926,23,553,998,2500,3925
2022-02-27 06:00:00,2022-02-27 07:00:00,955,234,568,919,2676,4189
2022-02-27 07:00:00,2022-02-27 08:00:00,923,603,576,739,2841,4334
2022-02-27 08:00:00,2022-02-27 09:00:00,915,844,606,661,3026,4354
2022-02-27 09:00:00,2022-02-27 10:00:00,895,1094,653,717,3359,4316
2022-02-27 10:00:00,2022-02-27 11:00:00,768,1240,660,753,3421,4370
2022-02-27 11:00:00,2022-02-27 12:00:00,732,1208,577,715,3232,4305
2022-02-27 12:00:00,2022-02-27 13:00:00,695,1057,469,600,2821,4203
2022-02-27 13:00:00,2022-02-27 14:00:00,765,772,399,442,2378,4149
2022-02-27 14:00:00,2022-02-27 15:00:00,860,379,468,362,2069,4195
2022-02-27 15:00:00,2022-02-27 16:00:00,974,59,569,405,2007,4525
2022-02-27 16:00:00,2022-02-27 17:00:00,993,3,699,657,2352,4749
2022-02-27 17:00:00,2022-02-27 18:00:00,997,3,892,985,2877,4498
2022-02-27 18:00:00,2022-02-27 19:00:00,920,3,1034,1142,3099,4364
2022-02-27 19:00:00,2022-02-27 20:00:00,802,3,1090,1183,3078,4204
2022-02-27 20:00:00,2022-02-27 21:00:00,806,3,1034,1280,3123,4013
2022-02-27 21:00:00,2022-02-27 22:00:00,766,3,1069,1401,3239,3868
2022-02-27 22:00:00,2022-02-27 23:00:00,774,3,1069,1417,3263,3813
2022-02-27 23:00:00,2022-02-28 00:00:00,793,3,1124,1317,3237,3770
2022-02-28 00:00:00,2022-02-28 01:00:00,797,3,1089,1189,3078,3571
2022-02-28 01:00:00,2022-02-28 02:00:00,803,3,1037,1208,3051,3658
2022-02-28 02:00:00,2022-02-28 03:00:00,776,3,1000,1209,2988,3720
2022-02-28 03:00:00,2022-02-28 04:00:00,787,3,928,1243,2961,3913
2022-02-28 04:00:00,2022-02-28 05:00:00,784,3,875,1272,2934,4534
2022-02-28 05:00:00,2022-02-28 06:00:00,856,26,916,1288,3086,5050
2022-02-28 06:00:00,2022-02-28 07:00:00,905,251,959,1237,3352,5190
2022-02-28 07:00:00,2022-02-28 08:00:00,863,683,979,1064,3589,5177
2022-02-28 08:00:00,2022-02-28 09:00:00,888,994,985,849,3716,5210
2022-02-28 09:00:00,2022-02-28 10:00:00,779,1190,1050,1011,4030,5146
2022-02-28 10:00:00,2022-02-28 11:00:00,728,1272,1171,1421,4592,5098
2022-02-28 11:00:00,2022-02-28 12:00:00,731,1239,1191,1842,5003,5179
2022-02-28 12:00:00,2022-02-28 13:00:00,693,1045,1147,2115,5000,5014
2022-02-28 13:00:00,2022-02-28 14:00:00,822,714,1150,2048,4734,4759
2022-02-28 14:00:00,2022-02-28 15:00:00,907,334,1254,1668,4163,4756
2022-02-28 15:00:00,2022-02-28 16:00:00,1088,56,1282,1479,3905,5022
2022-02-28 16:00:00,2022-02-28 17:00:00,941,3,1278,1529,3751,5250
2022-02-28 17:00:00,2022-02-28 18:00:00,901,3,1533,1726,4163,5018
2022-02-28 18:00:00,2022-02-28 19:00:00,696,3,1760,1884,4343,4766
2022-02-28 19:00:00,2022-02-28 20:00:00,754,3,1860,1968,4585,4589
2022-02-28 20:00:00,2022-02-28 21:00:00,877,3,1889,1995,4764,4250
2022-02-28 21:00:00,2022-02-28 22:00:00,876,3,1859,1984,4722,3995
2022-02-28 22:00:00,2022-02-28 23:00:00,845,3,1872,2023,4743,3805
2022-02-28 23:00:00,2022-03-01 00:00:00,825,3,1883,1999,4710,3699
2022-03-01 00:00:00,2022-03-01 01:00:00,830,3,1848,1893,4574,3695
2022-03-01 01:00:00,2022-03-01 02:00:00,847,3,1737,1799,4386,3657
2022-03-01 02:00:00,2022-03-01 03:00:00,833,3,1507,1718,4061,3686
2022-03-01 03:00:00,2022-03-01 04:00:00,892,3,1361,1595,3851,3943
2022-03-01 04:00:00,2022-03-01 05:00:00,948,3,1278,1392,3621,4570
2022-03-01 05:00:00,2022-03-01 06:00:00,1093,33,1194,1165,3485,4997
2022-03-01 06:00:00,2022-03-01 07:00:00,1097,158,1096,965,3316,5197
2022-03-01 07:00:00,2022-03-01 08:00:00,1098,292,1081,765,3236,5215
2022-03-01 08:00:00,2022-03-01 09:00:00,1045,338,1014,615,3012,5217
2022-03-01 09:00:00,2022-03-01 10:00:00,928,372,743,403,2446,5215
2022-03-01 10:00:00,2022-03-01 11:00:00,927,410,449,242,2028,5092
2022-03-01 11:00:00,2022-03-01 12:00:00,958,423,285,168,1834,5119
2022-03-01 12:00:00,2022-03-01 13:00:00,1024,411,250,121,1806,5061
2022-03-01 13:00:00,2022-03-01 14:00:00,1018,278,246,103,1645,4945
2022-03-01 14:00:00,2022-03-01 15:00:00,1046,171,181,113,1511,4979
2022-03-01 15:00:00,2022-03-01 16:00:00,1058,47,107,105,1317,5259
2022-03-01 16:00:00,2022-03-01 17:00:00,1152,4,39,113,1308,5212
2022-03-01 17:00:00,2022-03-01 18:00:00,1118,4,16,163,1301,4983
2022-03-01 18:00:00,2022-03-01 19:00:00,1062,4,9,172,1247,4702
2022-03-01 19:00:00,2022-03-01 20:00:00,988,4,19,144,1155,4398
2022-03-01 20:00:00,2022-03-01 21:00:00,942,4,36,138,1120,4167
2022-03-01 21:00:00,2022-03-01 22:00:00,895,4,37,130,1066,3923
2022-03-01 22:00:00,2022-03-01 23:00:00,865,4,39,152,1060,3785
2022-03-01 23:00:00,2022-03-02 00:00:00,861,4,77,177,1119,3690
2022-03-02 00:00:00,2022-03-02 01:00:00,861,4,71,158,1094,3655
2022-03-02 01:00:00,2022-03-02 02:00:00,860,4,76,155,1095,3661
2022-03-02 02:00:00,2022-03-02 03:00:00,862,4,73,155,1094,3724
2022-03-02 03:00:00,2022-03-02 04:00:00,870,4,74,195,1143,3982
2022-03-02 04:00:00,2022-03-02 05:00:00,940,4,75,211,1230,4587
2022-03-02 05:00:00,2022-03-02 06:00:00,969,25,76,190,1260,5075
2022-03-02 06:00:00,2022-03-02 07:00:00,1005,171,59,207,1442,5163
2022-03-02 07:00:00,2022-03-02 08:00:00,973,408,56,159,1596,5156
2022-03-02 08:00:00,2022-03-02 09:00:00,949,700,37,113,1799,5259
2022-03-02 09:00:00,2022-03-02 10:00:00,945,898,28,133,2004,5144
2022-03-02 10:00:00,2022-03-02 11:00:00,931,1023,36,128,2118,4955
2022-03-02 11:00:00,2022-03-02 12:00:00,930,1057,68,124,2179,4898
2022-03-02 12:00:00,2022-03-02 13:00:00,942,926,37,131,2036,4803
2022-03-02 13:00:00,2022-03-02 14:00:00,1017,697,32,139,1885,4660
2022-03-02 14:00:00,2022-03-02 15:00:00,1077,360,41,128,1606,4711
2022-03-02 15:00:00,2022-03-02 16:00:00,1130,70,65,132,1397,5005
2022-03-02 16:00:00,2022-03-02 17:00:00,1145,3,80,174,1402,5155
2022-03-02 17:00:00,2022-03-02 18:00:00,1161,3,79,171,1414,4908
2022-03-02 18:00:00,2022-03-02 19:00:00,1092,3,153,141,1389,4641
2022-03-02 19:00:00,2022-03-02 20:00:00,1082,3,113,110,1308,4352
2022-03-02 20:00:00,2022-03-02 21:00:00,1083,3,88,91,1265,4088
2022-03-02 21:00:00,2022-03-02 22:00:00,1058,3,77,85,1223,3887
2022-03-02 22:00:00,2022-03-02 23:00:00,1035,3,118,68,1224,3766
2022-03-02 23:00:00,2022-03-03 00:00:00,1031,3,114,63,1211,3645
2022-03-03 00:00:00,2022-03-03 01:00:00,1036,3,84,59,1182,3597
2022-03-03 01:00:00,2022-03-03 02:00:00,1035,3,82,66,1186,3597
2022-03-03 02:00:00,2022-03-03 03:00:00,1039,3,121,69,1232,3678
2022-03-03 03:00:00,2022-03-03 04:00:00,1037,3,107,92,1239,3924
2022-03-03 04:00:00,2022-03-03 05:00:00,1062,3,138,149,1352,4553
2022-03-03 05:00:00,2022-03-03 06:00:00,1053,37,125,252,1467,5058
2022-03-03 06:00:00,2022-03-03 07:00:00,922,270,108,296,1596,5288
2022-03-03 07:00:00,2022-03-03 08:00:00,899,597,91,210,1797,5277
2022-03-03 08:00:00,2022-03-03 09:00:00,892,754,77,112,1835,5132
2022-03-03 09:00:00,2022-03-03 10:00:00,899,966,77,80,2022,4964
2022-03-03 10:00:00,2022-03-03 11:00:00,917,1049,83,86,2135,4812
2022-03-03 11:00:00,2022-03-03 12:00:00,937,1078,66,123,2204,4754
2022-03-03 12:00:00,2022-03-03 13:00:00,965,941,24,190,2120,4636
2022-03-03 13:00:00,2022-03-03 14:00:00,956,689,42,242,1929,4527
2022-03-03 14:00:00,2022-03-03 15:00:00,975,361,62,228,1626,4560
2022-03-03 15:00:00,2022-03-03 16:00:00,1012,68,134,251,1465,4889
2022-03-03 16:00:00,2022-03-03 17:00:00,1006,1,164,382,1553,5025
2022-03-03 17:00:00,2022-03-03 18:00:00,1033,0,214,547,1794,4825
2022-03-03 18:00:00,2022-03-03 19:00:00,1016,0,267,548,1831,4559
2022-03-03 19:00:00,2022-03-03 20:00:00,990,0,375,499,1864,4377
2022-03-03 20:00:00,2022-03-03 21:00:00,918,0,482,547,1947,4139
2022-03-03 21:00:00,2022-03-03 22:00:00,901,0,426,626,1953,3906
2022-03-03 22:00:00,2022-03-03 23:00:00,890,0,285,622,1797,3754
2022-03-03 23:00:00,2022-03-04 00:00:00,894,0,270,435,1599,3684
2022-03-04 00:00:00,2022-03-04 01:00:00,896,0,213,242,1351,3612
2022-03-04 01:00:00,2022-03-04 02:00:00,908,0,151,195,1254,3623
2022-03-04 02:00:00,2022-03-04 03:00:00,924,0,116,206,1246,3723
2022-03-04 03:00:00,2022-03-04 04:00:00,948,0,120,211,1279,3969
2022-03-04 04:00:00,2022-03-04 05:00:00,979,1,109,264,1353,4594
2022-03-04 05:00:00,2022-03-04 06:00:00,991,41,178,276,1486,5012
2022-03-04 06:00:00,2022-03-04 07:00:00,984,264,155,292,1695,5103
2022-03-04 07:00:00,2022-03-04 08:00:00,991,565,154,245,1955,5039
2022-03-04 08:00:00,2022-03-04 09:00:00,976,826,195,249,2246,5034
2022-03-04 09:00:00,2022-03-04 10:00:00,947,980,232,333,2492,4895
2022-03-04 10:00:00,2022-03-04 11:00:00,907,1043,223,398,2571,4765
2022-03-04 11:00:00,2022-03-04 12:00:00,913,979,215,431,2538,4610
2022-03-04 12:00:00,2022-03-04 13:00:00,902,861,210,399,2372,4497
2022-03-04 13:00:00,2022-03-04 14:00:00,907,668,226,347,2148,4364
2022-03-04 14:00:00,2022-03-04 15:00:00,914,343,255,313,1825,4404
2022-03-04 15:00:00,2022-03-04 16:00:00,968,70,252,284,1574,4726
2022-03-04 16:00:00,2022-03-04 17:00:00,1020,3,238,325,1586,4876
2022-03-04 17:00:00,2022-03-04 18:00:00,1012,2,260,403,1677,4628
2022-03-04 18:00:00,2022-03-04 19:00:00,975,2,199,433,1609,4358
2022-03-04 19:00:00,2022-03-04 20:00:00,920,2,232,445,1599,4170
2022-03-04 20:00:00,2022-03-04 21:00:00,929,2,341,454,1726,3969
2022-03-04 21:00:00,2022-03-04 22:00:00,900,2,447,448,1797,3829
2022-03-04 22:00:00,2022-03-04 23:00:00,885,2,558,508,1953,3704
2022-03-04 23:00:00,2022-03-05 00:00:00,904,2,567,520,1993,3593
2022-03-05 00:00:00,2022-03-05 01:00:00,875,2,485,533,1895,3540
2022-03-05 01:00:00,2022-03-05 02:00:00,857,2,391,522,1772,3527
2022-03-05 02:00:00,2022-03-05 03:00:00,892,2,345,429,1668,3539
2022-03-05 03:00:00,2022-03-05 04:00:00,924,2,261,356,1543,3577
2022-03-05 04:00:00,2022-03-05 05:00:00,945,2,224,341,1512,3758
2022-03-05 05:00:00,2022-03-05 06:00:00,947,42,264,333,1586,4033
2022-03-05 06:00:00,2022-03-05 07:00:00,887,261,278,261,1687,4225
2022-03-05 07:00:00,2022-03-05 08:00:00,926,566,265,141,1898,4266
2022-03-05 08:00:00,2022-03-05 09:00:00,871,744,203,126,1944,4353
2022-03-05 09:00:00,2022-03-05 10:00:00,856,735,156,126,1873,4310
2022-03-05 10:00:00,2022-03-05 11:00:00,856,713,66,87,1722,4227
2022-03-05 11:00:00,2022-03-05 12:00:00,856,668,28,76,1628,4125
2022-03-05 12:00:00,2022-03-05 13:00:00,850,622,26,74,1572,4096
2022-03-05 13:00:00,2022-03-05 14:00:00,846,410,28,69,1353,4068
2022-03-05 14:00:00,2022-03-05 15:00:00,921,239,26,72,1258,4161
2022-03-05 15:00:00,2022-03-05 16:00:00,952,57,19,68,1096,4502
2022-03-05 16:00:00,2022-03-05 17:00:00,972,3,14,78,1067,4688
2022-03-05 17:00:00,2022-03-05 18:00:00,981,2,6,92,1081,4442
2022-03-05 18:00:00,2022-03-05 19:00:00,972,2,8,124,1106,4212
2022-03-05 19:00:00,2022-03-05 20:00:00,953,2,24,143,1122,4035
2022-03-05 20:00:00,2022-03-05 21:00:00,933,2,47,162,1144,3878
2022-03-05 21:00:00,2022-03-05 22:00:00,908,2,90,180,1180,3682
2022-03-05 22:00:00,2022-03-05 23:00:00,891,2,103,223,1219,3554
2022-03-05 23:00:00,2022-03-06 00:00:00,888,2,68,241,1199,3472
2022-03-06 00:00:00,2022-03-06 01:00:00,902,2,56,197,1157,3403
2022-03-06 01:00:00,2022-03-06 02:00:00,882,2,92,234,1210,3398
2022-03-06 02:00:00,2022-03-06 03:00:00,872,2,127,228,1229,3384
2022-03-06 03:00:00,2022-03-06 04:00:00,865,2,130,218,1215,3440
2022-03-06 04:00:00,2022-03-06 05:00:00,884,2,149,234,1269,3595
2022-03-06 05:00:00,2022-03-06 06:00:00,887,51,179,238,1355,3822
2022-03-06 06:00:00,2022-03-06 07:00:00,878,296,114,234,1522,4088
2022-03-06 07:00:00,2022-03-06 08:00:00,871,627,123,189,1810,4149
2022-03-06 08:00:00,2022-03-06 09:00:00,899,890,266,187,2242,4152
2022-03-06 09:00:00,2022-03-06 10:00:00,919,1034,286,193,2432,4080
2022-03-06 10:00:00,2022-03-06 11:00:00,921,1006,217,206,2350,3959
2022-03-06 11:00:00,2022-03-06 12:00:00,902,1003,207,237,2349,3888
2022-03-06 12:00:00,2022-03-06 13:00:00,889,940,300,273,2402,3906
2022-03-06 13:00:00,2022-03-06 14:00:00,901,730,341,279,2251,3892
2022-03-06 14:00:00,2022-03-06 15:00:00,932,404,351,284,1971,4016
2022-03-06 15:00:00,2022-03-06 16:00:00,973,93,372,264,1702,4404
2022-03-06 16:00:00,2022-03-06 17:00:00,1021,2,342,276,1641,4606
2022-03-06 17:00:00,2022-03-06 18:00:00,1050,0,361,315,1726,4447
2022-03-06 18:00:00,2022-03-06 19:00:00,1020,0,333,259,1612,4220
2022-03-06 19:00:00,2022-03-06 20:00:00,995,0,292,225,1512,4012
2022-03-06 20:00:00,2022-03-06 21:00:00,997,0,170,161,1328,3768
2022-03-06 21:00:00,2022-03-06 22:00:00,970,0,150,133,1253,3664
2022-03-06 22:00:00,2022-03-06 23:00:00,1029,0,129,127,1285,3439
2022-03-06 23:00:00,2022-03-07 00:00:00,958,0,127,133,1218,3415
2022-03-07 00:00:00,2022-03-07 01:00:00,939,0,138,125,1202,3376
2022-03-07 01:00:00,2022-03-07 02:00:00,924,0,156,131,1211,3395
2022-03-07 02:00:00,2022-03-07 03:00:00,925,0,188,133,1246,3489
2022-03-07 03:00:00,2022-03-07 04:00:00,939,0,252,143,1334,3771
2022-03-07 04:00:00,2022-03-07 05:00:00,1006,1,235,137,1379,4442
2022-03-07 05:00:00,2022-03-07 06:00:00,1072,62,221,146,1501,4958
2022-03-07 06:00:00,2022-03-07 07:00:00,1055,327,209,147,1738,5036
2022-03-07 07:00:00,2022-03-07 08:00:00,1061,660,198,122,2041,4977
2022-03-07 08:00:00,2022-03-07 09:00:00,1039,923,231,81,2274,4889
2022-03-07 09:00:00,2022-03-07 10:00:00,938,1083,195,112,2328,4889
2022-03-07 10:00:00,2022-03-07 11:00:00,915,1120,179,125,2339,4794
2022-03-07 11:00:00,2022-03-07 12:00:00,921,1087,190,125,2323,4732
2022-03-07 12:00:00,2022-03-07 13:00:00,919,964,258,161,2302,4631
2022-03-07 13:00:00,2022-03-07 14:00:00,916,733,309,206,2164,4508
2022-03-07 14:00:00,2022-03-07 15:00:00,954,405,252,212,1823,4580
2022-03-07 15:00:00,2022-03-07 16:00:00,1032,101,240,185,1558,4911
2022-03-07 16:00:00,2022-03-07 17:00:00,1045,4,174,196,1419,5045
2022-03-07 17:00:00,2022-03-07 18:00:00,1107,2,141,187,1437,4835
2022-03-07 18:00:00,2022-03-07 19:00:00,1045,2,94,191,1332,4522
2022-03-07 19:00:00,2022-03-07 20:00:00,977,2,71,243,1293,4265
2022-03-07 20:00:00,2022-03-07 21:00:00,961,2,49,241,1253,4036
2022-03-07 21:00:00,2022-03-07 22:00:00,933,2,44,207,1186,3833
2022-03-07 22:00:00,2022-03-07 23:00:00,863,2,24,160,1049,3681
2022-03-07 23:00:00,2022-03-08 00:00:00,876,2,15,137,1030,3588
2022-03-08 00:00:00,2022-03-08 01:00:00,867,2,12,141,1022,3561
2022-03-08 01:00:00,2022-03-08 02:00:00,869,2,33,182,1086,3573
2022-03-08 02:00:00,2022-03-08 03:00:00,865,2,47,170,1084,3671
2022-03-08 03:00:00,2022-03-08 04:00:00,885,2,48,146,1081,3906
2022-03-08 04:00:00,2022-03-08 05:00:00,907,2,60,150,1119,4518
2022-03-08 05:00:00,2022-03-08 06:00:00,994,45,64,198,1301,4954
2022-03-08 06:00:00,2022-03-08 07:00:00,1029,201,96,228,1554,5028
2022-03-08 07:00:00,2022-03-08 08:00:00,1009,390,98,195,1692,5137
2022-03-08 08:00:00,2022-03-08 09:00:00,920,660,99,179,1858,5101
2022-03-08 09:00:00,2022-03-08 10:00:00,873,909,99,177,2058,4971
2022-03-08 10:00:00,2022-03-08 11:00:00,859,1023,78,166,2126,4790
2022-03-08 11:00:00,2022-03-08 12:00:00,848,1041,29,134,2052,4731
2022-03-08 12:00:00,2022-03-08 13:00:00,926,952,17,97,1992,4673
2022-03-08 13:00:00,2022-03-08 14:00:00,959,728,26,63,1776,4567
2022-03-08 14:00:00,2022-03-08 15:00:00,995,402,60,47,1504,4543
2022-03-08 15:00:00,2022-03-08 16:00:00,1054,102,83,45,1284,4869
2022-03-08 16:00:00,2022-03-08 17:00:00,1090,3,108,50,1251,4979
2022-03-08 17:00:00,2022-03-08 18:00:00,1094,0,149,102,1345,4830
2022-03-08 18:00:00,2022-03-08 19:00:00,1085,0,281,157,1523,4557
2022-03-08 19:00:00,2022-03-08 20:00:00,1015,0,341,270,1626,4297
2022-03-08 20:00:00,2022-03-08 21:00:00,989,0,443,377,1809,4101
2022-03-08 21:00:00,2022-03-08 22:00:00,947,0,469,397,1813,3885
2022-03-08 22:00:00,2022-03-08 23:00:00,940,0,430,398,1768,3726
2022-03-08 23:00:00,2022-03-09 00:00:00,907,0,306,397,1610,3644
2022-03-09 00:00:00,2022-03-09 01:00:00,894,0,253,428,1575,3598
2022-03-09 01:00:00,2022-03-09 02:00:00,890,0,297,455,1642,3614
2022-03-09 02:00:00,2022-03-09 03:00:00,908,0,335,443,1686,3699
2022-03-09 03:00:00,2022-03-09 04:00:00,948,0,270,480,1698,3945
2022-03-09 04:00:00,2022-03-09 05:00:00,989,1,296,525,1811,4496
2022-03-09 05:00:00,2022-03-09 06:00:00,1031,59,340,523,1953,4980
2022-03-09 06:00:00,2022-03-09 07:00:00,1028,253,251,398,1930,5165
2022-03-09 07:00:00,2022-03-09 08:00:00,1022,513,265,257,2057,5147
2022-03-09 08:00:00,2022-03-09 09:00:00,996,742,241,218,2197,5140
2022-03-09 09:00:00,2022-03-09 10:00:00,953,870,265,277,2365,5026
2022-03-09 10:00:00,2022-03-09 11:00:00,919,911,256,448,2534,4894
2022-03-09 11:00:00,2022-03-09 12:00:00,914,904,242,511,2571,4814
2022-03-09 12:00:00,2022-03-09 13:00:00,899,879,385,518,2681,4784
2022-03-09 13:00:00,2022-03-09 14:00:00,872,691,424,603,2590,4721
2022-03-09 14:00:00,2022-03-09 15:00:00,938,387,370,641,2336,4637
2022-03-09 15:00:00,2022-03-09 16:00:00,960,101,383,629,2073,4966
2022-03-09 16:00:00,2022-03-09 17:00:00,959,4,385,694,2042,5087
2022-03-09 17:00:00,2022-03-09 18:00:00,989,2,635,933,2559,4915
2022-03-09 18:00:00,2022-03-09 19:00:00,932,2,794,917,2645,4651
2022-03-09 19:00:00,2022-03-09 20:00:00,921,2,860,855,2638,4389
2022-03-09 20:00:00,2022-03-09 21:00:00,925,2,888,950,2765,4123
2022-03-09 21:00:00,2022-03-09 22:00:00,902,2,1063,1180,3147,3929
2022-03-09 22:00:00,2022-03-09 23:00:00,917,2,1146,1247,3312,3721
2022-03-09 23:00:00,2022-03-10 00:00:00,888,2,1272,1324,3486,3665
2022-03-10 00:00:00,2022-03-10 01:00:00,781,2,1346,1407,3536,3649
2022-03-10 01:00:00,2022-03-10 02:00:00,686,2,1434,1489,3611,3671
2022-03-10 02:00:00,2022-03-10 03:00:00,734,2,1466,1488,3690,3731
2022-03-10 03:00:00,2022-03-10 04:00:00,740,2,1348,1558,3648,3978
2022-03-10 04:00:00,2022-03-10 05:00:00,698,3,1335,1623,3659,4540
2022-03-10 05:00:00,2022-03-10 06:00:00,728,52,1339,1604,3723,4994
2022-03-10 06:00:00,2022-03-10 07:00:00,934,233,1345,1551,4063,5124
2022-03-10 07:00:00,2022-03-10 08:00:00,884,489,1347,1596,4316,5099
2022-03-10 08:00:00,2022-03-10 09:00:00,801,769,1355,1596,4521,5088
2022-03-10 09:00:00,2022-03-10 10:00:00,719,933,1427,1514,4593,4999
2022-03-10 10:00:00,2022-03-10 11:00:00,810,979,1457,1526,4772,4763
2022-03-10 11:00:00,2022-03-10 12:00:00,850,1005,1488,1668,5011,4738
2022-03-10 12:00:00,2022-03-10 13:00:00,863,919,1422,1904,5108,4721
2022-03-10 13:00:00,2022-03-10 14:00:00,816,685,1552,2040,5093,4776
2022-03-10 14:00:00,2022-03-10 15:00:00,813,393,1686,1559,4451,4874
2022-03-10 15:00:00,2022-03-10 16:00:00,674,103,1829,1638,4244,5154
2022-03-10 16:00:00,2022-03-10 17:00:00,656,3,1896,1934,4489,5225
2022-03-10 17:00:00,2022-03-10 18:00:00,668,0,1839,2006,4513,4917
2022-03-10 18:00:00,2022-03-10 19:00:00,648,0,1785,1697,4130,4772
2022-03-10 19:00:00,2022-03-10 20:00:00,640,0,1858,1745,4243,4497
2022-03-10 20:00:00,2022-03-10 21:00:00,639,0,1677,1505,3821,4343
2022-03-10 21:00:00,2022-03-10 22:00:00,631,0,1687,1415,3733,4143
2022-03-10 22:00:00,2022-03-10 23:00:00,550,0,1546,1201,3297,3988
2022-03-10 23:00:00,2022-03-11 00:00:00,496,0,1497,1069,3062,3920
2022-03-11 00:00:00,2022-03-11 01:00:00,511,0,1441,1143,3095,3825
2022-03-11 01:00:00,2022-03-11 02:00:00,610,0,1407,1206,3223,3838
2022-03-11 02:00:00,2022-03-11 03:00:00,679,0,1394,1227,3300,3903
2022-03-11 03:00:00,2022-03-11 04:00:00,637,0,1393,1270,3300,4132
2022-03-11 04:00:00,2022-03-11 05:00:00,629,2,1410,1863,3904,4672
2022-03-11 05:00:00,2022-03-11 06:00:00,752,89,1900,1871,4612,5067
2022-03-11 06:00:00,2022-03-11 07:00:00,718,376,1985,2421,5500,5150
2022-03-11 07:00:00,2022-03-11 08:00:00,742,721,1983,2580,6026,4957
2022-03-11 08:00:00,2022-03-11 09:00:00,693,986,1940,2809,6428,5070
2022-03-11 09:00:00,2022-03-11 10:00:00,615,1102,1923,2783,6423,4978
2022-03-11 10:00:00,2022-03-11 11:00:00,478,1181,1875,2520,6054,4926
2022-03-11 11:00:00,2022-03-11 12:00:00,476,1152,1666,2508,5802,4855
2022-03-11 12:00:00,2022-03-11 13:00:00,592,1029,1703,2741,6065,4608
2022-03-11 13:00:00,2022-03-11 14:00:00,664,795,1951,2857,6267,4522
2022-03-11 14:00:00,2022-03-11 15:00:00,627,461,1852,2416,5356,4722
2022-03-11 15:00:00,2022-03-11 16:00:00,644,127,1543,2550,4864,4999
2022-03-11 16:00:00,2022-03-11 17:00:00,673,5,1536,2564,4778,5079
2022-03-11 17:00:00,2022-03-11 18:00:00,634,0,1509,2760,4903,4763
2022-03-11 18:00:00,2022-03-11 19:00:00,689,0,1683,2219,4591,4575
2022-03-11 19:00:00,2022-03-11 20:00:00,789,0,1760,2092,4641,4381
2022-03-11 20:00:00,2022-03-11 21:00:00,778,0,1671,1924,4373,4113
2022-03-11 21:00:00,2022-03-11 22:00:00,756,0,1814,1784,4354,3943
2022-03-11 22:00:00,2022-03-11 23:00:00,665,0,1792,1607,4064,3834
2022-03-11 23:00:00,2022-03-12 00:00:00,565,0,1334,1662,3561,3676
2022-03-12 00:00:00,2022-03-12 01:00:00,524,0,1249,1624,3397,3552
2022-03-12 01:00:00,2022-03-12 02:00:00,519,0,1422,1489,3430,3523
2022-03-12 02:00:00,2022-03-12 03:00:00,549,0,1299,1740,3588,3561
2022-03-12 03:00:00,2022-03-12 04:00:00,586,0,1200,1803,3589,3632
2022-03-12 04:00:00,2022-03-12 05:00:00,497,3,1356,1743,3599,3800
2022-03-12 05:00:00,2022-03-12 06:00:00,588,101,1355,2171,4215,3965
2022-03-12 06:00:00,2022-03-12 07:00:00,652,404,1554,2256,4866,4162
2022-03-12 07:00:00,2022-03-12 08:00:00,651,732,1652,1874,4909,4254
2022-03-12 08:00:00,2022-03-12 09:00:00,616,966,1609,1956,5147,4243
2022-03-12 09:00:00,2022-03-12 10:00:00,587,1127,1612,1743,5069,4129
2022-03-12 10:00:00,2022-03-12 11:00:00,561,1154,1658,1746,5119,4077
2022-03-12 11:00:00,2022-03-12 12:00:00,488,1082,1678,1690,4938,3951
2022-03-12 12:00:00,2022-03-12 13:00:00,600,931,1642,1577,4750,3865
2022-03-12 13:00:00,2022-03-12 14:00:00,931,681,1602,1436,4650,3825
2022-03-12 14:00:00,2022-03-12 15:00:00,913,354,1646,1346,4259,3952
2022-03-12 15:00:00,2022-03-12 16:00:00,912,73,1662,1198,3845,4297
2022-03-12 16:00:00,2022-03-12 17:00:00,893,3,1531,1350,3777,4464
2022-03-12 17:00:00,2022-03-12 18:00:00,850,0,1425,1565,3840,4238
2022-03-12 18:00:00,2022-03-12 19:00:00,818,0,1534,1531,3883,4076
2022-03-12 19:00:00,2022-03-12 20:00:00,812,0,1587,1141,3540,3962
2022-03-12 20:00:00,2022-03-12 21:00:00,778,0,1439,925,3142,3781
2022-03-12 21:00:00,2022-03-12 22:00:00,746,0,1572,954,3272,3594
2022-03-12 22:00:00,2022-03-12 23:00:00,741,0,1399,897,3037,3538
2022-03-12 23:00:00,2022-03-13 00:00:00,741,0,1233,1262,3236,3289
2022-03-13 00:00:00,2022-03-13 01:00:00,789,0,1260,1377,3426,3232
2022-03-13 01:00:00,2022-03-13 02:00:00,723,0,1522,1472,3717,3232
2022-03-13 02:00:00,2022-03-13 03:00:00,550,0,1657,1618,3825,3345
2022-03-13 03:00:00,2022-03-13 04:00:00,498,0,1619,1845,3962,3317
2022-03-13 04:00:00,2022-03-13 05:00:00,622,5,1692,2056,4375,3543
2022-03-13 05:00:00,2022-03-13 06:00:00,747,121,1722,2080,4670,3646
2022-03-13 06:00:00,2022-03-13 07:00:00,715,374,1733,1925,4747,3814
2022-03-13 07:00:00,2022-03-13 08:00:00,748,643,1694,1871,4956,3870
2022-03-13 08:00:00,2022-03-13 09:00:00,633,878,1673,1979,5163,4001
2022-03-13 09:00:00,2022-03-13 10:00:00,573,1021,1661,1675,4930,4036
2022-03-13 10:00:00,2022-03-13 11:00:00,482,1068,1666,2043,5259,3832
2022-03-13 11:00:00,2022-03-13 12:00:00,475,1049,1715,1951,5190,3885
2022-03-13 12:00:00,2022-03-13 13:00:00,499,844,1745,1980,5068,3851
2022-03-13 13:00:00,2022-03-13 14:00:00,539,620,1869,1748,4776,3906
2022-03-13 14:00:00,2022-03-13 15:00:00,617,331,1878,2019,4845,4020
2022-03-13 15:00:00,2022-03-13 16:00:00,618,89,1890,2334,4931,4350
2022-03-13 16:00:00,2022-03-13 17:00:00,661,5,1898,2258,4822,4442
2022-03-13 17:00:00,2022-03-13 18:00:00,716,2,1856,2205,4779,4293
2022-03-13 18:00:00,2022-03-13 19:00:00,698,2,1794,2202,4696,4093
2022-03-13 19:00:00,2022-03-13 20:00:00,614,2,1770,1462,3848,4039
2022-03-13 20:00:00,2022-03-13 21:00:00,518,2,1838,1546,3904,3824
2022-03-13 21:00:00,2022-03-13 22:00:00,414,2,1833,1348,3597,3656
2022-03-13 22:00:00,2022-03-13 23:00:00,374,2,1342,1179,2897,3544
2022-03-13 23:00:00,2022-03-14 00:00:00,335,2,1380,1218,2935,3447
2022-03-14 00:00:00,2022-03-14 01:00:00,364,2,1628,1470,3464,3383
2022-03-14 01:00:00,2022-03-14 02:00:00,507,2,1635,1521,3665,3426
2022-03-14 02:00:00,2022-03-14 03:00:00,695,2,1561,1109,3367,3548
2022-03-14 03:00:00,2022-03-14 04:00:00,643,2,1619,1447,3711,3704
2022-03-14 04:00:00,2022-03-14 05:00:00,830,8,1598,1611,4047,4358
2022-03-14 05:00:00,2022-03-14 06:00:00,978,125,1569,1486,4158,4765
2022-03-14 06:00:00,2022-03-14 07:00:00,985,414,1414,1206,4019,4892
2022-03-14 07:00:00,2022-03-14 08:00:00,912,691,1049,1057,3709,4845
2022-03-14 08:00:00,2022-03-14 09:00:00,860,910,824,910,3504,4866
2022-03-14 09:00:00,2022-03-14 10:00:00,857,1043,646,729,3275,4799
2022-03-14 10:00:00,2022-03-14 11:00:00,816,1090,626,640,3172,4663
2022-03-14 11:00:00,2022-03-14 12:00:00,758,1014,582,625,2979,4600
2022-03-14 12:00:00,2022-03-14 13:00:00,869,811,552,638,2870,4503
2022-03-14 13:00:00,2022-03-14 14:00:00,909,509,458,617,2493,4434
2022-03-14 14:00:00,2022-03-14 15:00:00,997,220,416,526,2159,4474
2022-03-14 15:00:00,2022-03-14 16:00:00,973,59,330,405,1767,4866
2022-03-14 16:00:00,2022-03-14 17:00:00,1100,3,260,349,1712,4876
2022-03-14 17:00:00,2022-03-14 18:00:00,1030,2,250,317,1599,4657
2022-03-14 18:00:00,2022-03-14 19:00:00,993,2,253,249,1497,4434
2022-03-14 19:00:00,2022-03-14 20:00:00,935,2,237,230,1404,4207
2022-03-14 20:00:00,2022-03-14 21:00:00,903,2,265,233,1403,3926
2022-03-14 21:00:00,2022-03-14 22:00:00,868,2,249,265,1384,3675
2022-03-14 22:00:00,2022-03-14 23:00:00,912,2,248,266,1428,3500
2022-03-14 23:00:00,2022-03-15 00:00:00,966,2,293,250,1511,3363
2022-03-15 00:00:00,2022-03-15 01:00:00,929,2,353,247,1531,3359
2022-03-15 01:00:00,2022-03-15 02:00:00,917,2,259,230,1408,3386
2022-03-15 02:00:00,2022-03-15 03:00:00,925,2,191,184,1302,3448
2022-03-15 03:00:00,2022-03-15 04:00:00,934,2,187,161,1284,3714
2022-03-15 04:00:00,2022-03-15 05:00:00,968,3,168,160,1299,4261
2022-03-15 05:00:00,2022-03-15 06:00:00,994,29,194,189,1406,4790
2022-03-15 06:00:00,2022-03-15 07:00:00,1078,99,188,184,1549,4915
2022-03-15 07:00:00,2022-03-15 08:00:00,1031,188,189,156,1564,4968
2022-03-15 08:00:00,2022-03-15 09:00:00,1058,332,197,153,1740,4982
2022-03-15 09:00:00,2022-03-15 10:00:00,1045,548,226,147,1966,4954
2022-03-15 10:00:00,2022-03-15 11:00:00,1008,720,170,139,2037,4806
2022-03-15 11:00:00,2022-03-15 12:00:00,996,780,119,153,2048,4684
2022-03-15 12:00:00,2022-03-15 13:00:00,995,686,67,167,1915,4694
2022-03-15 13:00:00,2022-03-15 14:00:00,1005,531,38,139,1713,4572
2022-03-15 14:00:00,2022-03-15 15:00:00,1028,339,30,94,1491,4508
2022-03-15 15:00:00,2022-03-15 16:00:00,1113,117,30,69,1329,4864
2022-03-15 16:00:00,2022-03-15 17:00:00,1158,8,30,76,1272,4943
2022-03-15 17:00:00,2022-03-15 18:00:00,1151,0,48,96,1295,4803
2022-03-15 18:00:00,2022-03-15 19:00:00,1152,0,60,99,1311,4558
2022-03-15 19:00:00,2022-03-15 20:00:00,988,0,39,92,1119,4313
2022-03-15 20:00:00,2022-03-15 21:00:00,972,0,43,93,1108,4007
2022-03-15 21:00:00,2022-03-15 22:00:00,952,0,78,80,1110,3767
2022-03-15 22:00:00,2022-03-15 23:00:00,860,0,122,78,1060,3612
2022-03-15 23:00:00,2022-03-16 00:00:00,828,0,124,112,1064,3510
2022-03-16 00:00:00,2022-03-16 01:00:00,833,0,107,154,1094,3464
2022-03-16 01:00:00,2022-03-16 02:00:00,859,0,113,160,1132,3458
2022-03-16 02:00:00,2022-03-16 03:00:00,841,0,127,201,1169,3540
2022-03-16 03:00:00,2022-03-16 04:00:00,866,0,141,262,1269,3787
2022-03-16 04:00:00,2022-03-16 05:00:00,901,5,186,315,1407,4308
2022-03-16 05:00:00,2022-03-16 06:00:00,932,88,259,395,1674,4822
2022-03-16 06:00:00,2022-03-16 07:00:00,953,210,314,357,1834,5038
2022-03-16 07:00:00,2022-03-16 08:00:00,1019,321,314,260,1914,5053
2022-03-16 08:00:00,2022-03-16 09:00:00,1006,416,280,253,1955,5019
2022-03-16 09:00:00,2022-03-16 10:00:00,977,553,439,264,2233,5019
2022-03-16 10:00:00,2022-03-16 11:00:00,953,711,355,298,2317,4948
2022-03-16 11:00:00,2022-03-16 12:00:00,844,756,368,391,2359,4890
2022-03-16 12:00:00,2022-03-16 13:00:00,869,611,412,483,2375,4807
2022-03-16 13:00:00,2022-03-16 14:00:00,860,400,437,502,2199,4710
2022-03-16 14:00:00,2022-03-16 15:00:00,883,216,566,470,2135,4739
2022-03-16 15:00:00,2022-03-16 16:00:00,989,81,704,593,2367,4960
2022-03-16 16:00:00,2022-03-16 17:00:00,960,11,867,818,2656,5036
2022-03-16 17:00:00,2022-03-16 18:00:00,919,0,1067,1014,3000,4865
2022-03-16 18:00:00,2022-03-16 19:00:00,757,0,1204,1185,3146,4726
2022-03-16 19:00:00,2022-03-16 20:00:00,824,0,1248,1411,3483,4297
2022-03-16 20:00:00,2022-03-16 21:00:00,822,0,1432,1556,3810,3989
2022-03-16 21:00:00,2022-03-16 22:00:00,774,0,1430,1631,3835,3752
2022-03-16 22:00:00,2022-03-16 23:00:00,769,0,1520,1886,4175,3661
2022-03-16 23:00:00,2022-03-17 00:00:00,556,0,1613,2240,4409,3509
2022-03-17 00:00:00,2022-03-17 01:00:00,420,0,1764,2514,4698,3463
2022-03-17 01:00:00,2022-03-17 02:00:00,441,0,1797,2708,4946,3490
2022-03-17 02:00:00,2022-03-17 03:00:00,342,0,1768,2371,4481,3676
2022-03-17 03:00:00,2022-03-17 04:00:00,449,0,1750,2384,4583,3909
2022-03-17 04:00:00,2022-03-17 05:00:00,558,1,1841,2857,5257,4439
2022-03-17 05:00:00,2022-03-17 06:00:00,687,16,1913,3420,6036,4794
2022-03-17 06:00:00,2022-03-17 07:00:00,611,46,1991,3449,6097,5031
2022-03-17 07:00:00,2022-03-17 08:00:00,656,77,1962,3411,6106,5108
2022-03-17 08:00:00,2022-03-17 09:00:00,746,103,1970,3373,6192,5180
2022-03-17 09:00:00,2022-03-17 10:00:00,781,135,1997,3142,6055,5200
2022-03-17 10:00:00,2022-03-17 11:00:00,672,140,2013,2880,5705,5092
2022-03-17 11:00:00,2022-03-17 12:00:00,682,110,1993,2809,5594,5056
2022-03-17 12:00:00,2022-03-17 13:00:00,636,99,1985,2807,5527,5065
2022-03-17 13:00:00,2022-03-17 14:00:00,776,123,1798,2796,5493,5016
2022-03-17 14:00:00,2022-03-17 15:00:00,822,144,1708,2713,5387,4857
2022-03-17 15:00:00,2022-03-17 16:00:00,890,79,1615,2402,4986,5087
2022-03-17 16:00:00,2022-03-17 17:00:00,934,10,1314,2104,4362,5099
2022-03-17 17:00:00,2022-03-17 18:00:00,952,0,1228,1856,4036,4907
2022-03-17 18:00:00,2022-03-17 19:00:00,927,0,1270,1731,3928,4631
2022-03-17 19:00:00,2022-03-17 20:00:00,893,0,1254,1618,3765,4356
2022-03-17 20:00:00,2022-03-17 21:00:00,858,0,1175,1610,3643,4054
2022-03-17 21:00:00,2022-03-17 22:00:00,798,0,1156,1551,3505,3821
2022-03-17 22:00:00,2022-03-17 23:00:00,841,0,1086,1437,3364,3670
2022-03-17 23:00:00,2022-03-18 00:00:00,887,0,976,1357,3220,3571
2022-03-18 00:00:00,2022-03-18 01:00:00,881,0,845,1276,3002,3511
2022-03-18 01:00:00,2022-03-18 02:00:00,882,0,642,1192,2716,3485
2022-03-18 02:00:00,2022-03-18 03:00:00,856,0,605,1164,2625,3549
2022-03-18 03:00:00,2022-03-18 04:00:00,931,0,496,1047,2474,3729
2022-03-18 04:00:00,2022-03-18 05:00:00,1021,9,392,844,2266,4279
2022-03-18 05:00:00,2022-03-18 06:00:00,1036,136,421,724,2317,4756
2022-03-18 06:00:00,2022-03-18 07:00:00,1116,440,490,590,2636,4814
2022-03-18 07:00:00,2022-03-18 08:00:00,1084,742,403,717,2946,4725
2022-03-18 08:00:00,2022-03-18 09:00:00,945,950,380,959,3234,4763
2022-03-18 09:00:00,2022-03-18 10:00:00,885,1120,356,1166,3527,4655
2022-03-18 10:00:00,2022-03-18 11:00:00,912,1144,276,1354,3686,4417
2022-03-18 11:00:00,2022-03-18 12:00:00,845,1123,289,1358,3615,4267
2022-03-18 12:00:00,2022-03-18 13:00:00,845,1065,334,1338,3582,4160
2022-03-18 13:00:00,2022-03-18 14:00:00,873,857,396,1178,3304,4115
2022-03-18 14:00:00,2022-03-18 15:00:00,980,532,515,895,2922,4220
2022-03-18 15:00:00,2022-03-18 16:00:00,1056,183,476,529,2244,4517
2022-03-18 16:00:00,2022-03-18 17:00:00,1094,13,406,315,1828,4622
2022-03-18 17:00:00,2022-03-18 18:00:00,1182,0,308,288,1778,4447
2022-03-18 18:00:00,2022-03-18 19:00:00,879,0,347,257,1483,4249
2022-03-18 19:00:00,2022-03-18 20:00:00,922,0,438,233,1593,4021
2022-03-18 20:00:00,2022-03-18 21:00:00,795,0,383,244,1422,3824
2022-03-18 21:00:00,2022-03-18 22:00:00,899,0,402,233,1534,3712
2022-03-18 22:00:00,2022-03-18 23:00:00,971,0,334,225,1530,3500
2022-03-18 23:00:00,2022-03-19 00:00:00,834,0,333,209,1376,3424
2022-03-19 00:00:00,2022-03-19 01:00:00,715,0,327,205,1247,3433
2022-03-19 01:00:00,2022-03-19 02:00:00,738,0,338,192,1268,3489
2022-03-19 02:00:00,2022-03-19 03:00:00,870,0,323,207,1400,3433
2022-03-19 03:00:00,2022-03-19 04:00:00,881,0,315,240,1436,3477
2022-03-19 04:00:00,2022-03-19 05:00:00,873,13,352,256,1494,3616
2022-03-19 05:00:00,2022-03-19 06:00:00,829,162,358,271,1620,3832
2022-03-19 06:00:00,2022-03-19 07:00:00,792,469,358,215,1834,4016
2022-03-19 07:00:00,2022-03-19 08:00:00,632,810,336,142,1920,4019
2022-03-19 08:00:00,2022-03-19 09:00:00,531,1077,339,129,2076,4038
2022-03-19 09:00:00,2022-03-19 10:00:00,557,1218,388,181,2344,3925
2022-03-19 10:00:00,2022-03-19 11:00:00,596,1246,402,261,2505,4048
2022-03-19 11:00:00,2022-03-19 12:00:00,463,1214,511,292,2480,4042
2022-03-19 12:00:00,2022-03-19 13:00:00,436,1095,658,457,2646,3894
2022-03-19 13:00:00,2022-03-19 14:00:00,507,871,666,477,2521,3904
2022-03-19 14:00:00,2022-03-19 15:00:00,414,544,649,567,2174,3807
2022-03-19 15:00:00,2022-03-19 16:00:00,422,192,767,515,1896,4102
2022-03-19 16:00:00,2022-03-19 17:00:00,539,14,813,499,1865,4283
2022-03-19 17:00:00,2022-03-19 18:00:00,533,0,973,631,2137,4278
2022-03-19 18:00:00,2022-03-19 19:00:00,366,0,1144,703,2213,4037
2022-03-19 19:00:00,2022-03-19 20:00:00,421,0,1226,730,2377,3923
2022-03-19 20:00:00,2022-03-19 21:00:00,423,0,1290,840,2553,3695
2022-03-19 21:00:00,2022-03-19 22:00:00,414,0,1196,895,2505,3536
2022-03-19 22:00:00,2022-03-19 23:00:00,437,0,1086,916,2439,3323
2022-03-19 23:00:00,2022-03-20 00:00:00,341,0,1146,986,2473,3251
2022-03-20 00:00:00,2022-03-20 01:00:00,407,0,1078,1015,2500,3204
2022-03-20 01:00:00,2022-03-20 02:00:00,409,0,1226,1040,2675,3240
2022-03-20 02:00:00,2022-03-20 03:00:00,477,0,1164,942,2583,3295
2022-03-20 03:00:00,2022-03-20 04:00:00,504,0,1116,948,2568,3345
2022-03-20 04:00:00,2022-03-20 05:00:00,461,11,1111,943,2526,3393
2022-03-20 05:00:00,2022-03-20 06:00:00,530,138,1011,1001,2680,3727
2022-03-20 06:00:00,2022-03-20 07:00:00,364,388,1197,985,2934,3950
2022-03-20 07:00:00,2022-03-20 08:00:00,344,700,1151,1111,3306,4061
2022-03-20 08:00:00,2022-03-20 09:00:00,329,953,1087,1441,3810,4056
2022-03-20 09:00:00,2022-03-20 10:00:00,294,1127,1278,1818,4517,4017
2022-03-20 10:00:00,2022-03-20 11:00:00,299,1182,1259,2104,4844,3974
2022-03-20 11:00:00,2022-03-20 12:00:00,392,1160,945,2265,4762,3897
2022-03-20 12:00:00,2022-03-20 13:00:00,333,1052,1080,2485,4950,3859
2022-03-20 13:00:00,2022-03-20 14:00:00,318,837,1291,2819,5265,3845
2022-03-20 14:00:00,2022-03-20 15:00:00,294,523,1847,2773,5437,4107
2022-03-20 15:00:00,2022-03-20 16:00:00,330,196,1979,2227,4732,4593
2022-03-20 16:00:00,2022-03-20 17:00:00,341,29,1830,2020,4220,4818
2022-03-20 17:00:00,2022-03-20 18:00:00,357,0,1768,1824,3949,4644
2022-03-20 18:00:00,2022-03-20 19:00:00,345,0,1703,1680,3728,4359
2022-03-20 19:00:00,2022-03-20 20:00:00,297,0,1616,1503,3416,4200
2022-03-20 20:00:00,2022-03-20 21:00:00,298,0,1480,1645,3423,3880
2022-03-20 21:00:00,2022-03-20 22:00:00,269,0,1654,1654,3577,3605
2022-03-20 22:00:00,2022-03-20 23:00:00,252,0,1777,1794,3823,3468
2022-03-20 23:00:00,2022-03-21 00:00:00,312,0,1980,1631,3923,3386
2022-03-21 00:00:00,2022-03-21 01:00:00,361,0,1950,1568,3879,3384
2022-03-21 01:00:00,2022-03-21 02:00:00,438,0,1889,1450,3777,3332
2022-03-21 02:00:00,2022-03-21 03:00:00,433,0,1823,1533,3789,3383
2022-03-21 03:00:00,2022-03-21 04:00:00,366,0,1659,1259,3284,3720
2022-03-21 04:00:00,2022-03-21 05:00:00,384,17,1562,1590,3553,4209
2022-03-21 05:00:00,2022-03-21 06:00:00,620,142,1610,1496,3868,4743
2022-03-21 06:00:00,2022-03-21 07:00:00,648,369,1543,1347,3907,4876
2022-03-21 07:00:00,2022-03-21 08:00:00,637,618,1305,1368,3928,4785
2022-03-21 08:00:00,2022-03-21 09:00:00,606,850,1116,1371,3943,4725
2022-03-21 09:00:00,2022-03-21 10:00:00,573,1095,1014,1320,4002,4630
2022-03-21 10:00:00,2022-03-21 11:00:00,535,1112,942,1295,3884,4507
2022-03-21 11:00:00,2022-03-21 12:00:00,558,1105,980,1171,3814,4474
2022-03-21 12:00:00,2022-03-21 13:00:00,510,965,1039,1021,3535,4384
2022-03-21 13:00:00,2022-03-21 14:00:00,460,749,981,895,3085,4332
2022-03-21 14:00:00,2022-03-21 15:00:00,397,459,942,830,2628,4479
2022-03-21 15:00:00,2022-03-21 16:00:00,616,170,921,719,2426,4787
2022-03-21 16:00:00,2022-03-21 17:00:00,696,18,847,676,2237,4803
2022-03-21 17:00:00,2022-03-21 18:00:00,709,0,774,713,2196,4602
2022-03-21 18:00:00,2022-03-21 19:00:00,711,0,672,738,2121,4438
2022-03-21 19:00:00,2022-03-21 20:00:00,606,0,604,707,1917,4206
2022-03-21 20:00:00,2022-03-21 21:00:00,642,0,763,613,2018,3953
2022-03-21 21:00:00,2022-03-21 22:00:00,627,0,696,482,1805,3715
2022-03-21 22:00:00,2022-03-21 23:00:00,625,0,622,346,1593,3523
2022-03-21 23:00:00,2022-03-22 00:00:00,626,0,538,250,1414,3429
2022-03-22 00:00:00,2022-03-22 01:00:00,685,0,403,202,1290,3391
2022-03-22 01:00:00,2022-03-22 02:00:00,627,0,318,162,1107,3437
2022-03-22 02:00:00,2022-03-22 03:00:00,640,0,254,113,1007,3532
2022-03-22 03:00:00,2022-03-22 04:00:00,691,0,207,96,994,3819
2022-03-22 04:00:00,2022-03-22 05:00:00,689,18,145,99,951,4297
2022-03-22 05:00:00,2022-03-22 06:00:00,697,175,81,85,1038,4778
2022-03-22 06:00:00,2022-03-22 07:00:00,699,466,69,64,1298,4898
2022-03-22 07:00:00,2022-03-22 08:00:00,667,754,77,46,1544,4834
2022-03-22 08:00:00,2022-03-22 09:00:00,589,962,62,46,1659,4769
2022-03-22 09:00:00,2022-03-22 10:00:00,577,1087,43,45,1752,4691
2022-03-22 10:00:00,2022-03-22 11:00:00,586,1103,20,48,1757,4581
2022-03-22 11:00:00,2022-03-22 12:00:00,611,1068,17,62,1758,4543
2022-03-22 12:00:00,2022-03-22 13:00:00,616,946,20,77,1659,4380
2022-03-22 13:00:00,2022-03-22 14:00:00,611,722,46,92,1471,4348
2022-03-22 14:00:00,2022-03-22 15:00:00,601,432,94,107,1234,4415
2022-03-22 15:00:00,2022-03-22 16:00:00,556,173,131,119,979,4726
2022-03-22 16:00:00,2022-03-22 17:00:00,593,19,192,159,963,4730
2022-03-22 17:00:00,2022-03-22 18:00:00,594,1,234,218,1047,4642
2022-03-22 18:00:00,2022-03-22 19:00:00,603,0,213,238,1054,4386
2022-03-22 19:00:00,2022-03-22 20:00:00,694,0,168,251,1113,4194
2022-03-22 20:00:00,2022-03-22 21:00:00,699,0,134,233,1066,3941
2022-03-22 21:00:00,2022-03-22 22:00:00,616,0,120,240,976,3708
2022-03-22 22:00:00,2022-03-22 23:00:00,649,0,110,244,1003,3528
2022-03-22 23:00:00,2022-03-23 00:00:00,633,0,81,245,959,3435
2022-03-23 00:00:00,2022-03-23 01:00:00,637,0,73,270,980,3389
2022-03-23 01:00:00,2022-03-23 02:00:00,675,0,91,289,1055,3364
2022-03-23 02:00:00,2022-03-23 03:00:00,653,0,126,318,1097,3493
2022-03-23 03:00:00,2022-03-23 04:00:00,649,0,165,342,1156,3762
2022-03-23 04:00:00,2022-03-23 05:00:00,684,20,124,355,1183,4287
2022-03-23 05:00:00,2022-03-23 06:00:00,694,157,103,328,1282,4747
2022-03-23 06:00:00,2022-03-23 07:00:00,693,406,90,207,1396,4782
2022-03-23 07:00:00,2022-03-23 08:00:00,681,703,56,93,1533,4773
2022-03-23 08:00:00,2022-03-23 09:00:00,587,975,26,66,1654,4726
2022-03-23 09:00:00,2022-03-23 10:00:00,545,1143,10,57,1755,4637
2022-03-23 10:00:00,2022-03-23 11:00:00,561,1180,3,53,1797,4567
2022-03-23 11:00:00,2022-03-23 12:00:00,557,1136,2,52,1747,4551
2022-03-23 12:00:00,2022-03-23 13:00:00,606,1009,2,56,1673,4493
2022-03-23 13:00:00,2022-03-23 14:00:00,673,790,12,58,1533,4386
2022-03-23 14:00:00,2022-03-23 15:00:00,696,486,43,64,1289,4344
2022-03-23 15:00:00,2022-03-23 16:00:00,707,181,67,71,1026,4671
2022-03-23 16:00:00,2022-03-23 17:00:00,716,20,91,99,926,4705
2022-03-23 17:00:00,2022-03-23 18:00:00,713,1,110,142,966,4576
2022-03-23 18:00:00,2022-03-23 19:00:00,681,0,130,148,959,4404
2022-03-23 19:00:00,2022-03-23 20:00:00,670,0,133,114,917,4160
2022-03-23 20:00:00,2022-03-23 21:00:00,672,0,79,101,852,3926
2022-03-23 21:00:00,2022-03-23 22:00:00,696,0,32,88,816,3685
2022-03-23 22:00:00,2022-03-23 23:00:00,650,0,20,92,762,3539
2022-03-23 23:00:00,2022-03-24 00:00:00,640,0,25,112,777,3472
2022-03-24 00:00:00,2022-03-24 01:00:00,640,0,32,140,812,3430
2022-03-24 01:00:00,2022-03-24 02:00:00,645,0,39,175,859,3416
2022-03-24 02:00:00,2022-03-24 03:00:00,629,0,40,226,895,3450
2022-03-24 03:00:00,2022-03-24 04:00:00,628,0,31,240,899,3756
2022-03-24 04:00:00,2022-03-24 05:00:00,659,27,24,260,970,4256
2022-03-24 05:00:00,2022-03-24 06:00:00,672,197,22,294,1185,4645
2022-03-24 06:00:00,2022-03-24 07:00:00,611,486,29,217,1343,4803
2022-03-24 07:00:00,2022-03-24 08:00:00,586,793,34,139,1552,4642
2022-03-24 08:00:00,2022-03-24 09:00:00,537,1016,42,146,1741,4662
2022-03-24 09:00:00,2022-03-24 10:00:00,557,1160,36,180,1933,4598
2022-03-24 10:00:00,2022-03-24 11:00:00,587,1202,42,249,2080,4501
2022-03-24 11:00:00,2022-03-24 12:00:00,580,1156,44,293,2073,4469
2022-03-24 12:00:00,2022-03-24 13:00:00,626,1023,105,343,2097,4406
2022-03-24 13:00:00,2022-03-24 14:00:00,684,799,195,439,2117,4202
2022-03-24 14:00:00,2022-03-24 15:00:00,703,492,211,516,1922,4343
2022-03-24 15:00:00,2022-03-24 16:00:00,709,185,233,500,1627,4599
2022-03-24 16:00:00,2022-03-24 17:00:00,741,23,294,501,1559,4569
2022-03-24 17:00:00,2022-03-24 18:00:00,725,1,462,509,1697,4532
2022-03-24 18:00:00,2022-03-24 19:00:00,690,0,397,577,1664,4293
2022-03-24 19:00:00,2022-03-24 20:00:00,696,0,384,585,1665,4034
2022-03-24 20:00:00,2022-03-24 21:00:00,691,0,352,602,1645,3706
2022-03-24 21:00:00,2022-03-24 22:00:00,683,0,404,587,1674,3452
2022-03-24 22:00:00,2022-03-24 23:00:00,573,0,448,574,1595,3348
2022-03-24 23:00:00,2022-03-25 00:00:00,584,0,419,543,1546,3269
2022-03-25 00:00:00,2022-03-25 01:00:00,648,0,347,578,1573,3220
2022-03-25 01:00:00,2022-03-25 02:00:00,645,0,367,604,1616,3231
2022-03-25 02:00:00,2022-03-25 03:00:00,647,0,412,694,1753,3301
2022-03-25 03:00:00,2022-03-25 04:00:00,669,0,474,777,1920,3560
2022-03-25 04:00:00,2022-03-25 05:00:00,690,26,586,893,2195,4045
2022-03-25 05:00:00,2022-03-25 06:00:00,678,184,679,888,2429,4402
2022-03-25 06:00:00,2022-03-25 07:00:00,637,490,625,798,2550,4604
2022-03-25 07:00:00,2022-03-25 08:00:00,690,786,644,758,2878,4523
2022-03-25 08:00:00,2022-03-25 09:00:00,630,995,674,934,3233,4536
2022-03-25 09:00:00,2022-03-25 10:00:00,555,1158,631,1240,3584,4410
2022-03-25 10:00:00,2022-03-25 11:00:00,395,1216,647,1510,3768,4232
2022-03-25 11:00:00,2022-03-25 12:00:00,373,1178,657,1714,3922,4084
2022-03-25 12:00:00,2022-03-25 13:00:00,388,1032,677,1898,3995,3931
2022-03-25 13:00:00,2022-03-25 14:00:00,582,832,835,2084,4333,3877
2022-03-25 14:00:00,2022-03-25 15:00:00,507,535,1036,2124,4202,3940
2022-03-25 15:00:00,2022-03-25 16:00:00,424,215,1289,2075,4003,4219
2022-03-25 16:00:00,2022-03-25 17:00:00,448,27,1442,1975,3892,4275
2022-03-25 17:00:00,2022-03-25 18:00:00,460,0,1611,1897,3968,4198
2022-03-25 18:00:00,2022-03-25 19:00:00,514,0,1599,1830,3943,3906
2022-03-25 19:00:00,2022-03-25 20:00:00,531,0,1599,1915,4045,3683
2022-03-25 20:00:00,2022-03-25 21:00:00,487,0,1525,2043,4055,3472
2022-03-25 21:00:00,2022-03-25 22:00:00,356,0,1642,2187,4185,3280
2022-03-25 22:00:00,2022-03-25 23:00:00,315,0,1735,2314,4364,3196
2022-03-25 23:00:00,2022-03-26 00:00:00,399,0,1760,2467,4626,3091
2022-03-26 00:00:00,2022-03-26 01:00:00,336,0,1871,2567,4774,2972
2022-03-26 01:00:00,2022-03-26 02:00:00,133,0,1953,2617,4703,3074
2022-03-26 02:00:00,2022-03-26 03:00:00,124,0,1975,2345,4444,3100
2022-03-26 03:00:00,2022-03-26 04:00:00,242,0,1862,1968,4072,3167
2022-03-26 04:00:00,2022-03-26 05:00:00,354,14,1670,1628,3666,3332
2022-03-26 05:00:00,2022-03-26 06:00:00,322,110,1585,1330,3347,3649
2022-03-26 06:00:00,2022-03-26 07:00:00,286,348,1416,1560,3610,3775
2022-03-26 07:00:00,2022-03-26 08:00:00,456,661,1249,1354,3720,3822
2022-03-26 08:00:00,2022-03-26 09:00:00,277,960,1038,1269,3544,3847
2022-03-26 09:00:00,2022-03-26 10:00:00,447,1157,910,1047,3561,3807
2022-03-26 10:00:00,2022-03-26 11:00:00,289,1250,778,803,3120,3744
2022-03-26 11:00:00,2022-03-26 12:00:00,320,1235,603,643,2801,3620
2022-03-26 12:00:00,2022-03-26 13:00:00,273,1115,497,585,2470,3553
2022-03-26 13:00:00,2022-03-26 14:00:00,327,897,507,532,2263,3517
2022-03-26 14:00:00,2022-03-26 15:00:00,618,590,595,445,2248,3670
2022-03-26 15:00:00,2022-03-26 16:00:00,649,239,557,340,1785,3978
2022-03-26 16:00:00,2022-03-26 17:00:00,661,30,643,265,1599,4079
2022-03-26 17:00:00,2022-03-26 18:00:00,663,1,722,286,1672,4054
2022-03-26 18:00:00,2022-03-26 19:00:00,698,0,638,239,1575,3877
2022-03-26 19:00:00,2022-03-26 20:00:00,695,0,475,162,1332,3654
2022-03-26 20:00:00,2022-03-26 21:00:00,684,0,296,119,1099,3468
2022-03-26 21:00:00,2022-03-26 22:00:00,547,0,254,102,903,3324
2022-03-26 22:00:00,2022-03-26 23:00:00,669,0,269,118,1056,3214
2022-03-26 23:00:00,2022-03-27 00:00:00,675,0,200,177,1052,3133
2022-03-27 00:00:00,2022-03-27 01:00:00,669,0,140,278,1087,3091
2022-03-27 01:00:00,2022-03-27 02:00:00,665,0,185,408,1258,3079
2022-03-27 02:00:00,2022-03-27 03:00:00,653,0,212,501,1366,3108
2022-03-27 03:00:00,2022-03-27 04:00:00,641,1,248,598,1488,3254
2022-03-27 04:00:00,2022-03-27 05:00:00,643,35,360,736,1774,3359
2022-03-27 05:00:00,2022-03-27 06:00:00,634,217,388,910,2149,3566
2022-03-27 06:00:00,2022-03-27 07:00:00,630,446,525,1153,2754,3645
2022-03-27 07:00:00,2022-03-27 08:00:00,633,619,488,1480,3220,3662
2022-03-27 08:00:00,2022-03-27 09:00:00,444,762,723,1682,3611,3664
2022-03-27 09:00:00,2022-03-27 10:00:00,382,939,891,1789,4001,3631
2022-03-27 10:00:00,2022-03-27 11:00:00,268,1081,895,1924,4168,3599
2022-03-27 11:00:00,2022-03-27 12:00:00,324,1122,804,1945,4195,3517
2022-03-27 12:00:00,2022-03-27 13:00:00,374,1005,905,1945,4229,3417
2022-03-27 13:00:00,2022-03-27 14:00:00,383,798,997,1884,4062,3449
2022-03-27 14:00:00,2022-03-27 15:00:00,565,543,1185,1814,4107,3796
2022-03-27 15:00:00,2022-03-27 16:00:00,673,237,1370,1685,3965,3970
2022-03-27 16:00:00,2022-03-27 17:00:00,673,32,1346,1601,3652,3893
2022-03-27 17:00:00,2022-03-27 18:00:00,664,1,1230,1655,3550,3875
2022-03-27 18:00:00,2022-03-27 19:00:00,650,0,1363,1721,3734,3711
2022-03-27 19:00:00,2022-03-27 20:00:00,652,0,1440,1812,3904,3456
2022-03-27 20:00:00,2022-03-27 21:00:00,568,0,1326,1777,3671,3240
2022-03-27 21:00:00,2022-03-27 22:00:00,549,0,1316,1723,3588,3106
2022-03-27 22:00:00,2022-03-27 23:00:00,468,0,1281,1787,3536,3003
2022-03-27 23:00:00,2022-03-28 00:00:00,380,0,1401,1853,3634,2972
2022-03-28 00:00:00,2022-03-28 01:00:00,382,0,1454,1853,3689,2965
2022-03-28 01:00:00,2022-03-28 02:00:00,358,0,1500,1899,3757,3038
2022-03-28 02:00:00,2022-03-28 03:00:00,350,0,1485,1965,3800,3306
2022-03-28 03:00:00,2022-03-28 04:00:00,346,0,1562,1967,3875,3873
2022-03-28 04:00:00,2022-03-28 05:00:00,525,10,1707,2018,4260,4430
2022-03-28 05:00:00,2022-03-28 06:00:00,569,64,1675,2082,4390,4689
2022-03-28 06:00:00,2022-03-28 07:00:00,591,149,1438,2164,4342,4688
2022-03-28 07:00:00,2022-03-28 08:00:00,547,239,1357,2250,4393,4699
2022-03-28 08:00:00,2022-03-28 09:00:00,386,363,1353,2278,4380,4622
2022-03-28 09:00:00,2022-03-28 10:00:00,306,558,1321,2226,4411,4508
2022-03-28 10:00:00,2022-03-28 11:00:00,340,759,1367,2344,4810,4489
2022-03-28 11:00:00,2022-03-28 12:00:00,326,840,1473,2583,5222,4411
2022-03-28 12:00:00,2022-03-28 13:00:00,325,764,1598,2667,5354,4438
2022-03-28 13:00:00,2022-03-28 14:00:00,299,651,1666,2877,5493,4320
2022-03-28 14:00:00,2022-03-28 15:00:00,331,451,1677,2826,5285,4483
2022-03-28 15:00:00,2022-03-28 16:00:00,428,204,1688,2602,4922,4412
2022-03-28 16:00:00,2022-03-28 17:00:00,478,31,1755,2172,4436,4241
2022-03-28 17:00:00,2022-03-28 18:00:00,569,1,1854,1783,4207,4216
2022-03-28 18:00:00,2022-03-28 19:00:00,505,0,1913,1509,3927,4025
2022-03-28 19:00:00,2022-03-28 20:00:00,493,0,1851,1360,3704,3813
2022-03-28 20:00:00,2022-03-28 21:00:00,459,0,1784,1261,3504,3553
2022-03-28 21:00:00,2022-03-28 22:00:00,506,0,1613,1160,3279,3355
2022-03-28 22:00:00,2022-03-28 23:00:00,545,0,1500,1119,3164,3271
2022-03-28 23:00:00,2022-03-29 00:00:00,578,0,1435,1083,3096,3230
2022-03-29 00:00:00,2022-03-29 01:00:00,525,0,1257,1049,2831,3247
2022-03-29 01:00:00,2022-03-29 02:00:00,558,0,1152,936,2646,3353
2022-03-29 02:00:00,2022-03-29 03:00:00,597,0,1038,884,2519,3625
2022-03-29 03:00:00,2022-03-29 04:00:00,605,0,939,805,2349,4213
2022-03-29 04:00:00,2022-03-29 05:00:00,676,35,880,723,2314,4684
2022-03-29 05:00:00,2022-03-29 06:00:00,688,185,851,626,2350,4847
2022-03-29 06:00:00,2022-03-29 07:00:00,689,452,827,673,2641,4786
2022-03-29 07:00:00,2022-03-29 08:00:00,665,679,791,880,3015,4825
2022-03-29 08:00:00,2022-03-29 09:00:00,652,879,775,963,3269,4718
2022-03-29 09:00:00,2022-03-29 10:00:00,622,1028,718,1146,3514,4600
2022-03-29 10:00:00,2022-03-29 11:00:00,581,1087,654,1470,3792,4595
2022-03-29 11:00:00,2022-03-29 12:00:00,574,1089,578,1791,4032,4483
2022-03-29 12:00:00,2022-03-29 13:00:00,535,983,628,1839,3985,4286
2022-03-29 13:00:00,2022-03-29 14:00:00,600,706,522,1617,3445,4264
2022-03-29 14:00:00,2022-03-29 15:00:00,641,428,554,1350,2973,4554
2022-03-29 15:00:00,2022-03-29 16:00:00,627,183,511,952,2273,4541
2022-03-29 16:00:00,2022-03-29 17:00:00,660,31,473,593,1757,4381
2022-03-29 17:00:00,2022-03-29 18:00:00,708,1,620,423,1752,4367
2022-03-29 18:00:00,2022-03-29 19:00:00,708,0,646,345,1699,4180
2022-03-29 19:00:00,2022-03-29 20:00:00,663,0,733,336,1732,3918
2022-03-29 20:00:00,2022-03-29 21:00:00,622,0,503,274,1399,3697
2022-03-29 21:00:00,2022-03-29 22:00:00,587,0,393,260,1240,3534
2022-03-29 22:00:00,2022-03-29 23:00:00,628,0,253,215,1096,3391
2022-03-29 23:00:00,2022-03-30 00:00:00,648,0,212,197,1057,3313
2022-03-30 00:00:00,2022-03-30 01:00:00,650,0,232,215,1097,3379
2022-03-30 01:00:00,2022-03-30 02:00:00,646,0,316,259,1221,3458
2022-03-30 02:00:00,2022-03-30 03:00:00,575,0,347,350,1272,3726
2022-03-30 03:00:00,2022-03-30 04:00:00,629,1,281,434,1345,4290
2022-03-30 04:00:00,2022-03-30 05:00:00,684,33,219,547,1483,4690
2022-03-30 05:00:00,2022-03-30 06:00:00,689,178,236,611,1714,4859
2022-03-30 06:00:00,2022-03-30 07:00:00,680,438,317,722,2157,4824
2022-03-30 07:00:00,2022-03-30 08:00:00,620,593,470,1009,2692,4960
2022-03-30 08:00:00,2022-03-30 09:00:00,625,720,583,1207,3135,4934
2022-03-30 09:00:00,2022-03-30 10:00:00,599,810,721,1301,3431,4839
2022-03-30 10:00:00,2022-03-30 11:00:00,579,805,815,1395,3594,4837
2022-03-30 11:00:00,2022-03-30 12:00:00,574,793,693,1387,3447,4755
2022-03-30 12:00:00,2022-03-30 13:00:00,604,730,766,1320,3420,4643
2022-03-30 13:00:00,2022-03-30 14:00:00,647,591,648,1284,3170,4689
2022-03-30 14:00:00,2022-03-30 15:00:00,698,403,613,1273,2987,4881
2022-03-30 15:00:00,2022-03-30 16:00:00,695,196,720,1170,2781,4796
2022-03-30 16:00:00,2022-03-30 17:00:00,697,33,962,965,2657,4643
2022-03-30 17:00:00,2022-03-30 18:00:00,695,1,1403,901,3000,4607
2022-03-30 18:00:00,2022-03-30 19:00:00,673,0,1430,901,3004,4378
2022-03-30 19:00:00,2022-03-30 20:00:00,663,0,1497,862,3022,4118
2022-03-30 20:00:00,2022-03-30 21:00:00,624,0,1447,829,2900,3882
2022-03-30 21:00:00,2022-03-30 22:00:00,614,0,1387,813,2814,3687
2022-03-30 22:00:00,2022-03-30 23:00:00,521,0,1405,811,2737,3621
2022-03-30 23:00:00,2022-03-31 00:00:00,594,0,1299,812,2705,3603
2022-03-31 00:00:00,2022-03-31 01:00:00,599,0,1218,827,2644,3581
2022-03-31 01:00:00,2022-03-31 02:00:00,593,0,1258,822,2673,3628
2022-03-31 02:00:00,2022-03-31 03:00:00,583,0,1294,836,2713,3871
2022-03-31 03:00:00,2022-03-31 04:00:00,431,1,1243,898,2573,4541
2022-03-31 04:00:00,2022-03-31 05:00:00,417,48,1297,863,2625,5050
2022-03-31 05:00:00,2022-03-31 06:00:00,471,245,1324,757,2797,5192
2022-03-31 06:00:00,2022-03-31 07:00:00,456,553,1231,678,2918,5074
2022-03-31 07:00:00,2022-03-31 08:00:00,425,840,1068,842,3175,5100
2022-03-31 08:00:00,2022-03-31 09:00:00,403,1059,1021,964,3447,5031
2022-03-31 09:00:00,2022-03-31 10:00:00,598,1126,927,1049,3700,4924
2022-03-31 10:00:00,2022-03-31 11:00:00,573,1132,830,1064,3599,4723
2022-03-31 11:00:00,2022-03-31 12:00:00,567,1115,765,1095,3542,4609
2022-03-31 12:00:00,2022-03-31 13:00:00,438,1060,735,1120,3353,4402
2022-03-31 13:00:00,2022-03-31 14:00:00,469,853,871,1134,3327,4393
2022-03-31 14:00:00,2022-03-31 15:00:00,566,572,1057,1123,3318,4578
2022-03-31 15:00:00,2022-03-31 16:00:00,599,278,1169,995,3041,4614
2022-03-31 16:00:00,2022-03-31 17:00:00,428,47,1192,764,2431,4517
2022-03-31 17:00:00,2022-03-31 18:00:00,517,1,1342,678,2538,4476
2022-03-31 18:00:00,2022-03-31 19:00:00,477,0,1403,731,2611,4313
2022-03-31 19:00:00,2022-03-31 20:00:00,499,0,1387,778,2664,4070
2022-03-31 20:00:00,2022-03-31 21:00:00,494,0,1343,812,2649,3828
2022-03-31 21:00:00,2022-03-31 22:00:00,546,0,1334,792,2672,3678
2022-03-31 22:00:00,2022-03-31 23:00:00,570,0,1252,823,2645,3599
2022-03-31 23:00:00,2022-04-01 00:00:00,590,0,1207,852,2649,3552
2022-04-01 00:00:00,2022-04-01 01:00:00,528,0,1178,878,2584,3527
2022-04-01 01:00:00,2022-04-01 02:00:00,541,0,1143,899,2583,3594
2022-04-01 02:00:00,2022-04-01 03:00:00,580,0,1211,927,2718,3855
2022-04-01 03:00:00,2022-04-01 04:00:00,619,1,1266,951,2837,4431
2022-04-01 04:00:00,2022-04-01 05:00:00,615,57,1249,979,2900,4865
2022-04-01 05:00:00,2022-04-01 06:00:00,589,268,1189,844,2890,4975
2022-04-01 06:00:00,2022-04-01 07:00:00,589,573,1095,759,3016,4900
2022-04-01 07:00:00,2022-04-01 08:00:00,605,880,1081,955,3521,4885
2022-04-01 08:00:00,2022-04-01 09:00:00,578,1074,1033,1015,3700,4741
2022-04-01 09:00:00,2022-04-01 10:00:00,579,1131,991,1052,3753,4607
2022-04-01 10:00:00,2022-04-01 11:00:00,590,1094,959,1028,3671,4477
2022-04-01 11:00:00,2022-04-01 12:00:00,581,1049,1094,1042,3766,4314
2022-04-01 12:00:00,2022-04-01 13:00:00,451,914,1306,1016,3687,4375
2022-04-01 13:00:00,2022-04-01 14:00:00,388,757,1514,1062,3721,4420
2022-04-01 14:00:00,2022-04-01 15:00:00,510,528,1642,1139,3819,4593
2022-04-01 15:00:00,2022-04-01 16:00:00,512,246,1659,1043,3460,4586
2022-04-01 16:00:00,2022-04-01 17:00:00,482,49,1674,785,2990,4369
2022-04-01 17:00:00,2022-04-01 18:00:00,606,1,1545,702,2854,4292
2022-04-01 18:00:00,2022-04-01 19:00:00,555,0,1384,701,2640,4076
2022-04-01 19:00:00,2022-04-01 20:00:00,436,0,1217,712,2365,3893
2022-04-01 20:00:00,2022-04-01 21:00:00,459,0,1142,667,2268,3755
2022-04-01 21:00:00,2022-04-01 22:00:00,539,0,1054,598,2191,3683
2022-04-01 22:00:00,2022-04-01 23:00:00,515,0,848,584,1947,3614
2022-04-01 23:00:00,2022-04-02 00:00:00,526,0,693,566,1785,3573
2022-04-02 00:00:00,2022-04-02 01:00:00,531,0,739,572,1842,3421
2022-04-02 01:00:00,2022-04-02 02:00:00,549,0,758,601,1908,3552
2022-04-02 02:00:00,2022-04-02 03:00:00,517,0,782,657,1956,3636
2022-04-02 03:00:00,2022-04-02 04:00:00,606,1,728,608,1943,3760
2022-04-02 04:00:00,2022-04-02 05:00:00,640,71,727,512,1950,3896
2022-04-02 05:00:00,2022-04-02 06:00:00,670,334,715,399,2118,4087
2022-04-02 06:00:00,2022-04-02 07:00:00,651,685,668,321,2325,4102
2022-04-02 07:00:00,2022-04-02 08:00:00,638,996,551,413,2598,4151
2022-04-02 08:00:00,2022-04-02 09:00:00,490,1147,417,394,2448,4136
2022-04-02 09:00:00,2022-04-02 10:00:00,531,1111,268,359,2269,4040
2022-04-02 10:00:00,2022-04-02 11:00:00,485,1110,175,336,2106,3886
2022-04-02 11:00:00,2022-04-02 12:00:00,463,1000,120,364,1947,3805
2022-04-02 12:00:00,2022-04-02 13:00:00,541,914,127,431,2013,3782
2022-04-02 13:00:00,2022-04-02 14:00:00,605,759,130,463,1957,3788
2022-04-02 14:00:00,2022-04-02 15:00:00,637,574,160,488,1859,4028
2022-04-02 15:00:00,2022-04-02 16:00:00,744,287,234,447,1712,4111
2022-04-02 16:00:00,2022-04-02 17:00:00,741,53,379,398,1571,4021
2022-04-02 17:00:00,2022-04-02 18:00:00,650,1,448,363,1462,3974
2022-04-02 18:00:00,2022-04-02 19:00:00,748,0,387,348,1483,3867
2022-04-02 19:00:00,2022-04-02 20:00:00,747,0,321,352,1420,3706
2022-04-02 20:00:00,2022-04-02 21:00:00,718,0,389,371,1478,3549
2022-04-02 21:00:00,2022-04-02 22:00:00,587,0,354,417,1358,3453
2022-04-02 22:00:00,2022-04-02 23:00:00,542,0,469,500,1511,3351
2022-04-02 23:00:00,2022-04-03 00:00:00,533,0,654,648,1835,3314
2022-04-03 00:00:00,2022-04-03 01:00:00,573,0,636,755,1964,3274
2022-04-03 01:00:00,2022-04-03 02:00:00,574,0,685,817,2076,3325
2022-04-03 02:00:00,2022-04-03 03:00:00,714,0,755,892,2361,3326
2022-04-03 03:00:00,2022-04-03 04:00:00,725,3,732,999,2459,3468
2022-04-03 04:00:00,2022-04-03 05:00:00,710,77,735,1038,2560,3648
2022-04-03 05:00:00,2022-04-03 06:00:00,701,310,749,886,2646,3823
2022-04-03 06:00:00,2022-04-03 07:00:00,691,575,830,1086,3182,3872
2022-04-03 07:00:00,2022-04-03 08:00:00,694,764,849,1296,3603,3892
2022-04-03 08:00:00,2022-04-03 09:00:00,713,843,941,1506,4003,3865
2022-04-03 09:00:00,2022-04-03 10:00:00,579,801,873,1684,3937,3783
2022-04-03 10:00:00,2022-04-03 11:00:00,510,757,843,1980,4090,3729
2022-04-03 11:00:00,2022-04-03 12:00:00,479,800,944,2275,4498,3856
2022-04-03 12:00:00,2022-04-03 13:00:00,457,663,1102,1732,3954,3983
2022-04-03 13:00:00,2022-04-03 14:00:00,488,488,1141,1882,3999,4105
2022-04-03 14:00:00,2022-04-03 15:00:00,441,273,1399,2260,4373,4363
2022-04-03 15:00:00,2022-04-03 16:00:00,450,105,1727,1828,4110,4463
2022-04-03 16:00:00,2022-04-03 17:00:00,442,20,1878,1768,4108,4359
2022-04-03 17:00:00,2022-04-03 18:00:00,457,1,1885,1844,4187,4209
2022-04-03 18:00:00,2022-04-03 19:00:00,448,0,1867,1924,4239,4071
2022-04-03 19:00:00,2022-04-03 20:00:00,398,0,1901,2132,4431,3808
2022-04-03 20:00:00,2022-04-03 21:00:00,396,0,1968,1976,4340,3671
2022-04-03 21:00:00,2022-04-03 22:00:00,465,0,2000,2000,4465,3484
2022-04-03 22:00:00,2022-04-03 23:00:00,531,0,2041,1944,4516,3392
2022-04-03 23:00:00,2022-04-04 00:00:00,541,0,2036,2416,4993,3281
2022-04-04 00:00:00,2022-04-04 01:00:00,477,0,2001,2492,4970,3283
2022-04-04 01:00:00,2022-04-04 02:00:00,482,0,2013,2433,4928,3447
2022-04-04 02:00:00,2022-04-04 03:00:00,496,0,2013,2565,5074,3683
2022-04-04 03:00:00,2022-04-04 04:00:00,530,1,2039,2622,5192,4225
2022-04-04 04:00:00,2022-04-04 05:00:00,558,13,2058,3257,5886,4756
2022-04-04 05:00:00,2022-04-04 06:00:00,695,44,2053,3340,6132,5103
2022-04-04 06:00:00,2022-04-04 07:00:00,625,74,2042,3682,6423,5242
2022-04-04 07:00:00,2022-04-04 08:00:00,479,104,2002,3240,5825,5367
2022-04-04 08:00:00,2022-04-04 09:00:00,468,160,2048,3400,6076,5411
2022-04-04 09:00:00,2022-04-04 10:00:00,436,197,2001,3614,6248,5352
2022-04-04 10:00:00,2022-04-04 11:00:00,465,266,1974,3476,6181,5324
2022-04-04 11:00:00,2022-04-04 12:00:00,499,378,1977,3776,6630,5160
2022-04-04 12:00:00,2022-04-04 13:00:00,511,403,1987,3267,6168,5082
2022-04-04 13:00:00,2022-04-04 14:00:00,528,409,1991,3565,6493,5022
2022-04-04 14:00:00,2022-04-04 15:00:00,610,367,2037,3425,6439,5199
2022-04-04 15:00:00,2022-04-04 16:00:00,599,183,2036,3524,6342,5009
2022-04-04 16:00:00,2022-04-04 17:00:00,565,46,2023,3405,6039,4850
2022-04-04 17:00:00,2022-04-04 18:00:00,493,2,1937,3185,5617,4712
2022-04-04 18:00:00,2022-04-04 19:00:00,408,0,1931,3419,5758,4479
2022-04-04 19:00:00,2022-04-04 20:00:00,456,0,1933,3174,5563,4228
2022-04-04 20:00:00,2022-04-04 21:00:00,462,0,1996,2887,5345,4051
2022-04-04 21:00:00,2022-04-04 22:00:00,422,0,2007,2942,5371,3781
2022-04-04 22:00:00,2022-04-04 23:00:00,434,0,2038,2859,5331,3661
2022-04-04 23:00:00,2022-04-05 00:00:00,385,0,1966,2719,5070,3676
2022-04-05 00:00:00,2022-04-05 01:00:00,566,0,2006,2569,5141,3570
2022-04-05 01:00:00,2022-04-05 02:00:00,589,0,1967,2387,4943,3574
2022-04-05 02:00:00,2022-04-05 03:00:00,626,0,1828,2225,4679,3785
2022-04-05 03:00:00,2022-04-05 04:00:00,704,3,1840,1994,4541,4342
2022-04-05 04:00:00,2022-04-05 05:00:00,755,79,1776,1794,4404,4859
2022-04-05 05:00:00,2022-04-05 06:00:00,725,321,1641,1745,4432,4957
2022-04-05 06:00:00,2022-04-05 07:00:00,673,603,1545,1986,4807,4911
2022-04-05 07:00:00,2022-04-05 08:00:00,663,813,1398,2147,5021,4921
2022-04-05 08:00:00,2022-04-05 09:00:00,645,939,1226,2117,4927,4845
2022-04-05 09:00:00,2022-04-05 10:00:00,668,975,1322,2122,5087,4719
2022-04-05 10:00:00,2022-04-05 11:00:00,675,950,1140,2332,5097,4733
2022-04-05 11:00:00,2022-04-05 12:00:00,661,877,1094,2564,5196,4589
2022-04-05 12:00:00,2022-04-05 13:00:00,646,849,1075,2774,5344,4508
2022-04-05 13:00:00,2022-04-05 14:00:00,646,696,1084,2739,5165,4543
2022-04-05 14:00:00,2022-04-05 15:00:00,669,433,1167,2514,4783,4784
2022-04-05 15:00:00,2022-04-05 16:00:00,697,198,1167,2111,4173,4705
2022-04-05 16:00:00,2022-04-05 17:00:00,795,43,1102,1454,3394,4575
2022-04-05 17:00:00,2022-04-05 18:00:00,822,1,965,986,2774,4488
2022-04-05 18:00:00,2022-04-05 19:00:00,788,0,853,669,2310,4306
2022-04-05 19:00:00,2022-04-05 20:00:00,705,0,757,475,1937,4039
2022-04-05 20:00:00,2022-04-05 21:00:00,669,0,637,352,1658,3789
2022-04-05 21:00:00,2022-04-05 22:00:00,675,0,426,266,1367,3641
2022-04-05 22:00:00,2022-04-05 23:00:00,671,0,329,206,1206,3554
2022-04-05 23:00:00,2022-04-06 00:00:00,605,0,256,212,1073,3511
2022-04-06 00:00:00,2022-04-06 01:00:00,569,0,343,235,1147,3546
2022-04-06 01:00:00,2022-04-06 02:00:00,537,0,598,287,1422,3591
2022-04-06 02:00:00,2022-04-06 03:00:00,603,0,588,422,1613,3812
2022-04-06 03:00:00,2022-04-06 04:00:00,685,1,872,769,2327,4403
2022-04-06 04:00:00,2022-04-06 05:00:00,666,10,1131,1120,2927,4959
2022-04-06 05:00:00,2022-04-06 06:00:00,692,34,1431,1542,3699,5148
2022-04-06 06:00:00,2022-04-06 07:00:00,677,69,1745,2014,4505,5083
2022-04-06 07:00:00,2022-04-06 08:00:00,795,114,1918,2468,5295,5014
2022-04-06 08:00:00,2022-04-06 09:00:00,674,217,2062,2846,5799,5168
2022-04-06 09:00:00,2022-04-06 10:00:00,648,382,2004,2979,6013,5118
2022-04-06 10:00:00,2022-04-06 11:00:00,558,386,2059,3088,6091,5028
2022-04-06 11:00:00,2022-04-06 12:00:00,548,326,2009,2789,5672,4900
2022-04-06 12:00:00,2022-04-06 13:00:00,585,205,1997,2732,5519,4814
2022-04-06 13:00:00,2022-04-06 14:00:00,609,153,1893,2856,5511,4897
2022-04-06 14:00:00,2022-04-06 15:00:00,584,131,2013,2820,5548,5054
2022-04-06 15:00:00,2022-04-06 16:00:00,604,86,1995,2693,5378,5020
2022-04-06 16:00:00,2022-04-06 17:00:00,536,35,1891,2331,4793,4718
2022-04-06 17:00:00,2022-04-06 18:00:00,673,2,1753,1861,4289,4494
2022-04-06 18:00:00,2022-04-06 19:00:00,641,0,1740,1637,4018,4230
2022-04-06 19:00:00,2022-04-06 20:00:00,560,0,1541,1434,3535,4039
2022-04-06 20:00:00,2022-04-06 21:00:00,640,0,1346,1241,3227,3825
2022-04-06 21:00:00,2022-04-06 22:00:00,369,0,1597,1111,3077,3793
2022-04-06 22:00:00,2022-04-06 23:00:00,300,0,1513,946,2759,3735
2022-04-06 23:00:00,2022-04-07 00:00:00,382,0,1168,825,2375,3655
2022-04-07 00:00:00,2022-04-07 01:00:00,372,0,1148,760,2280,3511
2022-04-07 01:00:00,2022-04-07 02:00:00,405,0,1235,624,2264,3534
2022-04-07 02:00:00,2022-04-07 03:00:00,468,0,1526,701,2695,3733
2022-04-07 03:00:00,2022-04-07 04:00:00,515,1,1571,934,3021,4294
2022-04-07 04:00:00,2022-04-07 05:00:00,641,15,1628,1265,3549,4802
2022-04-07 05:00:00,2022-04-07 06:00:00,603,69,1629,1590,3891,5077
2022-04-07 06:00:00,2022-04-07 07:00:00,546,152,1325,1752,3775,5121
2022-04-07 07:00:00,2022-04-07 08:00:00,476,197,1451,1683,3807,5173
2022-04-07 08:00:00,2022-04-07 09:00:00,324,289,1697,1798,4108,5139
2022-04-07 09:00:00,2022-04-07 10:00:00,297,400,1754,1975,4426,5203
2022-04-07 10:00:00,2022-04-07 11:00:00,421,507,1570,2081,4579,5017
2022-04-07 11:00:00,2022-04-07 12:00:00,386,576,1528,1956,4446,4862
2022-04-07 12:00:00,2022-04-07 13:00:00,346,610,1504,1969,4429,4695
2022-04-07 13:00:00,2022-04-07 14:00:00,365,431,1476,1770,4042,4729
2022-04-07 14:00:00,2022-04-07 15:00:00,440,273,1441,1727,3881,4908
2022-04-07 15:00:00,2022-04-07 16:00:00,469,146,1661,1855,4131,4843
2022-04-07 16:00:00,2022-04-07 17:00:00,475,28,1507,2035,4045,4679
2022-04-07 17:00:00,2022-04-07 18:00:00,500,1,1705,2513,4719,4581
2022-04-07 18:00:00,2022-04-07 19:00:00,476,0,1930,2967,5373,4439
2022-04-07 19:00:00,2022-04-07 20:00:00,446,0,1982,3044,5472,4216
2022-04-07 20:00:00,2022-04-07 21:00:00,441,0,2009,2494,4944,3987
2022-04-07 21:00:00,2022-04-07 22:00:00,316,0,1954,2450,4720,3801
2022-04-07 22:00:00,2022-04-07 23:00:00,289,0,1938,2435,4662,3770
2022-04-07 23:00:00,2022-04-08 00:00:00,285,0,1920,2459,4664,3809
2022-04-08 00:00:00,2022-04-08 01:00:00,312,0,1945,2397,4654,3797
2022-04-08 01:00:00,2022-04-08 02:00:00,394,0,1987,2329,4710,3818
2022-04-08 02:00:00,2022-04-08 03:00:00,474,0,1985,2658,5117,3984
2022-04-08 03:00:00,2022-04-08 04:00:00,520,6,2010,2229,4765,4495
2022-04-08 04:00:00,2022-04-08 05:00:00,554,88,2012,2559,5213,4913
2022-04-08 05:00:00,2022-04-08 06:00:00,497,289,2022,2878,5686,5073
2022-04-08 06:00:00,2022-04-08 07:00:00,427,526,2037,2945,5935,5022
2022-04-08 07:00:00,2022-04-08 08:00:00,364,701,1988,2908,5961,5061
2022-04-08 08:00:00,2022-04-08 09:00:00,507,853,1807,2515,5682,5134
2022-04-08 09:00:00,2022-04-08 10:00:00,481,931,1736,2386,5534,4902
2022-04-08 10:00:00,2022-04-08 11:00:00,471,970,1658,2393,5492,4799
2022-04-08 11:00:00,2022-04-08 12:00:00,455,1007,1477,2305,5244,4635
2022-04-08 12:00:00,2022-04-08 13:00:00,443,863,1566,2733,5605,4447
2022-04-08 13:00:00,2022-04-08 14:00:00,443,778,1688,2795,5704,4478
2022-04-08 14:00:00,2022-04-08 15:00:00,447,580,1768,2660,5455,4566
2022-04-08 15:00:00,2022-04-08 16:00:00,643,277,1771,2600,5291,4652
2022-04-08 16:00:00,2022-04-08 17:00:00,488,61,1795,2461,4805,4442
2022-04-08 17:00:00,2022-04-08 18:00:00,735,3,1758,2273,4769,4188
2022-04-08 18:00:00,2022-04-08 19:00:00,728,1,1825,2198,4752,4027
2022-04-08 19:00:00,2022-04-08 20:00:00,644,1,1880,2222,4747,3935
2022-04-08 20:00:00,2022-04-08 21:00:00,641,1,1747,2310,4699,3727
2022-04-08 21:00:00,2022-04-08 22:00:00,501,1,1891,2449,4842,3572
2022-04-08 22:00:00,2022-04-08 23:00:00,529,1,1923,2639,5092,3470
2022-04-08 23:00:00,2022-04-09 00:00:00,494,0,2015,2763,5272,3400
2022-04-09 00:00:00,2022-04-09 01:00:00,484,0,2016,2785,5285,3357
2022-04-09 01:00:00,2022-04-09 02:00:00,507,0,2022,2856,5385,3387
2022-04-09 02:00:00,2022-04-09 03:00:00,489,0,2017,2877,5383,3529
2022-04-09 03:00:00,2022-04-09 04:00:00,466,7,2028,2925,5426,3535
2022-04-09 04:00:00,2022-04-09 05:00:00,543,96,2009,2686,5334,3933
2022-04-09 05:00:00,2022-04-09 06:00:00,568,328,1993,2668,5557,4113
2022-04-09 06:00:00,2022-04-09 07:00:00,507,586,2002,2964,6059,4232
2022-04-09 07:00:00,2022-04-09 08:00:00,440,781,2005,3208,6434,4279
2022-04-09 08:00:00,2022-04-09 09:00:00,385,910,1927,2975,6197,4295
2022-04-09 09:00:00,2022-04-09 10:00:00,301,1049,1107,3306,5763,4258
2022-04-09 10:00:00,2022-04-09 11:00:00,304,1050,1104,3568,6026,4134
2022-04-09 11:00:00,2022-04-09 12:00:00,314,1021,1148,2849,5332,4063
2022-04-09 12:00:00,2022-04-09 13:00:00,285,940,1173,3345,5743,4047
2022-04-09 13:00:00,2022-04-09 14:00:00,328,770,1176,3607,5881,3972
2022-04-09 14:00:00,2022-04-09 15:00:00,416,530,1985,3843,6774,4217
2022-04-09 15:00:00,2022-04-09 16:00:00,364,282,2023,3127,5796,4362
2022-04-09 16:00:00,2022-04-09 17:00:00,448,70,2037,3030,5585,4239
2022-04-09 17:00:00,2022-04-09 18:00:00,413,4,2016,3428,5861,4095
2022-04-09 18:00:00,2022-04-09 19:00:00,435,1,2014,3426,5876,3937
2022-04-09 19:00:00,2022-04-09 20:00:00,417,1,2010,3442,5870,3680
2022-04-09 20:00:00,2022-04-09 21:00:00,260,0,1991,3428,5679,3526
2022-04-09 21:00:00,2022-04-09 22:00:00,265,0,1994,3242,5501,3505
2022-04-09 22:00:00,2022-04-09 23:00:00,324,0,2032,2890,5246,3431
2022-04-09 23:00:00,2022-04-10 00:00:00,267,0,2006,3075,5348,3347
2022-04-10 00:00:00,2022-04-10 01:00:00,319,0,2008,2949,5276,3338
2022-04-10 01:00:00,2022-04-10 02:00:00,328,0,2014,2858,5200,3362
2022-04-10 02:00:00,2022-04-10 03:00:00,398,0,1989,2922,5309,3430
2022-04-10 03:00:00,2022-04-10 04:00:00,414,8,1988,3000,5410,3425
2022-04-10 04:00:00,2022-04-10 05:00:00,354,107,1981,2893,5335,3734
2022-04-10 05:00:00,2022-04-10 06:00:00,356,373,2011,3100,5840,3888
2022-04-10 06:00:00,2022-04-10 07:00:00,305,652,1977,3358,6292,3913
2022-04-10 07:00:00,2022-04-10 08:00:00,278,911,1995,3531,6715,4021
2022-04-10 08:00:00,2022-04-10 09:00:00,285,1042,2014,3547,6888,4071
2022-04-10 09:00:00,2022-04-10 10:00:00,276,1022,1969,3487,6754,4050
2022-04-10 10:00:00,2022-04-10 11:00:00,284,1069,1923,3282,6558,4081
2022-04-10 11:00:00,2022-04-10 12:00:00,283,1008,1908,3211,6410,4008
2022-04-10 12:00:00,2022-04-10 13:00:00,300,935,1848,3481,6564,3915
2022-04-10 13:00:00,2022-04-10 14:00:00,333,766,1783,3354,6236,3973
2022-04-10 14:00:00,2022-04-10 15:00:00,389,538,1716,2900,5543,4287
2022-04-10 15:00:00,2022-04-10 16:00:00,442,270,1741,2539,4992,4382
2022-04-10 16:00:00,2022-04-10 17:00:00,492,72,1470,2359,4393,4253
2022-04-10 17:00:00,2022-04-10 18:00:00,581,3,1446,2398,4428,4144
2022-04-10 18:00:00,2022-04-10 19:00:00,665,0,1360,2262,4287,3967
2022-04-10 19:00:00,2022-04-10 20:00:00,679,0,1468,1988,4135,3775
2022-04-10 20:00:00,2022-04-10 21:00:00,664,0,1453,1821,3938,3624
2022-04-10 21:00:00,2022-04-10 22:00:00,653,0,1465,1680,3798,3471
2022-04-10 22:00:00,2022-04-10 23:00:00,637,0,1387,1568,3592,3379
2022-04-10 23:00:00,2022-04-11 00:00:00,649,0,1325,1501,3475,3349
2022-04-11 00:00:00,2022-04-11 01:00:00,657,0,1223,1484,3364,3359
2022-04-11 01:00:00,2022-04-11 02:00:00,646,0,1201,1442,3289,3426
2022-04-11 02:00:00,2022-04-11 03:00:00,661,0,1194,1371,3226,3657
2022-04-11 03:00:00,2022-04-11 04:00:00,719,11,1132,1240,3102,4071
2022-04-11 04:00:00,2022-04-11 05:00:00,839,111,1064,1139,3153,4487
2022-04-11 05:00:00,2022-04-11 06:00:00,812,368,836,1167,3183,4603
2022-04-11 06:00:00,2022-04-11 07:00:00,802,674,744,1396,3616,4653
2022-04-11 07:00:00,2022-04-11 08:00:00,672,882,699,1302,3555,4688
2022-04-11 08:00:00,2022-04-11 09:00:00,645,1022,523,1095,3285,4579
2022-04-11 09:00:00,2022-04-11 10:00:00,579,1127,373,1032,3111,4496
2022-04-11 10:00:00,2022-04-11 11:00:00,543,1177,365,913,2998,4458
2022-04-11 11:00:00,2022-04-11 12:00:00,531,1227,348,936,3042,4360
2022-04-11 12:00:00,2022-04-11 13:00:00,548,1209,263,854,2874,4210
2022-04-11 13:00:00,2022-04-11 14:00:00,550,981,171,736,2438,4176
2022-04-11 14:00:00,2022-04-11 15:00:00,699,657,107,606,2069,4421
2022-04-11 15:00:00,2022-04-11 16:00:00,768,339,114,404,1625,4458
2022-04-11 16:00:00,2022-04-11 17:00:00,795,95,115,219,1224,4350
2022-04-11 17:00:00,2022-04-11 18:00:00,834,5,141,163,1143,4236
2022-04-11 18:00:00,2022-04-11 19:00:00,776,0,119,146,1041,4134
2022-04-11 19:00:00,2022-04-11 20:00:00,741,0,102,132,975,3943
2022-04-11 20:00:00,2022-04-11 21:00:00,713,0,114,121,948,3736
2022-04-11 21:00:00,2022-04-11 22:00:00,544,0,115,141,800,3559
2022-04-11 22:00:00,2022-04-11 23:00:00,486,0,126,157,769,3482
2022-04-11 23:00:00,2022-04-12 00:00:00,566,0,183,204,953,3473
2022-04-12 00:00:00,2022-04-12 01:00:00,555,0,315,287,1157,3484
2022-04-12 01:00:00,2022-04-12 02:00:00,528,0,385,479,1392,3565
2022-04-12 02:00:00,2022-04-12 03:00:00,521,0,308,597,1426,3794
2022-04-12 03:00:00,2022-04-12 04:00:00,564,15,290,592,1461,4256
2022-04-12 04:00:00,2022-04-12 05:00:00,687,140,370,605,1802,4560
2022-04-12 05:00:00,2022-04-12 06:00:00,699,330,601,546,2176,4726
2022-04-12 06:00:00,2022-04-12 07:00:00,554,477,657,555,2243,4736
2022-04-12 07:00:00,2022-04-12 08:00:00,554,552,692,781,2579,4716
2022-04-12 08:00:00,2022-04-12 09:00:00,501,699,790,1048,3038,4652
2022-04-12 09:00:00,2022-04-12 10:00:00,386,915,849,1297,3447,4600
2022-04-12 10:00:00,2022-04-12 11:00:00,362,1057,879,1450,3748,4616
2022-04-12 11:00:00,2022-04-12 12:00:00,490,939,984,1547,3960,4412
2022-04-12 12:00:00,2022-04-12 13:00:00,499,965,1057,1598,4119,4255
2022-04-12 13:00:00,2022-04-12 14:00:00,470,842,1223,1700,4235,4215
2022-04-12 14:00:00,2022-04-12 15:00:00,353,571,1255,1825,4004,4540
2022-04-12 15:00:00,2022-04-12 16:00:00,322,234,1376,1298,3230,4665
2022-04-12 16:00:00,2022-04-12 17:00:00,336,61,1458,1369,3224,4528
2022-04-12 17:00:00,2022-04-12 18:00:00,361,3,1547,1575,3486,4363
2022-04-12 18:00:00,2022-04-12 19:00:00,404,0,1679,1867,3950,4184
2022-04-12 19:00:00,2022-04-12 20:00:00,504,0,1712,1818,4034,3944
2022-04-12 20:00:00,2022-04-12 21:00:00,450,0,1797,1842,4089,3681
2022-04-12 21:00:00,2022-04-12 22:00:00,394,1,1776,1979,4150,3513
2022-04-12 22:00:00,2022-04-12 23:00:00,359,0,1786,2083,4228,3394
2022-04-12 23:00:00,2022-04-13 00:00:00,383,0,1860,2236,4479,3329
2022-04-13 00:00:00,2022-04-13 01:00:00,391,0,1975,2177,4543,3411
2022-04-13 01:00:00,2022-04-13 02:00:00,407,0,1998,1801,4206,3486
2022-04-13 02:00:00,2022-04-13 03:00:00,360,0,1984,1844,4188,3633
2022-04-13 03:00:00,2022-04-13 04:00:00,387,9,1953,1389,3738,4050
2022-04-13 04:00:00,2022-04-13 05:00:00,410,92,1906,1599,4007,4480
2022-04-13 05:00:00,2022-04-13 06:00:00,509,249,1613,1685,4056,4587
2022-04-13 06:00:00,2022-04-13 07:00:00,553,426,1457,1570,4006,4579
2022-04-13 07:00:00,2022-04-13 08:00:00,509,604,1208,1412,3733,4604
2022-04-13 08:00:00,2022-04-13 09:00:00,579,671,1036,1279,3565,4574
2022-04-13 09:00:00,2022-04-13 10:00:00,643,755,1055,1097,3550,4421
2022-04-13 10:00:00,2022-04-13 11:00:00,569,857,1006,894,3326,4564
2022-04-13 11:00:00,2022-04-13 12:00:00,481,823,916,677,2897,4456
2022-04-13 12:00:00,2022-04-13 13:00:00,643,808,878,836,3165,4193
2022-04-13 13:00:00,2022-04-13 14:00:00,709,578,665,763,2715,4158
2022-04-13 14:00:00,2022-04-13 15:00:00,935,298,473,590,2296,4322
2022-04-13 15:00:00,2022-04-13 16:00:00,1095,181,412,397,2085,4288
2022-04-13 16:00:00,2022-04-13 17:00:00,962,63,423,384,1832,4227
2022-04-13 17:00:00,2022-04-13 18:00:00,1015,4,445,417,1881,4107
2022-04-13 18:00:00,2022-04-13 19:00:00,1033,0,278,401,1712,3935
2022-04-13 19:00:00,2022-04-13 20:00:00,1157,0,304,398,1859,3621
2022-04-13 20:00:00,2022-04-13 21:00:00,1039,0,346,390,1775,3401
2022-04-13 21:00:00,2022-04-13 22:00:00,1036,0,367,371,1774,3241
2022-04-13 22:00:00,2022-04-13 23:00:00,1042,0,491,417,1950,3117
2022-04-13 23:00:00,2022-04-14 00:00:00,914,0,491,464,1869,3044
2022-04-14 00:00:00,2022-04-14 01:00:00,911,0,401,523,1835,3015
2022-04-14 01:00:00,2022-04-14 02:00:00,923,0,462,528,1913,3028
2022-04-14 02:00:00,2022-04-14 03:00:00,908,0,660,509,2077,3089
2022-04-14 03:00:00,2022-04-14 04:00:00,1019,3,694,534,2250,3237
2022-04-14 04:00:00,2022-04-14 05:00:00,1017,29,761,612,2419,3464
2022-04-14 05:00:00,2022-04-14 06:00:00,989,81,684,738,2492,3749
2022-04-14 06:00:00,2022-04-14 07:00:00,1005,139,659,797,2600,3940
2022-04-14 07:00:00,2022-04-14 08:00:00,1002,225,714,749,2690,3997
2022-04-14 08:00:00,2022-04-14 09:00:00,1031,351,733,717,2832,3977
2022-04-14 09:00:00,2022-04-14 10:00:00,975,427,722,754,2878,3860
2022-04-14 10:00:00,2022-04-14 11:00:00,761,432,691,766,2650,3780
2022-04-14 11:00:00,2022-04-14 12:00:00,745,410,697,688,2540,3753
2022-04-14 12:00:00,2022-04-14 13:00:00,721,351,770,608,2450,3728
2022-04-14 13:00:00,2022-04-14 14:00:00,728,266,799,657,2450,3821
2022-04-14 14:00:00,2022-04-14 15:00:00,990,159,764,834,2747,4077
2022-04-14 15:00:00,2022-04-14 16:00:00,1093,71,806,832,2802,4093
2022-04-14 16:00:00,2022-04-14 17:00:00,841,19,788,869,2517,3957
2022-04-14 17:00:00,2022-04-14 18:00:00,783,1,784,876,2444,3835
2022-04-14 18:00:00,2022-04-14 19:00:00,1027,0,785,885,2697,3723
2022-04-14 19:00:00,2022-04-14 20:00:00,1024,0,813,851,2688,3551
2022-04-14 20:00:00,2022-04-14 21:00:00,851,0,894,833,2578,3356
2022-04-14 21:00:00,2022-04-14 22:00:00,778,0,979,922,2679,3180
2022-04-14 22:00:00,2022-04-14 23:00:00,769,0,991,1068,2828,3055
2022-04-14 23:00:00,2022-04-15 00:00:00,464,0,1170,1102,2736,2987
2022-04-15 00:00:00,2022-04-15 01:00:00,563,0,1108,1177,2848,2954
2022-04-15 01:00:00,2022-04-15 02:00:00,677,0,1152,1246,3075,2985
2022-04-15 02:00:00,2022-04-15 03:00:00,721,0,1150,1328,3199,3036
2022-04-15 03:00:00,2022-04-15 04:00:00,639,3,1273,1291,3206,3196
2022-04-15 04:00:00,2022-04-15 05:00:00,657,27,1400,1183,3267,3432
2022-04-15 05:00:00,2022-04-15 06:00:00,572,71,1214,1163,3020,3716
2022-04-15 06:00:00,2022-04-15 07:00:00,603,133,1123,1119,2978,3868
2022-04-15 07:00:00,2022-04-15 08:00:00,493,189,996,969,2647,3961
2022-04-15 08:00:00,2022-04-15 09:00:00,651,240,834,797,2522,4012
2022-04-15 09:00:00,2022-04-15 10:00:00,720,271,746,676,2413,3965
2022-04-15 10:00:00,2022-04-15 11:00:00,672,299,633,573,2177,3914
2022-04-15 11:00:00,2022-04-15 12:00:00,606,316,497,477,1896,3828
2022-04-15 12:00:00,2022-04-15 13:00:00,558,286,376,440,1660,3794
2022-04-15 13:00:00,2022-04-15 14:00:00,541,243,329,429,1542,3857
2022-04-15 14:00:00,2022-04-15 15:00:00,607,180,239,353,1379,3992
2022-04-15 15:00:00,2022-04-15 16:00:00,718,112,161,287,1278,4043
2022-04-15 16:00:00,2022-04-15 17:00:00,771,46,117,253,1187,3945
2022-04-15 17:00:00,2022-04-15 18:00:00,809,5,74,180,1068,3872
2022-04-15 18:00:00,2022-04-15 19:00:00,917,0,129,154,1200,3709
2022-04-15 19:00:00,2022-04-15 20:00:00,768,0,174,124,1066,3628
2022-04-15 20:00:00,2022-04-15 21:00:00,750,0,188,99,1037,3465
2022-04-15 21:00:00,2022-04-15 22:00:00,544,0,122,98,764,3293
2022-04-15 22:00:00,2022-04-15 23:00:00,657,0,139,95,891,3202
2022-04-15 23:00:00,2022-04-16 00:00:00,713,0,103,90,906,3168
2022-04-16 00:00:00,2022-04-16 01:00:00,670,0,94,86,850,3188
2022-04-16 01:00:00,2022-04-16 02:00:00,647,0,108,86,841,3228
2022-04-16 02:00:00,2022-04-16 03:00:00,586,1,68,101,756,3278
2022-04-16 03:00:00,2022-04-16 04:00:00,558,20,71,110,759,3355
2022-04-16 04:00:00,2022-04-16 05:00:00,644,147,111,116,1018,3550
2022-04-16 05:00:00,2022-04-16 06:00:00,592,405,117,91,1205,3719
2022-04-16 06:00:00,2022-04-16 07:00:00,574,708,135,110,1527,3763
2022-04-16 07:00:00,2022-04-16 08:00:00,429,912,211,147,1699,3808
2022-04-16 08:00:00,2022-04-16 09:00:00,364,1029,182,128,1703,3756
2022-04-16 09:00:00,2022-04-16 10:00:00,349,1102,118,139,1708,3693
2022-04-16 10:00:00,2022-04-16 11:00:00,332,1147,70,163,1712,3579
2022-04-16 11:00:00,2022-04-16 12:00:00,328,1245,56,186,1815,3576
2022-04-16 12:00:00,2022-04-16 13:00:00,324,1210,22,200,1756,3550
2022-04-16 13:00:00,2022-04-16 14:00:00,333,1020,11,202,1566,3550
2022-04-16 14:00:00,2022-04-16 15:00:00,345,727,13,198,1283,3753
2022-04-16 15:00:00,2022-04-16 16:00:00,402,376,22,206,1006,3830
2022-04-16 16:00:00,2022-04-16 17:00:00,392,104,57,185,738,3768
2022-04-16 17:00:00,2022-04-16 18:00:00,450,9,58,149,666,3698
2022-04-16 18:00:00,2022-04-16 19:00:00,430,0,54,120,604,3636
2022-04-16 19:00:00,2022-04-16 20:00:00,402,0,20,121,543,3490
2022-04-16 20:00:00,2022-04-16 21:00:00,403,0,41,132,576,3348
2022-04-16 21:00:00,2022-04-16 22:00:00,349,0,114,150,613,3200
2022-04-16 22:00:00,2022-04-16 23:00:00,381,0,166,173,720,3132
2022-04-16 23:00:00,2022-04-17 00:00:00,398,0,147,185,730,3107
2022-04-17 00:00:00,2022-04-17 01:00:00,421,0,99,198,718,3079
2022-04-17 01:00:00,2022-04-17 02:00:00,512,0,127,237,876,3112
2022-04-17 02:00:00,2022-04-17 03:00:00,488,0,182,278,948,3165
2022-04-17 03:00:00,2022-04-17 04:00:00,428,19,154,325,926,3219
2022-04-17 04:00:00,2022-04-17 05:00:00,368,149,104,343,964,3366
2022-04-17 05:00:00,2022-04-17 06:00:00,331,444,114,250,1139,3540
2022-04-17 06:00:00,2022-04-17 07:00:00,329,809,117,144,1399,3602
2022-04-17 07:00:00,2022-04-17 08:00:00,309,1122,126,145,1702,3603
2022-04-17 08:00:00,2022-04-17 09:00:00,339,1297,99,143,1878,3617
2022-04-17 09:00:00,2022-04-17 10:00:00,359,1365,70,121,1915,3573
2022-04-17 10:00:00,2022-04-17 11:00:00,332,1375,64,116,1887,3517
2022-04-17 11:00:00,2022-04-17 12:00:00,292,1344,62,126,1824,3452
2022-04-17 12:00:00,2022-04-17 13:00:00,282,1255,62,119,1718,3423
2022-04-17 13:00:00,2022-04-17 14:00:00,332,1051,60,119,1562,3486
2022-04-17 14:00:00,2022-04-17 15:00:00,428,752,56,108,1344,3648
2022-04-17 15:00:00,2022-04-17 16:00:00,400,392,45,106,943,3700
2022-04-17 16:00:00,2022-04-17 17:00:00,457,109,24,113,703,3627
2022-04-17 17:00:00,2022-04-17 18:00:00,471,10,27,110,618,3574
2022-04-17 18:00:00,2022-04-17 19:00:00,519,1,35,103,658,3541
2022-04-17 19:00:00,2022-04-17 20:00:00,601,0,66,116,783,3405
2022-04-17 20:00:00,2022-04-17 21:00:00,522,0,197,141,860,3276
2022-04-17 21:00:00,2022-04-17 22:00:00,434,0,246,185,865,3127
2022-04-17 22:00:00,2022-04-17 23:00:00,521,0,240,207,968,3094
2022-04-17 23:00:00,2022-04-18 00:00:00,509,0,303,207,1019,3052
2022-04-18 00:00:00,2022-04-18 01:00:00,476,0,281,220,977,3044
2022-04-18 01:00:00,2022-04-18 02:00:00,430,0,296,244,970,3037
2022-04-18 02:00:00,2022-04-18 03:00:00,384,1,314,264,963,3118
2022-04-18 03:00:00,2022-04-18 04:00:00,413,23,296,307,1039,3209
2022-04-18 04:00:00,2022-04-18 05:00:00,388,173,259,338,1158,3392
2022-04-18 05:00:00,2022-04-18 06:00:00,360,488,233,246,1327,3591
2022-04-18 06:00:00,2022-04-18 07:00:00,338,847,245,164,1594,3670
2022-04-18 07:00:00,2022-04-18 08:00:00,317,1130,238,210,1895,3670
2022-04-18 08:00:00,2022-04-18 09:00:00,305,1303,295,200,2103,3616
2022-04-18 09:00:00,2022-04-18 10:00:00,278,1365,342,205,2190,3576
2022-04-18 10:00:00,2022-04-18 11:00:00,272,1370,333,217,2192,3509
2022-04-18 11:00:00,2022-04-18 12:00:00,272,1325,262,202,2061,3466
2022-04-18 12:00:00,2022-04-18 13:00:00,286,1219,215,179,1899,3368
2022-04-18 13:00:00,2022-04-18 14:00:00,318,999,160,156,1633,3406
2022-04-18 14:00:00,2022-04-18 15:00:00,365,718,164,161,1408,3729
2022-04-18 15:00:00,2022-04-18 16:00:00,568,388,153,187,1296,3827
2022-04-18 16:00:00,2022-04-18 17:00:00,672,126,147,196,1141,3721
2022-04-18 17:00:00,2022-04-18 18:00:00,689,16,93,205,1003,3651
2022-04-18 18:00:00,2022-04-18 19:00:00,732,0,31,201,964,3590
2022-04-18 19:00:00,2022-04-18 20:00:00,783,0,27,203,1013,3319
2022-04-18 20:00:00,2022-04-18 21:00:00,688,0,109,207,1004,3188
2022-04-18 21:00:00,2022-04-18 22:00:00,659,0,145,178,982,3050
2022-04-18 22:00:00,2022-04-18 23:00:00,531,0,129,174,834,2969
2022-04-18 23:00:00,2022-04-19 00:00:00,591,0,107,137,835,2945
2022-04-19 00:00:00,2022-04-19 01:00:00,571,0,101,95,767,2964
2022-04-19 01:00:00,2022-04-19 02:00:00,621,0,95,70,786,3046
2022-04-19 02:00:00,2022-04-19 03:00:00,734,1,73,61,869,3287
2022-04-19 03:00:00,2022-04-19 04:00:00,708,27,65,68,868,3850
2022-04-19 04:00:00,2022-04-19 05:00:00,932,171,57,102,1262,4234
2022-04-19 05:00:00,2022-04-19 06:00:00,984,463,46,91,1584,4381
2022-04-19 06:00:00,2022-04-19 07:00:00,946,800,57,91,1894,4366
2022-04-19 07:00:00,2022-04-19 08:00:00,792,1071,81,129,2073,4410
2022-04-19 08:00:00,2022-04-19 09:00:00,775,1251,130,166,2322,4344
2022-04-19 09:00:00,2022-04-19 10:00:00,424,1347,156,188,2115,4243
2022-04-19 10:00:00,2022-04-19 11:00:00,359,1357,156,221,2093,4225
2022-04-19 11:00:00,2022-04-19 12:00:00,350,1315,209,288,2162,4115
2022-04-19 12:00:00,2022-04-19 13:00:00,357,1179,313,362,2211,3975
2022-04-19 13:00:00,2022-04-19 14:00:00,380,1024,516,416,2336,3991
2022-04-19 14:00:00,2022-04-19 15:00:00,575,744,602,468,2389,4253
2022-04-19 15:00:00,2022-04-19 16:00:00,769,396,591,462,2218,4305
2022-04-19 16:00:00,2022-04-19 17:00:00,799,115,570,380,1864,4146
2022-04-19 17:00:00,2022-04-19 18:00:00,770,12,575,371,1728,3982
2022-04-19 18:00:00,2022-04-19 19:00:00,785,1,488,388,1662,3876
2022-04-19 19:00:00,2022-04-19 20:00:00,746,0,384,404,1534,3676
2022-04-19 20:00:00,2022-04-19 21:00:00,714,0,336,329,1379,3403
2022-04-19 21:00:00,2022-04-19 22:00:00,622,0,314,211,1147,3225
2022-04-19 22:00:00,2022-04-19 23:00:00,403,0,217,191,811,3122
2022-04-19 23:00:00,2022-04-20 00:00:00,361,0,158,192,711,3076
2022-04-20 00:00:00,2022-04-20 01:00:00,314,0,159,186,659,3070
2022-04-20 01:00:00,2022-04-20 02:00:00,320,0,232,210,762,3111
2022-04-20 02:00:00,2022-04-20 03:00:00,513,1,268,223,1005,3343
2022-04-20 03:00:00,2022-04-20 04:00:00,788,28,290,276,1382,3832
2022-04-20 04:00:00,2022-04-20 05:00:00,839,167,300,340,1646,4271
2022-04-20 05:00:00,2022-04-20 06:00:00,819,475,328,272,1894,4414
2022-04-20 06:00:00,2022-04-20 07:00:00,733,822,365,277,2197,4407
2022-04-20 07:00:00,2022-04-20 08:00:00,580,1069,292,325,2266,4376
2022-04-20 08:00:00,2022-04-20 09:00:00,539,1273,236,448,2496,4323
2022-04-20 09:00:00,2022-04-20 10:00:00,401,1353,223,516,2493,4230
2022-04-20 10:00:00,2022-04-20 11:00:00,324,1364,252,528,2468,4206
2022-04-20 11:00:00,2022-04-20 12:00:00,349,1323,283,604,2559,4109
2022-04-20 12:00:00,2022-04-20 13:00:00,314,1184,414,715,2627,3994
2022-04-20 13:00:00,2022-04-20 14:00:00,257,963,522,853,2595,4032
2022-04-20 14:00:00,2022-04-20 15:00:00,305,690,562,914,2471,4273
2022-04-20 15:00:00,2022-04-20 16:00:00,434,372,517,832,2155,4266
2022-04-20 16:00:00,2022-04-20 17:00:00,436,115,495,668,1714,4126
2022-04-20 17:00:00,2022-04-20 18:00:00,455,15,486,568,1524,3913
2022-04-20 18:00:00,2022-04-20 19:00:00,435,1,616,557,1609,3834
2022-04-20 19:00:00,2022-04-20 20:00:00,445,0,608,529,1582,3585
2022-04-20 20:00:00,2022-04-20 21:00:00,430,0,841,529,1800,3309
2022-04-20 21:00:00,2022-04-20 22:00:00,368,0,802,609,1779,3188
2022-04-20 22:00:00,2022-04-20 23:00:00,384,0,594,596,1574,3098
2022-04-20 23:00:00,2022-04-21 00:00:00,382,0,618,596,1596,3049
2022-04-21 00:00:00,2022-04-21 01:00:00,369,0,659,593,1621,3042
2022-04-21 01:00:00,2022-04-21 02:00:00,408,0,563,633,1604,3085
2022-04-21 02:00:00,2022-04-21 03:00:00,420,1,409,779,1609,3276
2022-04-21 03:00:00,2022-04-21 04:00:00,458,33,365,944,1800,3712
2022-04-21 04:00:00,2022-04-21 05:00:00,445,191,344,887,1867,4181
2022-04-21 05:00:00,2022-04-21 06:00:00,411,510,387,815,2123,4239
2022-04-21 06:00:00,2022-04-21 07:00:00,418,874,362,816,2470,4352
2022-04-21 07:00:00,2022-04-21 08:00:00,453,1174,358,842,2827,4367
2022-04-21 08:00:00,2022-04-21 09:00:00,435,1352,513,990,3290,4324
2022-04-21 09:00:00,2022-04-21 10:00:00,395,1418,721,1376,3910,4272
2022-04-21 10:00:00,2022-04-21 11:00:00,318,1427,962,1519,4226,4255
2022-04-21 11:00:00,2022-04-21 12:00:00,388,1392,1063,1548,4391,4172
2022-04-21 12:00:00,2022-04-21 13:00:00,443,1293,1061,1498,4295,4071
2022-04-21 13:00:00,2022-04-21 14:00:00,336,1076,1058,1449,3919,4177
2022-04-21 14:00:00,2022-04-21 15:00:00,449,782,1070,1554,3855,4323
2022-04-21 15:00:00,2022-04-21 16:00:00,450,415,1062,1396,3323,4332
2022-04-21 16:00:00,2022-04-21 17:00:00,460,127,1012,1047,2646,4148
2022-04-21 17:00:00,2022-04-21 18:00:00,461,15,931,890,2297,4017
2022-04-21 18:00:00,2022-04-21 19:00:00,436,1,1062,1038,2537,3953
2022-04-21 19:00:00,2022-04-21 20:00:00,203,0,1361,1194,2758,3854
2022-04-21 20:00:00,2022-04-21 21:00:00,195,0,1349,1179,2723,3592
2022-04-21 21:00:00,2022-04-21 22:00:00,205,0,1369,1238,2812,3435
2022-04-21 22:00:00,2022-04-21 23:00:00,232,0,1269,1143,2644,3266
2022-04-21 23:00:00,2022-04-22 00:00:00,237,0,1163,1093,2493,3195
2022-04-22 00:00:00,2022-04-22 01:00:00,377,0,1127,1074,2578,3144
2022-04-22 01:00:00,2022-04-22 02:00:00,220,0,1135,1163,2518,3211
2022-04-22 02:00:00,2022-04-22 03:00:00,236,1,1200,1211,2648,3520
2022-04-22 03:00:00,2022-04-22 04:00:00,264,32,1365,1201,2862,4040
2022-04-22 04:00:00,2022-04-22 05:00:00,228,191,1690,1213,3322,4549
2022-04-22 05:00:00,2022-04-22 06:00:00,261,531,1687,1454,3933,4780
2022-04-22 06:00:00,2022-04-22 07:00:00,196,891,1516,1635,4238,4652
2022-04-22 07:00:00,2022-04-22 08:00:00,201,1147,1427,1875,4650,4577
2022-04-22 08:00:00,2022-04-22 09:00:00,171,1321,1478,2318,5288,4503
2022-04-22 09:00:00,2022-04-22 10:00:00,65,1403,1421,2387,5276,4439
2022-04-22 10:00:00,2022-04-22 11:00:00,78,1345,1358,2139,4920,4261
2022-04-22 11:00:00,2022-04-22 12:00:00,52,1347,1252,1996,4647,4029
2022-04-22 12:00:00,2022-04-22 13:00:00,46,1277,1156,1871,4350,3853
2022-04-22 13:00:00,2022-04-22 14:00:00,50,1066,1229,1824,4169,3880
2022-04-22 14:00:00,2022-04-22 15:00:00,46,785,1269,1776,3876,4054
2022-04-22 15:00:00,2022-04-22 16:00:00,65,431,1377,1759,3632,4049
2022-04-22 16:00:00,2022-04-22 17:00:00,73,130,1537,1458,3198,3977
2022-04-22 17:00:00,2022-04-22 18:00:00,108,15,1435,1402,2960,3733
2022-04-22 18:00:00,2022-04-22 19:00:00,104,1,1515,1491,3111,3648
2022-04-22 19:00:00,2022-04-22 20:00:00,98,0,1626,1474,3198,3488
2022-04-22 20:00:00,2022-04-22 21:00:00,75,0,1597,1404,3076,3339
2022-04-22 21:00:00,2022-04-22 22:00:00,32,0,1373,1230,2635,3188
2022-04-22 22:00:00,2022-04-22 23:00:00,13,0,1317,971,2301,3055
2022-04-22 23:00:00,2022-04-23 00:00:00,12,0,1224,794,2030,2933
2022-04-23 00:00:00,2022-04-23 01:00:00,12,0,1206,768,1986,2891
2022-04-23 01:00:00,2022-04-23 02:00:00,11,0,1228,772,2011,2915
2022-04-23 02:00:00,2022-04-23 03:00:00,12,1,1182,891,2086,2927
2022-04-23 03:00:00,2022-04-23 04:00:00,35,35,1166,1045,2281,3043
2022-04-23 04:00:00,2022-04-23 05:00:00,47,197,1237,1048,2529,3264
2022-04-23 05:00:00,2022-04-23 06:00:00,50,521,1132,1095,2798,3475
2022-04-23 06:00:00,2022-04-23 07:00:00,53,889,920,1244,3106,3596
2022-04-23 07:00:00,2022-04-23 08:00:00,34,1185,805,1405,3429,3634
2022-04-23 08:00:00,2022-04-23 09:00:00,22,1353,710,1711,3796,3621
2022-04-23 09:00:00,2022-04-23 10:00:00,20,1425,569,1931,3945,3718
2022-04-23 10:00:00,2022-04-23 11:00:00,20,1425,530,2147,4122,3667
2022-04-23 11:00:00,2022-04-23 12:00:00,20,1374,468,2248,4110,3527
2022-04-23 12:00:00,2022-04-23 13:00:00,21,1281,687,2355,4344,3541
2022-04-23 13:00:00,2022-04-23 14:00:00,21,1107,918,2282,4328,3556
2022-04-23 14:00:00,2022-04-23 15:00:00,77,799,1047,2093,4016,3731
2022-04-23 15:00:00,2022-04-23 16:00:00,157,438,973,1868,3436,3755
2022-04-23 16:00:00,2022-04-23 17:00:00,238,139,936,1571,2884,3621
2022-04-23 17:00:00,2022-04-23 18:00:00,346,18,941,1259,2564,3499
2022-04-23 18:00:00,2022-04-23 19:00:00,254,1,1109,1235,2599,3480
2022-04-23 19:00:00,2022-04-23 20:00:00,216,0,1156,1343,2715,3298
2022-04-23 20:00:00,2022-04-23 21:00:00,156,0,1033,1435,2624,3143
2022-04-23 21:00:00,2022-04-23 22:00:00,42,0,983,1491,2516,2987
2022-04-23 22:00:00,2022-04-23 23:00:00,40,0,1138,1479,2657,2868
2022-04-23 23:00:00,2022-04-24 00:00:00,30,0,1127,1538,2695,2813
2022-04-24 00:00:00,2022-04-24 01:00:00,33,0,1144,1621,2798,2805
2022-04-24 01:00:00,2022-04-24 02:00:00,38,0,1100,1622,2760,2794
2022-04-24 02:00:00,2022-04-24 03:00:00,38,1,839,1626,2504,2800
2022-04-24 03:00:00,2022-04-24 04:00:00,38,29,874,1705,2646,2912
2022-04-24 04:00:00,2022-04-24 05:00:00,44,161,1062,1668,2935,3116
2022-04-24 05:00:00,2022-04-24 06:00:00,47,399,1180,1870,3496,3349
2022-04-24 06:00:00,2022-04-24 07:00:00,46,699,1420,1776,3941,3622
2022-04-24 07:00:00,2022-04-24 08:00:00,40,906,1551,1846,4343,3709
2022-04-24 08:00:00,2022-04-24 09:00:00,23,1029,1589,1956,4597,3692
2022-04-24 09:00:00,2022-04-24 10:00:00,20,1110,1477,2088,4695,3811
2022-04-24 10:00:00,2022-04-24 11:00:00,20,1104,1480,2373,4977,3832
2022-04-24 11:00:00,2022-04-24 12:00:00,21,975,1568,2274,4838,3837
2022-04-24 12:00:00,2022-04-24 13:00:00,23,869,1415,2331,4638,3781
2022-04-24 13:00:00,2022-04-24 14:00:00,46,755,1301,1682,3784,4105
2022-04-24 14:00:00,2022-04-24 15:00:00,47,501,1470,1871,3889,4202
2022-04-24 15:00:00,2022-04-24 16:00:00,117,308,1537,2012,3974,4058
2022-04-24 16:00:00,2022-04-24 17:00:00,235,127,1738,1433,3533,4020
2022-04-24 17:00:00,2022-04-24 18:00:00,221,20,1606,1358,3205,3780
2022-04-24 18:00:00,2022-04-24 19:00:00,345,1,1410,1401,3157,3669
2022-04-24 19:00:00,2022-04-24 20:00:00,294,0,1340,1458,3092,3510
2022-04-24 20:00:00,2022-04-24 21:00:00,373,0,1421,1311,3105,3258
2022-04-24 21:00:00,2022-04-24 22:00:00,395,0,1548,1131,3074,3143
2022-04-24 22:00:00,2022-04-24 23:00:00,390,0,1493,960,2843,3077
2022-04-24 23:00:00,2022-04-25 00:00:00,362,0,1271,821,2454,3010
2022-04-25 00:00:00,2022-04-25 01:00:00,303,0,1045,768,2116,3012
2022-04-25 01:00:00,2022-04-25 02:00:00,267,0,800,721,1788,3083
2022-04-25 02:00:00,2022-04-25 03:00:00,371,1,635,689,1696,3302
2022-04-25 03:00:00,2022-04-25 04:00:00,365,41,541,595,1542,3806
2022-04-25 04:00:00,2022-04-25 05:00:00,397,213,538,397,1545,4265
2022-04-25 05:00:00,2022-04-25 06:00:00,411,553,380,323,1667,4426
2022-04-25 06:00:00,2022-04-25 07:00:00,237,895,213,392,1737,4500
2022-04-25 07:00:00,2022-04-25 08:00:00,385,1138,160,468,2151,4468
2022-04-25 08:00:00,2022-04-25 09:00:00,404,1209,178,496,2287,4430
2022-04-25 09:00:00,2022-04-25 10:00:00,407,1266,208,405,2286,4356
2022-04-25 10:00:00,2022-04-25 11:00:00,406,1278,290,306,2280,4334
2022-04-25 11:00:00,2022-04-25 12:00:00,423,1254,312,266,2255,4221
2022-04-25 12:00:00,2022-04-25 13:00:00,416,1172,317,299,2204,4086
2022-04-25 13:00:00,2022-04-25 14:00:00,407,1168,269,316,2160,4288
2022-04-25 14:00:00,2022-04-25 15:00:00,426,742,299,326,1793,4395
2022-04-25 15:00:00,2022-04-25 16:00:00,428,440,253,365,1486,4240
2022-04-25 16:00:00,2022-04-25 17:00:00,428,149,250,345,1172,4184
2022-04-25 17:00:00,2022-04-25 18:00:00,429,21,272,274,996,4076
2022-04-25 18:00:00,2022-04-25 19:00:00,421,1,294,253,969,3992
2022-04-25 19:00:00,2022-04-25 20:00:00,419,0,287,242,948,3768
2022-04-25 20:00:00,2022-04-25 21:00:00,415,0,234,213,862,3528
2022-04-25 21:00:00,2022-04-25 22:00:00,386,0,210,191,787,3327
2022-04-25 22:00:00,2022-04-25 23:00:00,340,0,174,191,705,3211
2022-04-25 23:00:00,2022-04-26 00:00:00,340,0,138,193,671,3169
2022-04-26 00:00:00,2022-04-26 01:00:00,339,0,98,216,653,3173
2022-04-26 01:00:00,2022-04-26 02:00:00,349,0,82,214,645,3255
2022-04-26 02:00:00,2022-04-26 03:00:00,394,2,80,190,666,3435
2022-04-26 03:00:00,2022-04-26 04:00:00,421,34,103,152,710,3924
2022-04-26 04:00:00,2022-04-26 05:00:00,466,150,87,145,848,4395
2022-04-26 05:00:00,2022-04-26 06:00:00,487,360,96,150,1093,4529
2022-04-26 06:00:00,2022-04-26 07:00:00,476,601,79,147,1303,4464
2022-04-26 07:00:00,2022-04-26 08:00:00,459,804,102,135,1500,4473
2022-04-26 08:00:00,2022-04-26 09:00:00,438,916,99,126,1579,4438
2022-04-26 09:00:00,2022-04-26 10:00:00,537,1026,74,125,1762,4372
2022-04-26 10:00:00,2022-04-26 11:00:00,538,1028,87,142,1795,4352
2022-04-26 11:00:00,2022-04-26 12:00:00,473,1064,91,155,1783,4222
2022-04-26 12:00:00,2022-04-26 13:00:00,351,1023,105,186,1665,4125
2022-04-26 13:00:00,2022-04-26 14:00:00,483,838,124,201,1646,4142
2022-04-26 14:00:00,2022-04-26 15:00:00,537,624,121,206,1488,4374
2022-04-26 15:00:00,2022-04-26 16:00:00,604,378,101,201,1284,4296
2022-04-26 16:00:00,2022-04-26 17:00:00,618,126,89,189,1022,4118
2022-04-26 17:00:00,2022-04-26 18:00:00,647,23,140,183,993,3962
2022-04-26 18:00:00,2022-04-26 19:00:00,648,1,156,151,956,3865
2022-04-26 19:00:00,2022-04-26 20:00:00,572,0,155,165,892,3696
2022-04-26 20:00:00,2022-04-26 21:00:00,424,0,159,166,749,3471
2022-04-26 21:00:00,2022-04-26 22:00:00,534,0,227,178,939,3299
2022-04-26 22:00:00,2022-04-26 23:00:00,546,0,241,196,983,3190
2022-04-26 23:00:00,2022-04-27 00:00:00,532,0,200,210,942,3139
2022-04-27 00:00:00,2022-04-27 01:00:00,517,0,160,220,897,3145
2022-04-27 01:00:00,2022-04-27 02:00:00,531,0,130,228,889,3164
2022-04-27 02:00:00,2022-04-27 03:00:00,531,1,169,243,944,3398
2022-04-27 03:00:00,2022-04-27 04:00:00,625,49,255,199,1128,3863
2022-04-27 04:00:00,2022-04-27 05:00:00,639,215,244,143,1241,4293
2022-04-27 05:00:00,2022-04-27 06:00:00,655,517,255,94,1521,4497
2022-04-27 06:00:00,2022-04-27 07:00:00,641,841,203,86,1771,4474
2022-04-27 07:00:00,2022-04-27 08:00:00,623,1117,144,103,1987,4475
2022-04-27 08:00:00,2022-04-27 09:00:00,573,1231,129,117,2050,4419
2022-04-27 09:00:00,2022-04-27 10:00:00,473,1272,104,147,1996,4305
2022-04-27 10:00:00,2022-04-27 11:00:00,460,1264,102,232,2058,4297
2022-04-27 11:00:00,2022-04-27 12:00:00,499,1206,105,333,2143,4228
2022-04-27 12:00:00,2022-04-27 13:00:00,533,1097,134,399,2163,4148
2022-04-27 13:00:00,2022-04-27 14:00:00,550,985,150,463,2148,4134
2022-04-27 14:00:00,2022-04-27 15:00:00,595,730,138,517,1980,4366
2022-04-27 15:00:00,2022-04-27 16:00:00,622,425,157,568,1772,4317
2022-04-27 16:00:00,2022-04-27 17:00:00,595,151,233,502,1481,4180
2022-04-27 17:00:00,2022-04-27 18:00:00,571,28,307,368,1274,4010
2022-04-27 18:00:00,2022-04-27 19:00:00,563,1,363,354,1281,3904
2022-04-27 19:00:00,2022-04-27 20:00:00,577,0,386,347,1310,3676
2022-04-27 20:00:00,2022-04-27 21:00:00,571,0,395,306,1272,3460
2022-04-27 21:00:00,2022-04-27 22:00:00,577,0,379,346,1302,3289
2022-04-27 22:00:00,2022-04-27 23:00:00,583,0,319,417,1319,3164
2022-04-27 23:00:00,2022-04-28 00:00:00,605,0,272,505,1382,3144
2022-04-28 00:00:00,2022-04-28 01:00:00,619,0,296,613,1528,3139
2022-04-28 01:00:00,2022-04-28 02:00:00,605,0,347,678,1630,3225
2022-04-28 02:00:00,2022-04-28 03:00:00,622,2,346,700,1670,3415
2022-04-28 03:00:00,2022-04-28 04:00:00,615,47,373,683,1718,3896
2022-04-28 04:00:00,2022-04-28 05:00:00,641,204,431,542,1818,4339
2022-04-28 05:00:00,2022-04-28 06:00:00,642,499,485,591,2217,4462
2022-04-28 06:00:00,2022-04-28 07:00:00,646,827,466,588,2527,4429
2022-04-28 07:00:00,2022-04-28 08:00:00,568,1154,403,573,2698,4432
2022-04-28 08:00:00,2022-04-28 09:00:00,563,1374,390,543,2870,4366
2022-04-28 09:00:00,2022-04-28 10:00:00,561,1435,368,609,2973,4244
2022-04-28 10:00:00,2022-04-28 11:00:00,496,1425,375,702,2998,4251
2022-04-28 11:00:00,2022-04-28 12:00:00,392,1404,456,866,3118,4163
2022-04-28 12:00:00,2022-04-28 13:00:00,369,1336,571,1077,3353,4087
2022-04-28 13:00:00,2022-04-28 14:00:00,370,1143,588,1111,3212,4103
2022-04-28 14:00:00,2022-04-28 15:00:00,421,836,548,1041,2846,4331
2022-04-28 15:00:00,2022-04-28 16:00:00,514,473,466,999,2452,4285
2022-04-28 16:00:00,2022-04-28 17:00:00,607,158,442,960,2167,4165
2022-04-28 17:00:00,2022-04-28 18:00:00,636,28,507,829,2000,4012
2022-04-28 18:00:00,2022-04-28 19:00:00,626,1,510,810,1947,3896
2022-04-28 19:00:00,2022-04-28 20:00:00,535,0,479,874,1888,3689
2022-04-28 20:00:00,2022-04-28 21:00:00,511,0,546,886,1943,3464
2022-04-28 21:00:00,2022-04-28 22:00:00,493,0,532,823,1848,3297
2022-04-28 22:00:00,2022-04-28 23:00:00,515,0,491,772,1778,3198
2022-04-28 23:00:00,2022-04-29 00:00:00,528,0,435,751,1714,3152
2022-04-29 00:00:00,2022-04-29 01:00:00,525,0,372,717,1614,3112
2022-04-29 01:00:00,2022-04-29 02:00:00,536,0,366,652,1554,3159
2022-04-29 02:00:00,2022-04-29 03:00:00,593,4,356,567,1520,3307
2022-04-29 03:00:00,2022-04-29 04:00:00,648,68,306,495,1517,3802
2022-04-29 04:00:00,2022-04-29 05:00:00,654,237,268,394,1553,4242
2022-04-29 05:00:00,2022-04-29 06:00:00,659,488,198,418,1763,4326
2022-04-29 06:00:00,2022-04-29 07:00:00,655,728,272,463,2118,4468
2022-04-29 07:00:00,2022-04-29 08:00:00,630,934,416,455,2435,4501
2022-04-29 08:00:00,2022-04-29 09:00:00,605,1068,509,459,2641,4439
2022-04-29 09:00:00,2022-04-29 10:00:00,552,1149,564,599,2864,4313
2022-04-29 10:00:00,2022-04-29 11:00:00,530,1149,551,837,3067,4191
2022-04-29 11:00:00,2022-04-29 12:00:00,477,1128,529,1028,3162,4035
2022-04-29 12:00:00,2022-04-29 13:00:00,488,1043,546,1110,3187,3945
2022-04-29 13:00:00,2022-04-29 14:00:00,578,941,481,1095,3095,4006
2022-04-29 14:00:00,2022-04-29 15:00:00,633,709,421,1012,2775,4197
2022-04-29 15:00:00,2022-04-29 16:00:00,638,439,370,881,2328,4180
2022-04-29 16:00:00,2022-04-29 17:00:00,652,166,291,730,1839,3990
2022-04-29 17:00:00,2022-04-29 18:00:00,637,31,322,563,1553,3831
2022-04-29 18:00:00,2022-04-29 19:00:00,648,1,272,511,1432,3748
2022-04-29 19:00:00,2022-04-29 20:00:00,623,0,184,496,1303,3582
2022-04-29 20:00:00,2022-04-29 21:00:00,620,0,176,477,1273,3384
2022-04-29 21:00:00,2022-04-29 22:00:00,598,0,182,456,1236,3184
2022-04-29 22:00:00,2022-04-29 23:00:00,539,0,170,385,1094,3063
2022-04-29 23:00:00,2022-04-30 00:00:00,514,0,194,296,1004,2998
2022-04-30 00:00:00,2022-04-30 01:00:00,498,0,196,236,930,2956
2022-04-30 01:00:00,2022-04-30 02:00:00,496,0,218,207,921,2957
2022-04-30 02:00:00,2022-04-30 03:00:00,512,3,234,189,938,2967
2022-04-30 03:00:00,2022-04-30 04:00:00,569,57,198,175,999,3104
2022-04-30 04:00:00,2022-04-30 05:00:00,610,194,181,129,1114,3354
2022-04-30 05:00:00,2022-04-30 06:00:00,603,452,137,112,1304,3569
2022-04-30 06:00:00,2022-04-30 07:00:00,603,803,114,116,1636,3668
2022-04-30 07:00:00,2022-04-30 08:00:00,532,1077,101,107,1817,3644
2022-04-30 08:00:00,2022-04-30 09:00:00,509,1208,104,126,1947,3617
2022-04-30 09:00:00,2022-04-30 10:00:00,522,1182,121,192,2017,3602
2022-04-30 10:00:00,2022-04-30 11:00:00,503,1124,159,244,2030,3577
2022-04-30 11:00:00,2022-04-30 12:00:00,428,1164,141,284,2017,3534
2022-04-30 12:00:00,2022-04-30 13:00:00,485,1092,96,363,2036,3478
2022-04-30 13:00:00,2022-04-30 14:00:00,509,950,95,424,1978,3574
2022-04-30 14:00:00,2022-04-30 15:00:00,546,724,133,435,1838,3747
2022-04-30 15:00:00,2022-04-30 16:00:00,617,435,160,412,1624,3826
2022-04-30 16:00:00,2022-04-30 17:00:00,652,152,145,344,1293,3712
2022-04-30 17:00:00,2022-04-30 18:00:00,659,33,124,233,1049,3606
2022-04-30 18:00:00,2022-04-30 19:00:00,657,1,107,162,927,3520
2022-04-30 19:00:00,2022-04-30 20:00:00,642,0,91,151,884,3392
2022-04-30 20:00:00,2022-04-30 21:00:00,641,0,79,147,867,3198
2022-04-30 21:00:00,2022-04-30 22:00:00,633,0,67,145,845,3020
2022-04-30 22:00:00,2022-04-30 23:00:00,623,0,96,137,856,2910
2022-04-30 23:00:00,2022-05-01 00:00:00,552,0,147,152,851,2850
2022-05-01 00:00:00,2022-05-01 01:00:00,548,0,136,177,861,2833
2022-05-01 01:00:00,2022-05-01 02:00:00,540,0,109,176,825,2824
2022-05-01 02:00:00,2022-05-01 03:00:00,593,2,188,160,943,2822
2022-05-01 03:00:00,2022-05-01 04:00:00,529,51,182,146,908,2902
2022-05-01 04:00:00,2022-05-01 05:00:00,587,170,160,143,1060,3134
2022-05-01 05:00:00,2022-05-01 06:00:00,501,335,132,129,1097,3390
2022-05-01 06:00:00,2022-05-01 07:00:00,532,536,72,140,1280,3511
2022-05-01 07:00:00,2022-05-01 08:00:00,533,757,40,146,1476,3557
2022-05-01 08:00:00,2022-05-01 09:00:00,445,921,40,160,1566,3599
2022-05-01 09:00:00,2022-05-01 10:00:00,412,970,61,212,1655,3567
2022-05-01 10:00:00,2022-05-01 11:00:00,342,964,74,268,1648,3547
2022-05-01 11:00:00,2022-05-01 12:00:00,307,935,53,311,1606,3540
2022-05-01 12:00:00,2022-05-01 13:00:00,321,961,51,341,1674,3544
2022-05-01 13:00:00,2022-05-01 14:00:00,302,911,54,331,1598,3550
2022-05-01 14:00:00,2022-05-01 15:00:00,526,720,40,306,1592,3847
2022-05-01 15:00:00,2022-05-01 16:00:00,590,416,32,311,1349,3919
2022-05-01 16:00:00,2022-05-01 17:00:00,616,166,33,267,1082,3779
2022-05-01 17:00:00,2022-05-01 18:00:00,642,33,34,218,927,3701
2022-05-01 18:00:00,2022-05-01 19:00:00,649,1,52,208,910,3607
2022-05-01 19:00:00,2022-05-01 20:00:00,640,0,65,230,935,3442
2022-05-01 20:00:00,2022-05-01 21:00:00,621,0,83,243,947,3269
2022-05-01 21:00:00,2022-05-01 22:00:00,586,0,139,233,958,3115
2022-05-01 22:00:00,2022-05-01 23:00:00,555,0,126,213,894,3027
2022-05-01 23:00:00,2022-05-02 00:00:00,540,0,117,236,893,2970
2022-05-02 00:00:00,2022-05-02 01:00:00,541,0,101,273,915,2985
2022-05-02 01:00:00,2022-05-02 02:00:00,546,0,107,318,971,3085
2022-05-02 02:00:00,2022-05-02 03:00:00,560,4,86,392,1042,3279
2022-05-02 03:00:00,2022-05-02 04:00:00,553,65,123,475,1216,3795
2022-05-02 04:00:00,2022-05-02 05:00:00,575,257,164,449,1445,4270
2022-05-02 05:00:00,2022-05-02 06:00:00,588,575,196,581,1940,4440
2022-05-02 06:00:00,2022-05-02 07:00:00,557,919,223,726,2425,4405
2022-05-02 07:00:00,2022-05-02 08:00:00,496,1178,213,812,2699,4371
2022-05-02 08:00:00,2022-05-02 09:00:00,487,1279,268,907,2941,4326
2022-05-02 09:00:00,2022-05-02 10:00:00,499,1270,247,1043,3059,4275
2022-05-02 10:00:00,2022-05-02 11:00:00,546,1255,310,1226,3337,4268
2022-05-02 11:00:00,2022-05-02 12:00:00,541,1088,390,1483,3502,4197
2022-05-02 12:00:00,2022-05-02 13:00:00,517,902,479,1650,3548,4130
2022-05-02 13:00:00,2022-05-02 14:00:00,487,705,684,1641,3517,4099
2022-05-02 14:00:00,2022-05-02 15:00:00,470,480,782,1667,3399,4387
2022-05-02 15:00:00,2022-05-02 16:00:00,425,237,812,1639,3113,4359
2022-05-02 16:00:00,2022-05-02 17:00:00,378,78,856,1574,2886,4170
2022-05-02 17:00:00,2022-05-02 18:00:00,386,16,929,1505,2836,4005
2022-05-02 18:00:00,2022-05-02 19:00:00,375,1,1053,1491,2920,3907
2022-05-02 19:00:00,2022-05-02 20:00:00,331,1,1183,1507,3022,3709
2022-05-02 20:00:00,2022-05-02 21:00:00,261,2,1219,1488,2970,3493
2022-05-02 21:00:00,2022-05-02 22:00:00,249,2,1357,1370,2978,3279
2022-05-02 22:00:00,2022-05-02 23:00:00,350,2,1260,1206,2818,3145
2022-05-02 23:00:00,2022-05-03 00:00:00,358,2,1290,1050,2700,3076
2022-05-03 00:00:00,2022-05-03 01:00:00,345,2,1384,999,2730,3068
2022-05-03 01:00:00,2022-05-03 02:00:00,336,2,1223,958,2519,3129
2022-05-03 02:00:00,2022-05-03 03:00:00,353,5,1092,947,2397,3298
2022-05-03 03:00:00,2022-05-03 04:00:00,366,60,848,969,2243,3812
2022-05-03 04:00:00,2022-05-03 05:00:00,452,235,581,812,2080,4297
2022-05-03 05:00:00,2022-05-03 06:00:00,295,528,449,838,2110,4432
2022-05-03 06:00:00,2022-05-03 07:00:00,350,868,418,691,2327,4398
2022-05-03 07:00:00,2022-05-03 08:00:00,463,1156,337,546,2502,4409
2022-05-03 08:00:00,2022-05-03 09:00:00,430,1302,310,440,2482,4348
2022-05-03 09:00:00,2022-05-03 10:00:00,375,1354,295,388,2412,4294
2022-05-03 10:00:00,2022-05-03 11:00:00,346,1296,284,413,2339,4325
2022-05-03 11:00:00,2022-05-03 12:00:00,309,1254,284,459,2306,4270
2022-05-03 12:00:00,2022-05-03 13:00:00,367,1146,299,507,2319,4129
2022-05-03 13:00:00,2022-05-03 14:00:00,436,986,264,497,2183,4123
2022-05-03 14:00:00,2022-05-03 15:00:00,503,728,230,478,1939,4414
2022-05-03 15:00:00,2022-05-03 16:00:00,518,421,218,469,1626,4397
2022-05-03 16:00:00,2022-05-03 17:00:00,438,168,266,406,1278,4189
2022-05-03 17:00:00,2022-05-03 18:00:00,342,38,287,299,966,4010
2022-05-03 18:00:00,2022-05-03 19:00:00,327,1,213,251,792,3944
2022-05-03 19:00:00,2022-05-03 20:00:00,330,0,163,198,691,3737
2022-05-03 20:00:00,2022-05-03 21:00:00,297,1,157,159,614,3483
2022-05-03 21:00:00,2022-05-03 22:00:00,264,2,200,129,595,3288
2022-05-03 22:00:00,2022-05-03 23:00:00,279,2,227,113,621,3168
2022-05-03 23:00:00,2022-05-04 00:00:00,304,2,192,103,601,3101
2022-05-04 00:00:00,2022-05-04 01:00:00,242,2,140,111,495,3090
2022-05-04 01:00:00,2022-05-04 02:00:00,241,2,125,96,464,3160
2022-05-04 02:00:00,2022-05-04 03:00:00,300,6,106,84,496,3336
2022-05-04 03:00:00,2022-05-04 04:00:00,378,75,81,86,620,3787
2022-05-04 04:00:00,2022-05-04 05:00:00,449,247,75,76,847,4287
2022-05-04 05:00:00,2022-05-04 06:00:00,518,490,79,65,1152,4436
2022-05-04 06:00:00,2022-05-04 07:00:00,494,761,98,76,1429,4391
2022-05-04 07:00:00,2022-05-04 08:00:00,441,951,80,104,1576,4455
2022-05-04 08:00:00,2022-05-04 09:00:00,423,1048,55,141,1667,4420
2022-05-04 09:00:00,2022-05-04 10:00:00,494,1093,24,179,1790,4342
2022-05-04 10:00:00,2022-05-04 11:00:00,493,1101,20,228,1842,4376
2022-05-04 11:00:00,2022-05-04 12:00:00,385,1058,42,326,1811,4273
2022-05-04 12:00:00,2022-05-04 13:00:00,315,1005,56,458,1834,4182
2022-05-04 13:00:00,2022-05-04 14:00:00,389,904,67,537,1897,4181
2022-05-04 14:00:00,2022-05-04 15:00:00,384,703,71,542,1700,4447
2022-05-04 15:00:00,2022-05-04 16:00:00,376,435,71,453,1335,4361
2022-05-04 16:00:00,2022-05-04 17:00:00,362,185,99,381,1027,4121
2022-05-04 17:00:00,2022-05-04 18:00:00,350,45,120,281,796,3986
2022-05-04 18:00:00,2022-05-04 19:00:00,371,2,155,278,806,3897
2022-05-04 19:00:00,2022-05-04 20:00:00,423,0,126,288,837,3715
2022-05-04 20:00:00,2022-05-04 21:00:00,402,2,176,265,845,3475
2022-05-04 21:00:00,2022-05-04 22:00:00,367,2,196,257,822,3295
2022-05-04 22:00:00,2022-05-04 23:00:00,407,2,181,253,843,3165
2022-05-04 23:00:00,2022-05-05 00:00:00,497,2,188,296,983,3109
2022-05-05 00:00:00,2022-05-05 01:00:00,440,2,173,327,942,3090
2022-05-05 01:00:00,2022-05-05 02:00:00,480,2,114,374,970,3152
2022-05-05 02:00:00,2022-05-05 03:00:00,510,6,126,387,1029,3306
2022-05-05 03:00:00,2022-05-05 04:00:00,438,57,180,395,1070,3786
2022-05-05 04:00:00,2022-05-05 05:00:00,441,184,179,373,1177,4274
2022-05-05 05:00:00,2022-05-05 06:00:00,517,345,183,400,1445,4440
2022-05-05 06:00:00,2022-05-05 07:00:00,546,485,208,494,1733,4489
2022-05-05 07:00:00,2022-05-05 08:00:00,566,596,202,552,1916,4532
2022-05-05 08:00:00,2022-05-05 09:00:00,549,650,226,536,1961,4484
2022-05-05 09:00:00,2022-05-05 10:00:00,509,719,247,569,2044,4464
2022-05-05 10:00:00,2022-05-05 11:00:00,538,521,202,685,1946,4127
2022-05-05 11:00:00,2022-05-05 12:00:00,484,552,136,877,2049,3992
2022-05-05 12:00:00,2022-05-05 13:00:00,521,902,152,1130,2705,4297
2022-05-05 13:00:00,2022-05-05 14:00:00,495,783,240,1343,2861,4347
2022-05-05 14:00:00,2022-05-05 15:00:00,500,552,238,1490,2780,4505
2022-05-05 15:00:00,2022-05-05 16:00:00,497,383,313,1493,2686,4424
2022-05-05 16:00:00,2022-05-05 17:00:00,568,163,567,1399,2697,4259
2022-05-05 17:00:00,2022-05-05 18:00:00,488,40,614,1200,2342,4079
2022-05-05 18:00:00,2022-05-05 19:00:00,504,2,589,1053,2148,3983
2022-05-05 19:00:00,2022-05-05 20:00:00,551,2,475,1048,2076,3818
2022-05-05 20:00:00,2022-05-05 21:00:00,515,2,373,970,1860,3565
2022-05-05 21:00:00,2022-05-05 22:00:00,478,2,320,882,1682,3335
2022-05-05 22:00:00,2022-05-05 23:00:00,465,2,344,800,1611,3207
2022-05-05 23:00:00,2022-05-06 00:00:00,442,2,404,725,1573,3124
2022-05-06 00:00:00,2022-05-06 01:00:00,395,2,431,643,1471,3103
2022-05-06 01:00:00,2022-05-06 02:00:00,431,2,387,586,1406,3151
2022-05-06 02:00:00,2022-05-06 03:00:00,507,7,410,549,1473,3289
2022-05-06 03:00:00,2022-05-06 04:00:00,492,54,387,540,1473,3730
2022-05-06 04:00:00,2022-05-06 05:00:00,585,148,376,632,1741,4289
2022-05-06 05:00:00,2022-05-06 06:00:00,612,256,356,771,1995,4522
2022-05-06 06:00:00,2022-05-06 07:00:00,618,357,286,846,2107,4513
2022-05-06 07:00:00,2022-05-06 08:00:00,637,464,279,778,2158,4572
2022-05-06 08:00:00,2022-05-06 09:00:00,574,689,303,680,2246,4530
2022-05-06 09:00:00,2022-05-06 10:00:00,537,898,295,688,2418,4410
2022-05-06 10:00:00,2022-05-06 11:00:00,516,947,269,800,2532,4272
2022-05-06 11:00:00,2022-05-06 12:00:00,501,818,348,904,2571,4149
2022-05-06 12:00:00,2022-05-06 13:00:00,532,703,321,1005,2561,4045
2022-05-06 13:00:00,2022-05-06 14:00:00,546,678,401,1011,2636,4087
2022-05-06 14:00:00,2022-05-06 15:00:00,608,522,463,1025,2618,4264
2022-05-06 15:00:00,2022-05-06 16:00:00,614,273,490,1033,2410,4269
2022-05-06 16:00:00,2022-05-06 17:00:00,611,125,370,953,2059,4062
2022-05-06 17:00:00,2022-05-06 18:00:00,625,23,430,833,1911,3817
2022-05-06 18:00:00,2022-05-06 19:00:00,629,1,442,853,1925,3743
2022-05-06 19:00:00,2022-05-06 20:00:00,630,0,413,902,1945,3571
2022-05-06 20:00:00,2022-05-06 21:00:00,611,0,622,920,2153,3320
2022-05-06 21:00:00,2022-05-06 22:00:00,537,0,777,951,2265,3169
2022-05-06 22:00:00,2022-05-06 23:00:00,342,2,735,1048,2127,3036
2022-05-06 23:00:00,2022-05-07 00:00:00,374,2,757,1121,2254,2945
2022-05-07 00:00:00,2022-05-07 01:00:00,356,2,808,1030,2196,2884
2022-05-07 01:00:00,2022-05-07 02:00:00,335,2,852,1140,2329,2872
2022-05-07 02:00:00,2022-05-07 03:00:00,357,4,777,1175,2313,2879
2022-05-07 03:00:00,2022-05-07 04:00:00,384,46,771,1141,2342,2980
2022-05-07 04:00:00,2022-05-07 05:00:00,383,146,823,1207,2559,3286
2022-05-07 05:00:00,2022-05-07 06:00:00,384,325,817,1522,3048,3598
2022-05-07 06:00:00,2022-05-07 07:00:00,386,645,695,1840,3566,3706
2022-05-07 07:00:00,2022-05-07 08:00:00,384,951,621,1952,3908,3730
2022-05-07 08:00:00,2022-05-07 09:00:00,360,1190,669,2006,4225,3673
2022-05-07 09:00:00,2022-05-07 10:00:00,354,1335,679,2122,4490,3574
2022-05-07 10:00:00,2022-05-07 11:00:00,229,1375,707,2299,4610,3485
2022-05-07 11:00:00,2022-05-07 12:00:00,227,1350,725,2418,4720,3436
2022-05-07 12:00:00,2022-05-07 13:00:00,301,1285,778,2427,4791,3403
2022-05-07 13:00:00,2022-05-07 14:00:00,386,1092,917,2332,4727,3433
2022-05-07 14:00:00,2022-05-07 15:00:00,365,818,1067,2276,4526,3665
2022-05-07 15:00:00,2022-05-07 16:00:00,353,502,1153,2141,4149,3787
2022-05-07 16:00:00,2022-05-07 17:00:00,371,204,1084,1928,3587,3659
2022-05-07 17:00:00,2022-05-07 18:00:00,375,50,1227,1521,3173,3534
2022-05-07 18:00:00,2022-05-07 19:00:00,385,3,1266,1206,2860,3475
2022-05-07 19:00:00,2022-05-07 20:00:00,386,0,1336,1115,2837,3365
2022-05-07 20:00:00,2022-05-07 21:00:00,385,2,1279,1128,2794,3195
2022-05-07 21:00:00,2022-05-07 22:00:00,386,2,1225,1152,2765,3037
2022-05-07 22:00:00,2022-05-07 23:00:00,359,2,1077,1043,2481,2896
2022-05-07 23:00:00,2022-05-08 00:00:00,358,2,983,1016,2359,2836
2022-05-08 00:00:00,2022-05-08 01:00:00,318,2,939,960,2219,2836
2022-05-08 01:00:00,2022-05-08 02:00:00,278,2,899,887,2066,2839
2022-05-08 02:00:00,2022-05-08 03:00:00,370,10,816,810,2006,2763
2022-05-08 03:00:00,2022-05-08 04:00:00,371,83,724,738,1916,2895
2022-05-08 04:00:00,2022-05-08 05:00:00,367,292,577,574,1810,3105
2022-05-08 05:00:00,2022-05-08 06:00:00,365,642,467,592,2066,3332
2022-05-08 06:00:00,2022-05-08 07:00:00,336,984,326,467,2113,3437
2022-05-08 07:00:00,2022-05-08 08:00:00,277,1250,213,495,2235,3473
2022-05-08 08:00:00,2022-05-08 09:00:00,309,1392,240,606,2547,3470
2022-05-08 09:00:00,2022-05-08 10:00:00,387,1444,211,629,2671,3449
2022-05-08 10:00:00,2022-05-08 11:00:00,421,1449,229,596,2695,3441
2022-05-08 11:00:00,2022-05-08 12:00:00,405,1420,263,517,2605,3393
2022-05-08 12:00:00,2022-05-08 13:00:00,411,1333,335,476,2555,3373
2022-05-08 13:00:00,2022-05-08 14:00:00,394,1148,404,448,2394,3469
2022-05-08 14:00:00,2022-05-08 15:00:00,486,857,413,406,2162,3711
2022-05-08 15:00:00,2022-05-08 16:00:00,577,511,381,420,1889,3791
2022-05-08 16:00:00,2022-05-08 17:00:00,623,194,339,418,1574,3680
2022-05-08 17:00:00,2022-05-08 18:00:00,585,44,307,368,1304,3597
2022-05-08 18:00:00,2022-05-08 19:00:00,626,3,283,382,1294,3570
2022-05-08 19:00:00,2022-05-08 20:00:00,610,0,276,352,1238,3432
2022-05-08 20:00:00,2022-05-08 21:00:00,595,1,229,335,1160,3244
2022-05-08 21:00:00,2022-05-08 22:00:00,576,2,163,311,1052,3100
2022-05-08 22:00:00,2022-05-08 23:00:00,563,2,171,370,1106,2999
2022-05-08 23:00:00,2022-05-09 00:00:00,567,2,246,399,1214,2950
2022-05-09 00:00:00,2022-05-09 01:00:00,518,2,233,485,1238,2941
2022-05-09 01:00:00,2022-05-09 02:00:00,457,2,230,556,1245,3022
2022-05-09 02:00:00,2022-05-09 03:00:00,514,12,273,657,1456,3194
2022-05-09 03:00:00,2022-05-09 04:00:00,587,89,421,700,1797,3681
2022-05-09 04:00:00,2022-05-09 05:00:00,488,285,453,492,1718,4141
2022-05-09 05:00:00,2022-05-09 06:00:00,385,624,401,341,1751,4334
2022-05-09 06:00:00,2022-05-09 07:00:00,385,957,394,473,2209,4334
2022-05-09 07:00:00,2022-05-09 08:00:00,383,1221,357,686,2647,4380
2022-05-09 08:00:00,2022-05-09 09:00:00,359,1378,303,789,2829,4388
2022-05-09 09:00:00,2022-05-09 10:00:00,356,1436,315,820,2927,4251
2022-05-09 10:00:00,2022-05-09 11:00:00,363,1444,367,875,3049,4283
2022-05-09 11:00:00,2022-05-09 12:00:00,364,1397,438,964,3163,4240
2022-05-09 12:00:00,2022-05-09 13:00:00,366,1325,467,1010,3168,4138
2022-05-09 13:00:00,2022-05-09 14:00:00,392,1146,555,1074,3167,4071
2022-05-09 14:00:00,2022-05-09 15:00:00,396,832,594,1191,3013,4250
2022-05-09 15:00:00,2022-05-09 16:00:00,405,470,664,1051,2590,4275
2022-05-09 16:00:00,2022-05-09 17:00:00,408,168,784,913,2273,4122
2022-05-09 17:00:00,2022-05-09 18:00:00,413,41,1045,804,2303,3905
2022-05-09 18:00:00,2022-05-09 19:00:00,412,2,1311,860,2585,3809
2022-05-09 19:00:00,2022-05-09 20:00:00,403,0,1386,1025,2814,3679
2022-05-09 20:00:00,2022-05-09 21:00:00,385,0,1367,1201,2953,3430
2022-05-09 21:00:00,2022-05-09 22:00:00,377,0,1313,1298,2988,3259
2022-05-09 22:00:00,2022-05-09 23:00:00,376,0,1248,1301,2925,3110
2022-05-09 23:00:00,2022-05-10 00:00:00,378,0,1352,1234,2964,3033
2022-05-10 00:00:00,2022-05-10 01:00:00,377,0,1491,1197,3065,2988
2022-05-10 01:00:00,2022-05-10 02:00:00,364,0,1715,1224,3303,3066
2022-05-10 02:00:00,2022-05-10 03:00:00,374,8,1892,1246,3520,3228
2022-05-10 03:00:00,2022-05-10 04:00:00,241,62,1901,1276,3480,3737
2022-05-10 04:00:00,2022-05-10 05:00:00,227,145,1903,1384,3659,4268
2022-05-10 05:00:00,2022-05-10 06:00:00,365,247,1858,1451,3921,4503
2022-05-10 06:00:00,2022-05-10 07:00:00,316,325,1748,1521,3910,4478
2022-05-10 07:00:00,2022-05-10 08:00:00,384,401,1769,1767,4321,4638
2022-05-10 08:00:00,2022-05-10 09:00:00,278,478,1800,1883,4439,4692
2022-05-10 09:00:00,2022-05-10 10:00:00,285,546,1623,2132,4586,4744
2022-05-10 10:00:00,2022-05-10 11:00:00,279,465,1637,2401,4782,4753
2022-05-10 11:00:00,2022-05-10 12:00:00,236,428,1632,2425,4721,4721
2022-05-10 12:00:00,2022-05-10 13:00:00,277,369,1549,2383,4578,4530
2022-05-10 13:00:00,2022-05-10 14:00:00,373,323,1576,2425,4697,4522
2022-05-10 14:00:00,2022-05-10 15:00:00,385,183,1332,2432,4332,4701
2022-05-10 15:00:00,2022-05-10 16:00:00,285,106,1182,2394,3967,4550
2022-05-10 16:00:00,2022-05-10 17:00:00,346,87,1197,2404,4034,4277
2022-05-10 17:00:00,2022-05-10 18:00:00,381,40,1218,2114,3753,4020
2022-05-10 18:00:00,2022-05-10 19:00:00,355,4,1247,1619,3225,3857
2022-05-10 19:00:00,2022-05-10 20:00:00,379,0,1239,1350,2968,3668
2022-05-10 20:00:00,2022-05-10 21:00:00,342,0,1371,1257,2970,3412
2022-05-10 21:00:00,2022-05-10 22:00:00,360,0,1236,1105,2701,3209
2022-05-10 22:00:00,2022-05-10 23:00:00,368,0,1095,1075,2538,3107
2022-05-10 23:00:00,2022-05-11 00:00:00,376,0,953,1117,2446,3050
2022-05-11 00:00:00,2022-05-11 01:00:00,453,0,800,1097,2350,3018
2022-05-11 01:00:00,2022-05-11 02:00:00,548,1,679,1054,2282,3035
2022-05-11 02:00:00,2022-05-11 03:00:00,611,9,805,1016,2441,3178
2022-05-11 03:00:00,2022-05-11 04:00:00,620,71,898,924,2513,3700
2022-05-11 04:00:00,2022-05-11 05:00:00,616,173,963,958,2710,4251
2022-05-11 05:00:00,2022-05-11 06:00:00,594,286,1090,1071,3041,4470
2022-05-11 06:00:00,2022-05-11 07:00:00,396,353,1157,1360,3266,4542
2022-05-11 07:00:00,2022-05-11 08:00:00,338,383,1100,1664,3485,4629
2022-05-11 08:00:00,2022-05-11 09:00:00,217,449,1242,1803,3711,4722
2022-05-11 09:00:00,2022-05-11 10:00:00,199,492,1389,1805,3885,4735
2022-05-11 10:00:00,2022-05-11 11:00:00,206,678,1493,1864,4241,4770
2022-05-11 11:00:00,2022-05-11 12:00:00,208,817,1564,2230,4819,4816
2022-05-11 12:00:00,2022-05-11 13:00:00,209,625,1572,2477,4883,4602
2022-05-11 13:00:00,2022-05-11 14:00:00,216,412,1499,2499,4626,4524
2022-05-11 14:00:00,2022-05-11 15:00:00,237,265,1525,2232,4259,4719
2022-05-11 15:00:00,2022-05-11 16:00:00,420,135,1455,2064,4074,4543
2022-05-11 16:00:00,2022-05-11 17:00:00,575,65,1346,1766,3752,4293
2022-05-11 17:00:00,2022-05-11 18:00:00,575,22,1305,1485,3387,4109
2022-05-11 18:00:00,2022-05-11 19:00:00,603,2,1018,1275,2898,3981
2022-05-11 19:00:00,2022-05-11 20:00:00,588,0,719,1068,2375,3752
2022-05-11 20:00:00,2022-05-11 21:00:00,473,0,625,954,2052,3473
2022-05-11 21:00:00,2022-05-11 22:00:00,394,0,678,922,1994,3257
2022-05-11 22:00:00,2022-05-11 23:00:00,388,0,980,1101,2469,3160
2022-05-11 23:00:00,2022-05-12 00:00:00,230,0,1226,1235,2691,3108
2022-05-12 00:00:00,2022-05-12 01:00:00,267,0,1334,1454,3055,3068
2022-05-12 01:00:00,2022-05-12 02:00:00,184,1,1222,1839,3246,3167
2022-05-12 02:00:00,2022-05-12 03:00:00,178,12,1309,2000,3499,3303
2022-05-12 03:00:00,2022-05-12 04:00:00,139,85,1513,1768,3505,3882
2022-05-12 04:00:00,2022-05-12 05:00:00,255,272,1563,1733,3823,4423
2022-05-12 05:00:00,2022-05-12 06:00:00,232,555,1505,2098,4390,4635
2022-05-12 06:00:00,2022-05-12 07:00:00,143,857,1519,2161,4680,4660
2022-05-12 07:00:00,2022-05-12 08:00:00,159,1116,1526,2237,5038,4743
2022-05-12 08:00:00,2022-05-12 09:00:00,141,1131,1537,2485,5294,4634
2022-05-12 09:00:00,2022-05-12 10:00:00,142,1194,1645,2634,5615,4620
2022-05-12 10:00:00,2022-05-12 11:00:00,145,1208,1693,3022,6068,4720
2022-05-12 11:00:00,2022-05-12 12:00:00,144,1069,1622,2987,5822,4703
2022-05-12 12:00:00,2022-05-12 13:00:00,138,982,1692,3137,5949,4607
2022-05-12 13:00:00,2022-05-12 14:00:00,153,794,1721,2795,5463,4568
2022-05-12 14:00:00,2022-05-12 15:00:00,156,593,1660,2624,5033,4554
2022-05-12 15:00:00,2022-05-12 16:00:00,220,416,1393,2128,4157,4477
2022-05-12 16:00:00,2022-05-12 17:00:00,216,194,1427,1756,3593,4232
2022-05-12 17:00:00,2022-05-12 18:00:00,181,55,1513,1769,3518,3973
2022-05-12 18:00:00,2022-05-12 19:00:00,300,4,1443,1499,3246,3805
2022-05-12 19:00:00,2022-05-12 20:00:00,390,1,1394,1517,3302,3606
2022-05-12 20:00:00,2022-05-12 21:00:00,394,0,1179,1390,2963,3358
2022-05-12 21:00:00,2022-05-12 22:00:00,394,0,1089,1214,2697,3143
2022-05-12 22:00:00,2022-05-12 23:00:00,395,0,953,1158,2506,2950
2022-05-12 23:00:00,2022-05-13 00:00:00,392,0,992,984,2368,2832
2022-05-13 00:00:00,2022-05-13 01:00:00,397,0,1097,864,2358,2837
2022-05-13 01:00:00,2022-05-13 02:00:00,397,1,1083,811,2292,2824
2022-05-13 02:00:00,2022-05-13 03:00:00,397,9,951,814,2171,2838
2022-05-13 03:00:00,2022-05-13 04:00:00,396,65,841,751,2053,2997
2022-05-13 04:00:00,2022-05-13 05:00:00,390,145,845,794,2174,3268
2022-05-13 05:00:00,2022-05-13 06:00:00,376,278,598,1119,2371,3542
2022-05-13 06:00:00,2022-05-13 07:00:00,279,491,787,1282,2839,3713
2022-05-13 07:00:00,2022-05-13 08:00:00,228,710,976,1655,3569,3840
2022-05-13 08:00:00,2022-05-13 09:00:00,209,648,1192,1982,4031,4003
2022-05-13 09:00:00,2022-05-13 10:00:00,160,708,1238,2071,4177,4024
2022-05-13 10:00:00,2022-05-13 11:00:00,182,735,1053,2443,4413,3973
2022-05-13 11:00:00,2022-05-13 12:00:00,302,710,1311,2604,4927,3883
2022-05-13 12:00:00,2022-05-13 13:00:00,193,730,1672,2540,5135,4035
2022-05-13 13:00:00,2022-05-13 14:00:00,162,612,1639,2399,4812,4113
2022-05-13 14:00:00,2022-05-13 15:00:00,172,439,1708,2718,5037,4180
2022-05-13 15:00:00,2022-05-13 16:00:00,171,222,1909,3074,5376,4049
2022-05-13 16:00:00,2022-05-13 17:00:00,162,101,1999,2807,5069,3921
2022-05-13 17:00:00,2022-05-13 18:00:00,184,35,1926,2099,4244,3831
2022-05-13 18:00:00,2022-05-13 19:00:00,181,3,2020,2325,4529,3728
2022-05-13 19:00:00,2022-05-13 20:00:00,208,1,2059,2227,4495,3658
2022-05-13 20:00:00,2022-05-13 21:00:00,178,0,2031,2340,4549,3420
2022-05-13 21:00:00,2022-05-13 22:00:00,135,0,1618,2236,3989,3223
2022-05-13 22:00:00,2022-05-13 23:00:00,133,0,1615,2285,4033,3086
2022-05-13 23:00:00,2022-05-14 00:00:00,133,0,1549,1822,3504,3019
2022-05-14 00:00:00,2022-05-14 01:00:00,139,0,1515,1706,3360,2958
2022-05-14 01:00:00,2022-05-14 02:00:00,134,0,1484,1613,3231,2954
2022-05-14 02:00:00,2022-05-14 03:00:00,133,10,1456,1605,3204,2926
2022-05-14 03:00:00,2022-05-14 04:00:00,132,79,1456,1568,3235,2986
2022-05-14 04:00:00,2022-05-14 05:00:00,159,255,1319,2086,3819,3198
2022-05-14 05:00:00,2022-05-14 06:00:00,232,549,1188,2375,4344,3493
2022-05-14 06:00:00,2022-05-14 07:00:00,256,842,1463,2410,4971,3675
2022-05-14 07:00:00,2022-05-14 08:00:00,243,1047,1426,2612,5328,3781
2022-05-14 08:00:00,2022-05-14 09:00:00,143,1165,1358,2550,5216,3793
2022-05-14 09:00:00,2022-05-14 10:00:00,181,1245,1237,2482,5145,3821
2022-05-14 10:00:00,2022-05-14 11:00:00,137,1297,1540,2401,5375,3846
2022-05-14 11:00:00,2022-05-14 12:00:00,214,1259,1393,2298,5164,3814
2022-05-14 12:00:00,2022-05-14 13:00:00,182,1175,1408,2937,5702,3638
2022-05-14 13:00:00,2022-05-14 14:00:00,185,1067,1459,2898,5609,3645
2022-05-14 14:00:00,2022-05-14 15:00:00,272,881,1350,2768,5271,3761
2022-05-14 15:00:00,2022-05-14 16:00:00,274,553,1321,2502,4650,3799
2022-05-14 16:00:00,2022-05-14 17:00:00,294,227,1163,2078,3762,3558
2022-05-14 17:00:00,2022-05-14 18:00:00,337,59,1073,1393,2862,3384
2022-05-14 18:00:00,2022-05-14 19:00:00,354,6,1024,1059,2443,3289
2022-05-14 19:00:00,2022-05-14 20:00:00,359,1,892,964,2216,3214
2022-05-14 20:00:00,2022-05-14 21:00:00,265,0,820,959,2044,3080
2022-05-14 21:00:00,2022-05-14 22:00:00,361,0,815,953,2129,2905
2022-05-14 22:00:00,2022-05-14 23:00:00,383,0,843,889,2115,2793
2022-05-14 23:00:00,2022-05-15 00:00:00,327,0,812,784,1923,2744
2022-05-15 00:00:00,2022-05-15 01:00:00,322,0,661,659,1642,2698
2022-05-15 01:00:00,2022-05-15 02:00:00,289,0,604,631,1524,2680
2022-05-15 02:00:00,2022-05-15 03:00:00,261,15,614,569,1459,2644
2022-05-15 03:00:00,2022-05-15 04:00:00,245,81,608,512,1446,2739
2022-05-15 04:00:00,2022-05-15 05:00:00,323,238,546,417,1524,2956
2022-05-15 05:00:00,2022-05-15 06:00:00,313,486,466,402,1667,3218
2022-05-15 06:00:00,2022-05-15 07:00:00,323,817,318,367,1825,3431
2022-05-15 07:00:00,2022-05-15 08:00:00,251,1152,226,368,1997,3585
2022-05-15 08:00:00,2022-05-15 09:00:00,228,1266,171,395,2060,3628
2022-05-15 09:00:00,2022-05-15 10:00:00,260,1317,99,396,2072,3586
2022-05-15 10:00:00,2022-05-15 11:00:00,260,1309,56,364,1989,3684
2022-05-15 11:00:00,2022-05-15 12:00:00,216,1322,58,370,1966,3612
2022-05-15 12:00:00,2022-05-15 13:00:00,232,1264,64,354,1914,3594
2022-05-15 13:00:00,2022-05-15 14:00:00,238,1074,47,322,1681,3560
2022-05-15 14:00:00,2022-05-15 15:00:00,282,834,47,273,1436,3820
2022-05-15 15:00:00,2022-05-15 16:00:00,347,528,74,220,1169,3843
2022-05-15 16:00:00,2022-05-15 17:00:00,344,218,102,192,856,3706
2022-05-15 17:00:00,2022-05-15 18:00:00,386,62,129,145,722,3569
2022-05-15 18:00:00,2022-05-15 19:00:00,394,6,143,157,700,3436
2022-05-15 19:00:00,2022-05-15 20:00:00,399,0,170,183,752,3380
2022-05-15 20:00:00,2022-05-15 21:00:00,396,0,165,162,723,3170
2022-05-15 21:00:00,2022-05-15 22:00:00,315,0,202,151,668,3016
2022-05-15 22:00:00,2022-05-15 23:00:00,266,0,185,174,625,2933
2022-05-15 23:00:00,2022-05-16 00:00:00,277,0,153,184,614,2880
2022-05-16 00:00:00,2022-05-16 01:00:00,264,0,167,179,610,2878
2022-05-16 01:00:00,2022-05-16 02:00:00,277,0,124,208,609,2912
2022-05-16 02:00:00,2022-05-16 03:00:00,277,19,136,209,641,3063
2022-05-16 03:00:00,2022-05-16 04:00:00,337,103,99,188,727,3559
2022-05-16 04:00:00,2022-05-16 05:00:00,386,262,136,148,932,4084
2022-05-16 05:00:00,2022-05-16 06:00:00,380,459,203,128,1170,4336
2022-05-16 06:00:00,2022-05-16 07:00:00,228,658,230,166,1282,4408
2022-05-16 07:00:00,2022-05-16 08:00:00,350,750,235,247,1582,4419
2022-05-16 08:00:00,2022-05-16 09:00:00,349,824,336,325,1834,4438
2022-05-16 09:00:00,2022-05-16 10:00:00,340,839,437,519,2135,4408
2022-05-16 10:00:00,2022-05-16 11:00:00,328,815,506,761,2410,4421
2022-05-16 11:00:00,2022-05-16 12:00:00,204,766,565,922,2457,4419
2022-05-16 12:00:00,2022-05-16 13:00:00,155,726,587,632,2100,4349
2022-05-16 13:00:00,2022-05-16 14:00:00,149,638,538,603,1928,4399
2022-05-16 14:00:00,2022-05-16 15:00:00,199,523,712,668,2102,4543
2022-05-16 15:00:00,2022-05-16 16:00:00,218,349,732,648,1947,4432
2022-05-16 16:00:00,2022-05-16 17:00:00,221,168,940,673,2002,4171
2022-05-16 17:00:00,2022-05-16 18:00:00,320,60,890,493,1763,3980
2022-05-16 18:00:00,2022-05-16 19:00:00,345,5,768,701,1819,3721
2022-05-16 19:00:00,2022-05-16 20:00:00,376,0,732,876,1984,3571
2022-05-16 20:00:00,2022-05-16 21:00:00,322,0,920,1009,2251,3258
2022-05-16 21:00:00,2022-05-16 22:00:00,299,0,904,1067,2270,3174
2022-05-16 22:00:00,2022-05-16 23:00:00,318,0,817,1021,2156,3055
2022-05-16 23:00:00,2022-05-17 00:00:00,328,0,788,934,2050,2995
2022-05-17 00:00:00,2022-05-17 01:00:00,241,0,871,959,2071,2976
2022-05-17 01:00:00,2022-05-17 02:00:00,307,1,840,923,2071,3009
2022-05-17 02:00:00,2022-05-17 03:00:00,321,19,720,904,1964,3145
2022-05-17 03:00:00,2022-05-17 04:00:00,318,104,670,757,1849,3575
2022-05-17 04:00:00,2022-05-17 05:00:00,306,258,659,563,1786,4136
2022-05-17 05:00:00,2022-05-17 06:00:00,287,483,699,508,1977,4362
2022-05-17 06:00:00,2022-05-17 07:00:00,286,718,569,614,2187,4425
2022-05-17 07:00:00,2022-05-17 08:00:00,296,1614,539,788,3237,5113
2022-05-17 08:00:00,2022-05-17 09:00:00,286,1175,565,1195,3221,4563
2022-05-17 09:00:00,2022-05-17 10:00:00,277,1293,548,1325,3443,4528
2022-05-17 10:00:00,2022-05-17 11:00:00,275,1283,621,1337,3516,4586
2022-05-17 11:00:00,2022-05-17 12:00:00,258,1244,730,1318,3550,4402
2022-05-17 12:00:00,2022-05-17 13:00:00,264,1263,769,1301,3597,4285
2022-05-17 13:00:00,2022-05-17 14:00:00,300,1131,907,1228,3566,4269
2022-05-17 14:00:00,2022-05-17 15:00:00,387,874,891,1166,3318,4430
2022-05-17 15:00:00,2022-05-17 16:00:00,393,535,858,1137,2923,4351
2022-05-17 16:00:00,2022-05-17 17:00:00,401,233,926,1094,2654,4151
2022-05-17 17:00:00,2022-05-17 18:00:00,395,65,1068,973,2501,3973
2022-05-17 18:00:00,2022-05-17 19:00:00,399,8,1375,1018,2800,3849
2022-05-17 19:00:00,2022-05-17 20:00:00,397,0,1400,1181,2978,3741
2022-05-17 20:00:00,2022-05-17 21:00:00,250,0,1608,1231,3089,3471
2022-05-17 21:00:00,2022-05-17 22:00:00,172,0,1661,1325,3158,3312
2022-05-17 22:00:00,2022-05-17 23:00:00,170,0,1650,1446,3266,3194
2022-05-17 23:00:00,2022-05-18 00:00:00,144,0,1708,1604,3456,3053
2022-05-18 00:00:00,2022-05-18 01:00:00,136,0,1740,1731,3607,3071
2022-05-18 01:00:00,2022-05-18 02:00:00,194,1,1638,1594,3427,3139
2022-05-18 02:00:00,2022-05-18 03:00:00,179,21,1648,1519,3367,3285
2022-05-18 03:00:00,2022-05-18 04:00:00,152,109,1628,1645,3534,3753
2022-05-18 04:00:00,2022-05-18 05:00:00,244,291,1534,1685,3754,4218
2022-05-18 05:00:00,2022-05-18 06:00:00,289,609,1446,1651,3995,4423
2022-05-18 06:00:00,2022-05-18 07:00:00,350,892,1453,1465,4160,4478
2022-05-18 07:00:00,2022-05-18 08:00:00,267,1153,1443,1301,4164,4473
2022-05-18 08:00:00,2022-05-18 09:00:00,259,1278,1354,1160,4051,4478
2022-05-18 09:00:00,2022-05-18 10:00:00,302,1289,1200,1044,3835,4384
2022-05-18 10:00:00,2022-05-18 11:00:00,254,1176,1186,928,3544,4355
2022-05-18 11:00:00,2022-05-18 12:00:00,202,1050,1097,948,3297,4212
2022-05-18 12:00:00,2022-05-18 13:00:00,18,1060,940,815,2833,4220
2022-05-18 13:00:00,2022-05-18 14:00:00,111,854,824,859,2648,4173
2022-05-18 14:00:00,2022-05-18 15:00:00,275,630,801,717,2423,4402
2022-05-18 15:00:00,2022-05-18 16:00:00,409,373,750,499,2031,4355
2022-05-18 16:00:00,2022-05-18 17:00:00,437,184,762,317,1700,4135
2022-05-18 17:00:00,2022-05-18 18:00:00,498,69,739,260,1566,3936
2022-05-18 18:00:00,2022-05-18 19:00:00,476,7,805,276,1564,3818
2022-05-18 19:00:00,2022-05-18 20:00:00,472,0,833,312,1617,3678
2022-05-18 20:00:00,2022-05-18 21:00:00,473,0,818,331,1622,3423
2022-05-18 21:00:00,2022-05-18 22:00:00,440,0,806,349,1595,3216
2022-05-18 22:00:00,2022-05-18 23:00:00,303,0,868,382,1553,3093
2022-05-18 23:00:00,2022-05-19 00:00:00,410,0,938,270,1618,3043
2022-05-19 00:00:00,2022-05-19 01:00:00,431,0,945,294,1670,3005
2022-05-19 01:00:00,2022-05-19 02:00:00,425,0,956,297,1678,3005
2022-05-19 02:00:00,2022-05-19 03:00:00,379,14,947,224,1564,3138
2022-05-19 03:00:00,2022-05-19 04:00:00,388,82,883,155,1508,3631
2022-05-19 04:00:00,2022-05-19 05:00:00,430,199,664,99,1392,4142
2022-05-19 05:00:00,2022-05-19 06:00:00,388,340,534,71,1333,4365
2022-05-19 06:00:00,2022-05-19 07:00:00,391,461,405,76,1333,4432
2022-05-19 07:00:00,2022-05-19 08:00:00,314,596,396,114,1420,4562
2022-05-19 08:00:00,2022-05-19 09:00:00,339,599,453,146,1537,4635
2022-05-19 09:00:00,2022-05-19 10:00:00,441,591,444,119,1595,4594
2022-05-19 10:00:00,2022-05-19 11:00:00,416,592,292,105,1405,4548
2022-05-19 11:00:00,2022-05-19 12:00:00,409,788,166,98,1461,4521
2022-05-19 12:00:00,2022-05-19 13:00:00,429,819,100,90,1438,4345
2022-05-19 13:00:00,2022-05-19 14:00:00,457,682,138,77,1354,4371
2022-05-19 14:00:00,2022-05-19 15:00:00,495,478,71,137,1181,4499
2022-05-19 15:00:00,2022-05-19 16:00:00,628,223,7,167,1025,4280
2022-05-19 16:00:00,2022-05-19 17:00:00,630,92,5,83,810,4072
2022-05-19 17:00:00,2022-05-19 18:00:00,614,27,149,98,888,3858
2022-05-19 18:00:00,2022-05-19 19:00:00,563,4,145,175,887,3778
2022-05-19 19:00:00,2022-05-19 20:00:00,531,0,216,206,953,3694
2022-05-19 20:00:00,2022-05-19 21:00:00,358,0,278,166,802,3411
2022-05-19 21:00:00,2022-05-19 22:00:00,310,0,413,226,949,3167
2022-05-19 22:00:00,2022-05-19 23:00:00,312,0,613,350,1275,3044
2022-05-19 23:00:00,2022-05-20 00:00:00,306,0,924,605,1835,2981
2022-05-20 00:00:00,2022-05-20 01:00:00,325,0,824,652,1801,2911
2022-05-20 01:00:00,2022-05-20 02:00:00,315,1,905,736,1957,2947
2022-05-20 02:00:00,2022-05-20 03:00:00,316,16,1007,864,2203,3092
2022-05-20 03:00:00,2022-05-20 04:00:00,359,76,757,766,1958,3621
2022-05-20 04:00:00,2022-05-20 05:00:00,377,156,599,670,1802,4048
2022-05-20 05:00:00,2022-05-20 06:00:00,365,269,571,649,1854,4334
2022-05-20 06:00:00,2022-05-20 07:00:00,310,407,655,590,1962,4424
2022-05-20 07:00:00,2022-05-20 08:00:00,293,702,561,611,2167,4524
2022-05-20 08:00:00,2022-05-20 09:00:00,274,1031,465,601,2371,4492
2022-05-20 09:00:00,2022-05-20 10:00:00,269,1202,333,598,2402,4336
2022-05-20 10:00:00,2022-05-20 11:00:00,279,1189,235,558,2261,4258
2022-05-20 11:00:00,2022-05-20 12:00:00,278,942,137,575,1932,4145
2022-05-20 12:00:00,2022-05-20 13:00:00,271,763,82,486,1602,4014
2022-05-20 13:00:00,2022-05-20 14:00:00,279,654,24,301,1258,4021
2022-05-20 14:00:00,2022-05-20 15:00:00,361,436,11,177,985,4198
2022-05-20 15:00:00,2022-05-20 16:00:00,374,236,19,160,789,4120
2022-05-20 16:00:00,2022-05-20 17:00:00,374,107,40,121,642,3896
2022-05-20 17:00:00,2022-05-20 18:00:00,373,32,83,84,572,3710
2022-05-20 18:00:00,2022-05-20 19:00:00,366,3,53,155,577,3597
2022-05-20 19:00:00,2022-05-20 20:00:00,241,0,55,171,467,3500
2022-05-20 20:00:00,2022-05-20 21:00:00,192,0,93,216,501,3373
2022-05-20 21:00:00,2022-05-20 22:00:00,267,0,206,258,731,3102
2022-05-20 22:00:00,2022-05-20 23:00:00,253,0,363,422,1038,2926
2022-05-20 23:00:00,2022-05-21 00:00:00,154,0,1001,533,1688,2895
2022-05-21 00:00:00,2022-05-21 01:00:00,162,0,1555,607,2324,2926
2022-05-21 01:00:00,2022-05-21 02:00:00,141,0,1578,686,2405,2882
2022-05-21 02:00:00,2022-05-21 03:00:00,166,6,1461,786,2419,2828
2022-05-21 03:00:00,2022-05-21 04:00:00,145,54,1261,955,2415,2993
2022-05-21 04:00:00,2022-05-21 05:00:00,181,169,1220,940,2510,3211
2022-05-21 05:00:00,2022-05-21 06:00:00,211,320,1125,995,2651,3521
2022-05-21 06:00:00,2022-05-21 07:00:00,272,488,986,1021,2767,3695
2022-05-21 07:00:00,2022-05-21 08:00:00,309,589,857,985,2740,3762
2022-05-21 08:00:00,2022-05-21 09:00:00,202,704,903,1039,2848,3857
2022-05-21 09:00:00,2022-05-21 10:00:00,151,818,1191,1035,3195,3864
2022-05-21 10:00:00,2022-05-21 11:00:00,192,844,1319,1103,3458,3867
2022-05-21 11:00:00,2022-05-21 12:00:00,281,823,1001,1213,3318,3756
2022-05-21 12:00:00,2022-05-21 13:00:00,264,837,924,1311,3336,3744
2022-05-21 13:00:00,2022-05-21 14:00:00,215,804,1050,1362,3431,3810
2022-05-21 14:00:00,2022-05-21 15:00:00,191,677,916,1321,3105,3916
2022-05-21 15:00:00,2022-05-21 16:00:00,168,447,913,1240,2768,3938
2022-05-21 16:00:00,2022-05-21 17:00:00,141,196,871,1280,2488,3692
2022-05-21 17:00:00,2022-05-21 18:00:00,302,53,706,1107,2168,3477
2022-05-21 18:00:00,2022-05-21 19:00:00,238,4,725,946,1913,3310
2022-05-21 19:00:00,2022-05-21 20:00:00,245,0,602,990,1837,3264
2022-05-21 20:00:00,2022-05-21 21:00:00,205,0,633,958,1796,3106
2022-05-21 21:00:00,2022-05-21 22:00:00,175,0,699,911,1785,2980
2022-05-21 22:00:00,2022-05-21 23:00:00,260,0,529,711,1500,2837
2022-05-21 23:00:00,2022-05-22 00:00:00,263,0,469,624,1356,2730
2022-05-22 00:00:00,2022-05-22 01:00:00,248,0,511,645,1404,2688
2022-05-22 01:00:00,2022-05-22 02:00:00,276,1,533,592,1402,2657
2022-05-22 02:00:00,2022-05-22 03:00:00,274,20,446,512,1252,2633
2022-05-22 03:00:00,2022-05-22 04:00:00,190,86,413,486,1175,2746
2022-05-22 04:00:00,2022-05-22 05:00:00,196,228,321,426,1171,2984
2022-05-22 05:00:00,2022-05-22 06:00:00,273,452,180,447,1352,3287
2022-05-22 06:00:00,2022-05-22 07:00:00,230,730,157,455,1572,3508
2022-05-22 07:00:00,2022-05-22 08:00:00,163,969,137,434,1703,3627
2022-05-22 08:00:00,2022-05-22 09:00:00,157,1091,112,433,1793,3663
2022-05-22 09:00:00,2022-05-22 10:00:00,161,1197,119,451,1928,3710
2022-05-22 10:00:00,2022-05-22 11:00:00,166,1249,123,467,2005,3699
2022-05-22 11:00:00,2022-05-22 12:00:00,168,1261,81,432,1942,3639
2022-05-22 12:00:00,2022-05-22 13:00:00,166,1203,44,374,1787,3621
2022-05-22 13:00:00,2022-05-22 14:00:00,207,1104,32,279,1622,3608
2022-05-22 14:00:00,2022-05-22 15:00:00,335,845,44,229,1453,3828
2022-05-22 15:00:00,2022-05-22 16:00:00,368,536,68,156,1128,3836
2022-05-22 16:00:00,2022-05-22 17:00:00,409,245,117,121,892,3673
2022-05-22 17:00:00,2022-05-22 18:00:00,414,66,112,108,700,3530
2022-05-22 18:00:00,2022-05-22 19:00:00,411,9,116,125,661,3409
2022-05-22 19:00:00,2022-05-22 20:00:00,410,0,156,130,696,3355
2022-05-22 20:00:00,2022-05-22 21:00:00,405,0,175,101,681,3156
2022-05-22 21:00:00,2022-05-22 22:00:00,335,0,153,94,582,3006
2022-05-22 22:00:00,2022-05-22 23:00:00,275,0,206,97,578,2903
2022-05-22 23:00:00,2022-05-23 00:00:00,252,0,324,163,739,2833
2022-05-23 00:00:00,2022-05-23 01:00:00,252,0,350,332,934,2816
2022-05-23 01:00:00,2022-05-23 02:00:00,254,1,374,441,1070,2854
2022-05-23 02:00:00,2022-05-23 03:00:00,294,26,455,540,1315,3014
2022-05-23 03:00:00,2022-05-23 04:00:00,366,126,507,608,1607,3568
2022-05-23 04:00:00,2022-05-23 05:00:00,384,334,555,544,1817,4064
2022-05-23 05:00:00,2022-05-23 06:00:00,387,625,629,602,2243,4316
2022-05-23 06:00:00,2022-05-23 07:00:00,357,935,681,910,2883,4394
2022-05-23 07:00:00,2022-05-23 08:00:00,277,1236,841,1005,3359,4609
2022-05-23 08:00:00,2022-05-23 09:00:00,158,1339,935,1140,3572,4587
2022-05-23 09:00:00,2022-05-23 10:00:00,184,1366,1146,1352,4048,4456
2022-05-23 10:00:00,2022-05-23 11:00:00,198,1418,1177,1595,4388,4460
2022-05-23 11:00:00,2022-05-23 12:00:00,187,1384,1266,1751,4588,4382
2022-05-23 12:00:00,2022-05-23 13:00:00,183,1310,1464,1804,4761,4271
2022-05-23 13:00:00,2022-05-23 14:00:00,176,1128,1221,1716,4241,4267
2022-05-23 14:00:00,2022-05-23 15:00:00,173,888,1319,1855,4235,4504
2022-05-23 15:00:00,2022-05-23 16:00:00,172,532,1386,2083,4173,4427
2022-05-23 16:00:00,2022-05-23 17:00:00,171,227,1436,2058,3892,4211
2022-05-23 17:00:00,2022-05-23 18:00:00,170,69,1411,1855,3505,3987
2022-05-23 18:00:00,2022-05-23 19:00:00,170,9,1375,1880,3434,3810
2022-05-23 19:00:00,2022-05-23 20:00:00,171,0,1388,2021,3580,3755
2022-05-23 20:00:00,2022-05-23 21:00:00,172,0,1403,2234,3809,3534
2022-05-23 21:00:00,2022-05-23 22:00:00,173,0,1387,2157,3717,3338
2022-05-23 22:00:00,2022-05-23 23:00:00,171,0,1408,2091,3670,3232
2022-05-23 23:00:00,2022-05-24 00:00:00,170,0,1427,2286,3883,3167
2022-05-24 00:00:00,2022-05-24 01:00:00,170,0,1715,1993,3878,3183
2022-05-24 01:00:00,2022-05-24 02:00:00,170,1,1784,1883,3838,3193
2022-05-24 02:00:00,2022-05-24 03:00:00,170,5,1725,1935,3835,3339
2022-05-24 03:00:00,2022-05-24 04:00:00,170,20,1549,2247,3986,3750
2022-05-24 04:00:00,2022-05-24 05:00:00,199,46,1922,2466,4633,4261
2022-05-24 05:00:00,2022-05-24 06:00:00,354,119,1677,2107,4257,4489
2022-05-24 06:00:00,2022-05-24 07:00:00,367,250,1572,1885,4074,4515
2022-05-24 07:00:00,2022-05-24 08:00:00,323,376,1120,1669,3488,4625
2022-05-24 08:00:00,2022-05-24 09:00:00,346,547,664,1389,2946,4588
2022-05-24 09:00:00,2022-05-24 10:00:00,364,705,562,1428,3059,4514
2022-05-24 10:00:00,2022-05-24 11:00:00,383,724,540,1366,3013,4598
2022-05-24 11:00:00,2022-05-24 12:00:00,398,614,622,1223,2857,4438
2022-05-24 12:00:00,2022-05-24 13:00:00,402,533,685,1114,2734,4343
2022-05-24 13:00:00,2022-05-24 14:00:00,401,450,654,1071,2576,4256
2022-05-24 14:00:00,2022-05-24 15:00:00,404,432,821,1028,2685,4465
2022-05-24 15:00:00,2022-05-24 16:00:00,403,304,772,1087,2566,4365
2022-05-24 16:00:00,2022-05-24 17:00:00,403,160,624,1107,2294,4179
2022-05-24 17:00:00,2022-05-24 18:00:00,406,58,726,1076,2266,3900
2022-05-24 18:00:00,2022-05-24 19:00:00,398,8,996,1128,2530,3705
2022-05-24 19:00:00,2022-05-24 20:00:00,393,0,1080,1239,2712,3586
2022-05-24 20:00:00,2022-05-24 21:00:00,397,0,1254,1342,2993,3341
2022-05-24 21:00:00,2022-05-24 22:00:00,394,0,1386,1400,3180,3154
2022-05-24 22:00:00,2022-05-24 23:00:00,332,0,1477,1494,3303,3037
2022-05-24 23:00:00,2022-05-25 00:00:00,350,0,1440,1595,3385,2989
2022-05-25 00:00:00,2022-05-25 01:00:00,279,0,1354,1443,3076,2902
2022-05-25 01:00:00,2022-05-25 02:00:00,201,1,1073,1351,2626,2942
2022-05-25 02:00:00,2022-05-25 03:00:00,297,27,889,1265,2478,3108
2022-05-25 03:00:00,2022-05-25 04:00:00,395,112,699,1156,2362,3653
2022-05-25 04:00:00,2022-05-25 05:00:00,401,309,641,1141,2492,4151
2022-05-25 05:00:00,2022-05-25 06:00:00,406,594,672,1336,3008,4370
2022-05-25 06:00:00,2022-05-25 07:00:00,405,816,573,1483,3277,4414
2022-05-25 07:00:00,2022-05-25 08:00:00,318,968,563,1576,3425,4487
2022-05-25 08:00:00,2022-05-25 09:00:00,231,1031,794,1515,3571,4510
2022-05-25 09:00:00,2022-05-25 10:00:00,214,1015,1107,1806,4142,4486
2022-05-25 10:00:00,2022-05-25 11:00:00,204,996,1106,2081,4387,4569
2022-05-25 11:00:00,2022-05-25 12:00:00,220,1006,922,2218,4366,4521
2022-05-25 12:00:00,2022-05-25 13:00:00,224,1028,973,2346,4571,4461
2022-05-25 13:00:00,2022-05-25 14:00:00,394,898,878,2282,4452,4374
2022-05-25 14:00:00,2022-05-25 15:00:00,399,556,1007,2282,4244,4433
2022-05-25 15:00:00,2022-05-25 16:00:00,397,314,1046,2144,3901,4337
2022-05-25 16:00:00,2022-05-25 17:00:00,335,161,1079,2006,3581,4117
2022-05-25 17:00:00,2022-05-25 18:00:00,240,58,1151,1938,3387,3934
2022-05-25 18:00:00,2022-05-25 19:00:00,365,7,1254,1776,3402,3715
2022-05-25 19:00:00,2022-05-25 20:00:00,302,0,1494,1850,3646,3579
2022-05-25 20:00:00,2022-05-25 21:00:00,109,0,1660,2019,3788,3405
2022-05-25 21:00:00,2022-05-25 22:00:00,40,0,1809,2318,4167,3209
2022-05-25 22:00:00,2022-05-25 23:00:00,37,0,1942,2254,4233,3126
2022-05-25 23:00:00,2022-05-26 00:00:00,24,0,1925,1873,3822,3125
2022-05-26 00:00:00,2022-05-26 01:00:00,31,0,1732,1642,3405,3056
2022-05-26 01:00:00,2022-05-26 02:00:00,17,1,1707,1638,3363,3016
2022-05-26 02:00:00,2022-05-26 03:00:00,14,25,1598,1773,3410,3046
2022-05-26 03:00:00,2022-05-26 04:00:00,14,127,1767,1917,3825,3197
2022-05-26 04:00:00,2022-05-26 05:00:00,12,311,1584,2318,4225,3434
2022-05-26 05:00:00,2022-05-26 06:00:00,10,562,1592,2546,4710,3645
2022-05-26 06:00:00,2022-05-26 07:00:00,10,839,1720,3054,5623,3813
2022-05-26 07:00:00,2022-05-26 08:00:00,10,1001,1943,2949,5903,3988
2022-05-26 08:00:00,2022-05-26 09:00:00,10,1038,1682,2730,5460,4021
2022-05-26 09:00:00,2022-05-26 10:00:00,11,1112,1006,3350,5479,3960
2022-05-26 10:00:00,2022-05-26 11:00:00,11,1084,978,3316,5389,3934
2022-05-26 11:00:00,2022-05-26 12:00:00,11,1032,933,3045,5021,3947
2022-05-26 12:00:00,2022-05-26 13:00:00,11,1049,970,3120,5150,3799
2022-05-26 13:00:00,2022-05-26 14:00:00,11,990,1469,2937,5407,3782
2022-05-26 14:00:00,2022-05-26 15:00:00,15,755,1833,3216,5819,3957
2022-05-26 15:00:00,2022-05-26 16:00:00,30,496,1917,2694,5137,3989
2022-05-26 16:00:00,2022-05-26 17:00:00,37,244,1720,2575,4576,3681
2022-05-26 17:00:00,2022-05-26 18:00:00,33,87,1642,1866,3628,3529
2022-05-26 18:00:00,2022-05-26 19:00:00,24,14,1472,1484,2994,3346
2022-05-26 19:00:00,2022-05-26 20:00:00,36,1,1302,1440,2779,3282
2022-05-26 20:00:00,2022-05-26 21:00:00,44,0,1306,1171,2521,3157
2022-05-26 21:00:00,2022-05-26 22:00:00,38,0,1478,1396,2912,2990
2022-05-26 22:00:00,2022-05-26 23:00:00,36,0,1512,1548,3096,2922
2022-05-26 23:00:00,2022-05-27 00:00:00,16,0,1547,1576,3139,2897
2022-05-27 00:00:00,2022-05-27 01:00:00,17,0,1574,1686,3277,2840
2022-05-27 01:00:00,2022-05-27 02:00:00,17,1,1810,1923,3751,2832
2022-05-27 02:00:00,2022-05-27 03:00:00,18,29,1584,1682,3313,2898
2022-05-27 03:00:00,2022-05-27 04:00:00,18,122,1596,1650,3386,3153
2022-05-27 04:00:00,2022-05-27 05:00:00,19,340,1614,2192,4165,3524
2022-05-27 05:00:00,2022-05-27 06:00:00,23,611,1784,2736,5154,3936
2022-05-27 06:00:00,2022-05-27 07:00:00,39,797,2013,2618,5467,4121
2022-05-27 07:00:00,2022-05-27 08:00:00,32,868,1994,2258,5152,4288
2022-05-27 08:00:00,2022-05-27 09:00:00,13,1014,1532,2260,4819,4391
2022-05-27 09:00:00,2022-05-27 10:00:00,11,1012,1464,3020,5507,4138
2022-05-27 10:00:00,2022-05-27 11:00:00,11,1006,834,2605,4456,4107
2022-05-27 11:00:00,2022-05-27 12:00:00,11,1007,766,2629,4413,4071
2022-05-27 12:00:00,2022-05-27 13:00:00,11,1016,782,2780,4589,3978
2022-05-27 13:00:00,2022-05-27 14:00:00,11,918,779,3368,5076,3892
2022-05-27 14:00:00,2022-05-27 15:00:00,10,723,1249,3646,5628,4154
2022-05-27 15:00:00,2022-05-27 16:00:00,15,400,1814,3192,5421,4081
2022-05-27 16:00:00,2022-05-27 17:00:00,19,137,1941,2789,4886,3925
2022-05-27 17:00:00,2022-05-27 18:00:00,16,48,1827,2447,4338,3787
2022-05-27 18:00:00,2022-05-27 19:00:00,14,9,1741,2193,3957,3615
2022-05-27 19:00:00,2022-05-27 20:00:00,17,1,1597,2042,3657,3578
2022-05-27 20:00:00,2022-05-27 21:00:00,18,0,1693,2070,3781,3354
2022-05-27 21:00:00,2022-05-27 22:00:00,15,0,1804,2171,3990,3189
2022-05-27 22:00:00,2022-05-27 23:00:00,14,0,1814,2168,3996,3028
2022-05-27 23:00:00,2022-05-28 00:00:00,13,0,1800,1850,3663,2946
2022-05-28 00:00:00,2022-05-28 01:00:00,16,0,1949,1650,3615,2942
2022-05-28 01:00:00,2022-05-28 02:00:00,14,1,1842,1655,3512,2860
2022-05-28 02:00:00,2022-05-28 03:00:00,14,15,1961,1687,3677,2871
2022-05-28 03:00:00,2022-05-28 04:00:00,14,66,1801,1669,3550,2970
2022-05-28 04:00:00,2022-05-28 05:00:00,14,170,1976,1967,4127,3155
2022-05-28 05:00:00,2022-05-28 06:00:00,15,350,1641,2710,4716,3285
2022-05-28 06:00:00,2022-05-28 07:00:00,20,485,1607,2629,4741,3394
2022-05-28 07:00:00,2022-05-28 08:00:00,20,589,904,2394,3907,3377
2022-05-28 08:00:00,2022-05-28 09:00:00,19,618,885,2293,3815,3353
2022-05-28 09:00:00,2022-05-28 10:00:00,19,616,875,2172,3682,3250
2022-05-28 10:00:00,2022-05-28 11:00:00,20,634,844,1961,3459,3177
2022-05-28 11:00:00,2022-05-28 12:00:00,22,622,800,1767,3211,3156
2022-05-28 12:00:00,2022-05-28 13:00:00,27,593,813,1542,2975,3155
2022-05-28 13:00:00,2022-05-28 14:00:00,23,548,804,1175,2550,3238
2022-05-28 14:00:00,2022-05-28 15:00:00,24,416,1418,1115,2973,3513
2022-05-28 15:00:00,2022-05-28 16:00:00,48,277,1497,1040,2862,3586
2022-05-28 16:00:00,2022-05-28 17:00:00,29,149,1444,787,2409,3517
2022-05-28 17:00:00,2022-05-28 18:00:00,25,60,1355,724,2164,3373
2022-05-28 18:00:00,2022-05-28 19:00:00,43,12,1431,615,2101,3227
2022-05-28 19:00:00,2022-05-28 20:00:00,27,0,1375,434,1836,3237
2022-05-28 20:00:00,2022-05-28 21:00:00,24,0,1339,337,1700,3110
2022-05-28 21:00:00,2022-05-28 22:00:00,43,0,1391,299,1733,2955
2022-05-28 22:00:00,2022-05-28 23:00:00,49,0,1325,334,1708,2774
2022-05-28 23:00:00,2022-05-29 00:00:00,50,0,1191,305,1546,2689
2022-05-29 00:00:00,2022-05-29 01:00:00,49,0,1068,325,1442,2637
2022-05-29 01:00:00,2022-05-29 02:00:00,51,1,973,337,1362,2602
2022-05-29 02:00:00,2022-05-29 03:00:00,51,19,929,334,1333,2579
2022-05-29 03:00:00,2022-05-29 04:00:00,50,67,914,305,1336,2660
2022-05-29 04:00:00,2022-05-29 05:00:00,44,146,868,318,1376,2784
2022-05-29 05:00:00,2022-05-29 06:00:00,43,296,825,348,1512,2954
2022-05-29 06:00:00,2022-05-29 07:00:00,45,494,777,354,1670,3003
2022-05-29 07:00:00,2022-05-29 08:00:00,45,654,764,376,1839,2926
2022-05-29 08:00:00,2022-05-29 09:00:00,18,716,756,501,1991,2857
2022-05-29 09:00:00,2022-05-29 10:00:00,14,714,764,636,2128,2841
2022-05-29 10:00:00,2022-05-29 11:00:00,13,727,816,898,2454,2914
2022-05-29 11:00:00,2022-05-29 12:00:00,33,723,928,1160,2844,2982
2022-05-29 12:00:00,2022-05-29 13:00:00,62,681,971,1394,3108,3025
2022-05-29 13:00:00,2022-05-29 14:00:00,183,574,865,1526,3148,3163
2022-05-29 14:00:00,2022-05-29 15:00:00,339,443,946,1520,3248,3590
2022-05-29 15:00:00,2022-05-29 16:00:00,249,260,824,1280,2613,3744
2022-05-29 16:00:00,2022-05-29 17:00:00,385,116,608,1082,2191,3587
2022-05-29 17:00:00,2022-05-29 18:00:00,401,44,555,910,1910,3479
2022-05-29 18:00:00,2022-05-29 19:00:00,405,10,556,687,1658,3370
2022-05-29 19:00:00,2022-05-29 20:00:00,405,0,549,589,1543,3293
2022-05-29 20:00:00,2022-05-29 21:00:00,404,0,475,535,1414,3089
2022-05-29 21:00:00,2022-05-29 22:00:00,386,0,425,480,1291,2962
2022-05-29 22:00:00,2022-05-29 23:00:00,394,0,333,434,1161,2883
2022-05-29 23:00:00,2022-05-30 00:00:00,397,0,186,372,955,2829
2022-05-30 00:00:00,2022-05-30 01:00:00,395,0,99,321,815,2798
2022-05-30 01:00:00,2022-05-30 02:00:00,415,1,76,256,748,2831
2022-05-30 02:00:00,2022-05-30 03:00:00,483,18,69,206,776,2987
2022-05-30 03:00:00,2022-05-30 04:00:00,498,63,58,150,769,3493
2022-05-30 04:00:00,2022-05-30 05:00:00,500,137,67,109,813,3948
2022-05-30 05:00:00,2022-05-30 06:00:00,456,288,72,101,917,4226
2022-05-30 06:00:00,2022-05-30 07:00:00,405,498,58,110,1071,4397
2022-05-30 07:00:00,2022-05-30 08:00:00,404,538,74,110,1126,4502
2022-05-30 08:00:00,2022-05-30 09:00:00,405,631,37,137,1210,4557
2022-05-30 09:00:00,2022-05-30 10:00:00,463,707,47,155,1372,4445
2022-05-30 10:00:00,2022-05-30 11:00:00,529,697,99,155,1480,4417
2022-05-30 11:00:00,2022-05-30 12:00:00,620,567,111,178,1476,4378
2022-05-30 12:00:00,2022-05-30 13:00:00,643,447,128,190,1408,4285
2022-05-30 13:00:00,2022-05-30 14:00:00,629,408,145,169,1351,4287
2022-05-30 14:00:00,2022-05-30 15:00:00,659,286,132,171,1248,4511
2022-05-30 15:00:00,2022-05-30 16:00:00,666,194,140,170,1170,4400
2022-05-30 16:00:00,2022-05-30 17:00:00,662,127,137,143,1069,4151
2022-05-30 17:00:00,2022-05-30 18:00:00,628,54,117,110,909,3918
2022-05-30 18:00:00,2022-05-30 19:00:00,620,10,99,90,819,3740
2022-05-30 19:00:00,2022-05-30 20:00:00,659,1,77,97,834,3577
2022-05-30 20:00:00,2022-05-30 21:00:00,658,0,63,104,825,3331
2022-05-30 21:00:00,2022-05-30 22:00:00,632,0,55,108,795,3152
2022-05-30 22:00:00,2022-05-30 23:00:00,593,0,63,122,778,3037
2022-05-30 23:00:00,2022-05-31 00:00:00,557,0,66,134,757,2980
2022-05-31 00:00:00,2022-05-31 01:00:00,550,0,37,127,714,2960
2022-05-31 01:00:00,2022-05-31 02:00:00,607,1,33,129,770,2966
2022-05-31 02:00:00,2022-05-31 03:00:00,618,15,44,133,810,3119
2022-05-31 03:00:00,2022-05-31 04:00:00,623,77,47,123,870,3640
2022-05-31 04:00:00,2022-05-31 05:00:00,626,205,54,103,988,4138
2022-05-31 05:00:00,2022-05-31 06:00:00,629,357,63,100,1149,4386
2022-05-31 06:00:00,2022-05-31 07:00:00,626,594,70,89,1379,4605
2022-05-31 07:00:00,2022-05-31 08:00:00,623,706,89,107,1525,4742
2022-05-31 08:00:00,2022-05-31 09:00:00,589,749,82,127,1547,4721
2022-05-31 09:00:00,2022-05-31 10:00:00,591,841,93,154,1679,4717
2022-05-31 10:00:00,2022-05-31 11:00:00,576,951,129,212,1868,4753
2022-05-31 11:00:00,2022-05-31 12:00:00,525,1097,79,276,1977,4824
2022-05-31 12:00:00,2022-05-31 13:00:00,574,1009,46,285,1914,4625
2022-05-31 13:00:00,2022-05-31 14:00:00,564,892,26,253,1735,4528
2022-05-31 14:00:00,2022-05-31 15:00:00,608,742,43,251,1644,4682
2022-05-31 15:00:00,2022-05-31 16:00:00,610,474,71,218,1373,4510
2022-05-31 16:00:00,2022-05-31 17:00:00,638,252,69,192,1151,4203
2022-05-31 17:00:00,2022-05-31 18:00:00,637,112,49,168,966,3925
2022-05-31 18:00:00,2022-05-31 19:00:00,612,25,31,147,815,3712
2022-05-31 19:00:00,2022-05-31 20:00:00,610,1,35,131,777,3620
2022-05-31 20:00:00,2022-05-31 21:00:00,602,0,59,127,788,3417
2022-05-31 21:00:00,2022-05-31 22:00:00,546,0,38,133,717,3168
2022-05-31 22:00:00,2022-05-31 23:00:00,541,0,19,156,716,3036
2022-05-31 23:00:00,2022-06-01 00:00:00,458,0,12,189,659,3020
2022-06-01 00:00:00,2022-06-01 01:00:00,498,0,16,232,746,3012
2022-06-01 01:00:00,2022-06-01 02:00:00,512,2,23,243,780,3013
2022-06-01 02:00:00,2022-06-01 03:00:00,494,43,29,255,821,3165
2022-06-01 03:00:00,2022-06-01 04:00:00,493,161,24,230,908,3661
2022-06-01 04:00:00,2022-06-01 05:00:00,541,375,28,195,1139,4216
2022-06-01 05:00:00,2022-06-01 06:00:00,435,576,20,217,1248,4457
2022-06-01 06:00:00,2022-06-01 07:00:00,471,559,11,195,1236,4274
2022-06-01 07:00:00,2022-06-01 08:00:00,523,866,3,255,1647,4550
2022-06-01 08:00:00,2022-06-01 09:00:00,508,1067,7,336,1918,4837
2022-06-01 09:00:00,2022-06-01 10:00:00,509,1117,24,434,2084,4755
2022-06-01 10:00:00,2022-06-01 11:00:00,476,1077,53,579,2185,4822
2022-06-01 11:00:00,2022-06-01 12:00:00,448,1079,75,751,2353,4844
2022-06-01 12:00:00,2022-06-01 13:00:00,440,956,128,925,2449,4663
2022-06-01 13:00:00,2022-06-01 14:00:00,460,863,229,982,2534,4560
2022-06-01 14:00:00,2022-06-01 15:00:00,508,683,271,965,2427,4634
2022-06-01 15:00:00,2022-06-01 16:00:00,536,490,287,947,2260,4486
2022-06-01 16:00:00,2022-06-01 17:00:00,567,248,292,821,1928,4183
2022-06-01 17:00:00,2022-06-01 18:00:00,595,103,260,665,1623,3967
2022-06-01 18:00:00,2022-06-01 19:00:00,566,21,395,578,1560,3748
2022-06-01 19:00:00,2022-06-01 20:00:00,579,1,496,632,1708,3635
2022-06-01 20:00:00,2022-06-01 21:00:00,585,0,670,739,1994,3423
2022-06-01 21:00:00,2022-06-01 22:00:00,513,0,887,812,2212,3253
2022-06-01 22:00:00,2022-06-01 23:00:00,495,0,952,865,2312,3124
2022-06-01 23:00:00,2022-06-02 00:00:00,482,0,982,914,2378,3054
2022-06-02 00:00:00,2022-06-02 01:00:00,481,0,909,947,2337,3008
2022-06-02 01:00:00,2022-06-02 02:00:00,510,1,1000,1062,2573,3039
2022-06-02 02:00:00,2022-06-02 03:00:00,442,19,1185,1199,2845,3196
2022-06-02 03:00:00,2022-06-02 04:00:00,488,68,1204,1350,3110,3710
2022-06-02 04:00:00,2022-06-02 05:00:00,490,128,1287,1473,3378,4313
2022-06-02 05:00:00,2022-06-02 06:00:00,582,189,1465,1600,3836,4572
2022-06-02 06:00:00,2022-06-02 07:00:00,494,269,1519,1684,3966,4679
2022-06-02 07:00:00,2022-06-02 08:00:00,373,370,1591,1828,4162,4884
2022-06-02 08:00:00,2022-06-02 09:00:00,468,398,1643,2038,4547,4812
2022-06-02 09:00:00,2022-06-02 10:00:00,253,395,1584,2171,4403,4744
2022-06-02 10:00:00,2022-06-02 11:00:00,220,377,1547,2351,4495,4786
2022-06-02 11:00:00,2022-06-02 12:00:00,346,347,1604,2525,4822,4689
2022-06-02 12:00:00,2022-06-02 13:00:00,418,347,1721,2573,5059,4589
2022-06-02 13:00:00,2022-06-02 14:00:00,378,293,1707,2516,4894,4589
2022-06-02 14:00:00,2022-06-02 15:00:00,524,238,1677,2470,4909,4741
2022-06-02 15:00:00,2022-06-02 16:00:00,557,174,1503,2410,4644,4619
2022-06-02 16:00:00,2022-06-02 17:00:00,559,109,1263,2166,4097,4322
2022-06-02 17:00:00,2022-06-02 18:00:00,555,45,1236,1946,3782,4053
2022-06-02 18:00:00,2022-06-02 19:00:00,581,7,1071,1772,3431,3822
2022-06-02 19:00:00,2022-06-02 20:00:00,501,1,1023,1636,3161,3740
2022-06-02 20:00:00,2022-06-02 21:00:00,313,0,935,1605,2853,3498
2022-06-02 21:00:00,2022-06-02 22:00:00,191,0,1006,1560,2757,3282
2022-06-02 22:00:00,2022-06-02 23:00:00,221,0,955,1518,2694,3167
2022-06-02 23:00:00,2022-06-03 00:00:00,233,0,1024,1531,2788,3116
2022-06-03 00:00:00,2022-06-03 01:00:00,231,0,936,1592,2759,3083
2022-06-03 01:00:00,2022-06-03 02:00:00,175,1,852,1573,2601,3081
2022-06-03 02:00:00,2022-06-03 03:00:00,176,12,787,1494,2469,3227
2022-06-03 03:00:00,2022-06-03 04:00:00,191,56,727,1355,2329,3699
2022-06-03 04:00:00,2022-06-03 05:00:00,224,129,659,1341,2353,4259
2022-06-03 05:00:00,2022-06-03 06:00:00,254,259,583,1272,2368,4495
2022-06-03 06:00:00,2022-06-03 07:00:00,254,486,520,1207,2467,4669
2022-06-03 07:00:00,2022-06-03 08:00:00,254,721,443,1182,2600,4874
2022-06-03 08:00:00,2022-06-03 09:00:00,256,934,340,1183,2713,4901
2022-06-03 09:00:00,2022-06-03 10:00:00,254,1022,327,1171,2774,4784
2022-06-03 10:00:00,2022-06-03 11:00:00,251,1147,311,1152,2861,4687
2022-06-03 11:00:00,2022-06-03 12:00:00,233,1173,221,1255,2882,4499
2022-06-03 12:00:00,2022-06-03 13:00:00,185,1118,231,1348,2882,4377
2022-06-03 13:00:00,2022-06-03 14:00:00,229,976,335,1370,2910,4315
2022-06-03 14:00:00,2022-06-03 15:00:00,216,750,388,1299,2653,4364
2022-06-03 15:00:00,2022-06-03 16:00:00,228,490,426,1183,2327,4252
2022-06-03 16:00:00,2022-06-03 17:00:00,252,225,406,1063,1946,3943
2022-06-03 17:00:00,2022-06-03 18:00:00,257,81,364,975,1677,3707
2022-06-03 18:00:00,2022-06-03 19:00:00,247,17,337,889,1490,3547
2022-06-03 19:00:00,2022-06-03 20:00:00,224,1,376,871,1472,3475
2022-06-03 20:00:00,2022-06-03 21:00:00,182,0,384,756,1322,3342
2022-06-03 21:00:00,2022-06-03 22:00:00,236,0,305,627,1168,3011
2022-06-03 22:00:00,2022-06-03 23:00:00,227,0,256,514,997,2952
2022-06-03 23:00:00,2022-06-04 00:00:00,242,0,225,434,901,2772
2022-06-04 00:00:00,2022-06-04 01:00:00,237,0,239,445,921,2780
2022-06-04 01:00:00,2022-06-04 02:00:00,170,2,269,404,845,2777
2022-06-04 02:00:00,2022-06-04 03:00:00,177,32,246,285,740,2770
2022-06-04 03:00:00,2022-06-04 04:00:00,159,119,146,193,617,2921
2022-06-04 04:00:00,2022-06-04 05:00:00,193,278,128,138,737,3259
2022-06-04 05:00:00,2022-06-04 06:00:00,217,500,140,137,994,3608
2022-06-04 06:00:00,2022-06-04 07:00:00,220,753,186,156,1315,3843
2022-06-04 07:00:00,2022-06-04 08:00:00,224,1038,169,141,1572,4031
2022-06-04 08:00:00,2022-06-04 09:00:00,228,1282,119,109,1738,4092
2022-06-04 09:00:00,2022-06-04 10:00:00,218,1467,64,92,1841,4107
2022-06-04 10:00:00,2022-06-04 11:00:00,215,1650,54,88,2007,4169
2022-06-04 11:00:00,2022-06-04 12:00:00,146,1669,38,84,1937,4166
2022-06-04 12:00:00,2022-06-04 13:00:00,163,1615,43,85,1906,3982
2022-06-04 13:00:00,2022-06-04 14:00:00,222,1424,37,91,1774,3916
2022-06-04 14:00:00,2022-06-04 15:00:00,229,1106,38,99,1472,3987
2022-06-04 15:00:00,2022-06-04 16:00:00,225,722,42,125,1114,3867
2022-06-04 16:00:00,2022-06-04 17:00:00,222,342,45,158,767,3639
2022-06-04 17:00:00,2022-06-04 18:00:00,249,114,51,146,560,3382
2022-06-04 18:00:00,2022-06-04 19:00:00,213,25,77,149,464,3241
2022-06-04 19:00:00,2022-06-04 20:00:00,225,1,88,152,466,3262
2022-06-04 20:00:00,2022-06-04 21:00:00,206,0,109,167,482,3127
2022-06-04 21:00:00,2022-06-04 22:00:00,152,0,96,164,412,2968
2022-06-04 22:00:00,2022-06-04 23:00:00,153,0,53,183,389,2848
2022-06-04 23:00:00,2022-06-05 00:00:00,154,0,33,189,376,2756
2022-06-05 00:00:00,2022-06-05 01:00:00,155,0,24,188,367,2749
2022-06-05 01:00:00,2022-06-05 02:00:00,151,2,15,156,324,2700
2022-06-05 02:00:00,2022-06-05 03:00:00,131,40,10,117,298,2646
2022-06-05 03:00:00,2022-06-05 04:00:00,131,146,3,108,388,2791
2022-06-05 04:00:00,2022-06-05 05:00:00,132,393,5,143,673,3073
2022-06-05 05:00:00,2022-06-05 06:00:00,138,740,5,144,1027,3410
2022-06-05 06:00:00,2022-06-05 07:00:00,204,1152,4,144,1504,3665
2022-06-05 07:00:00,2022-06-05 08:00:00,219,1530,27,176,1952,3864
2022-06-05 08:00:00,2022-06-05 09:00:00,184,1686,36,161,2067,3893
2022-06-05 09:00:00,2022-06-05 10:00:00,159,1754,54,150,2117,3918
2022-06-05 10:00:00,2022-06-05 11:00:00,150,1753,99,147,2149,3919
2022-06-05 11:00:00,2022-06-05 12:00:00,149,1713,157,164,2183,3870
2022-06-05 12:00:00,2022-06-05 13:00:00,168,1569,215,205,2157,3726
2022-06-05 13:00:00,2022-06-05 14:00:00,167,1299,275,247,1988,3699
2022-06-05 14:00:00,2022-06-05 15:00:00,169,874,301,268,1612,3752
2022-06-05 15:00:00,2022-06-05 16:00:00,168,519,410,221,1318,3695
2022-06-05 16:00:00,2022-06-05 17:00:00,173,291,477,209,1150,3530
2022-06-05 17:00:00,2022-06-05 18:00:00,243,126,500,249,1118,3332
2022-06-05 18:00:00,2022-06-05 19:00:00,174,28,607,343,1152,3201
2022-06-05 19:00:00,2022-06-05 20:00:00,168,2,716,480,1366,3154
2022-06-05 20:00:00,2022-06-05 21:00:00,165,0,945,525,1635,3011
2022-06-05 21:00:00,2022-06-05 22:00:00,167,0,1065,579,1811,2849
2022-06-05 22:00:00,2022-06-05 23:00:00,168,0,999,645,1812,2751
2022-06-05 23:00:00,2022-06-06 00:00:00,169,0,957,741,1867,2681
2022-06-06 00:00:00,2022-06-06 01:00:00,172,0,1035,861,2068,2644
2022-06-06 01:00:00,2022-06-06 02:00:00,175,1,1069,960,2205,2618
2022-06-06 02:00:00,2022-06-06 03:00:00,167,28,1137,1154,2486,2644
2022-06-06 03:00:00,2022-06-06 04:00:00,160,91,1316,1325,2892,2791
2022-06-06 04:00:00,2022-06-06 05:00:00,149,168,1507,1319,3143,3246
2022-06-06 05:00:00,2022-06-06 06:00:00,127,203,1517,1296,3143,3614
2022-06-06 06:00:00,2022-06-06 07:00:00,98,218,1404,1766,3486,3706
2022-06-06 07:00:00,2022-06-06 08:00:00,113,291,1335,1706,3445,3919
2022-06-06 08:00:00,2022-06-06 09:00:00,115,382,1268,1718,3483,4065
2022-06-06 09:00:00,2022-06-06 10:00:00,118,388,1152,1507,3165,4121
2022-06-06 10:00:00,2022-06-06 11:00:00,119,552,1118,1372,3161,4220
2022-06-06 11:00:00,2022-06-06 12:00:00,118,642,1150,1227,3137,4112
2022-06-06 12:00:00,2022-06-06 13:00:00,125,816,884,1086,2911,4037
2022-06-06 13:00:00,2022-06-06 14:00:00,121,831,731,1052,2735,4050
2022-06-06 14:00:00,2022-06-06 15:00:00,122,799,505,853,2279,4243
2022-06-06 15:00:00,2022-06-06 16:00:00,152,565,434,546,1697,4084
2022-06-06 16:00:00,2022-06-06 17:00:00,217,295,441,307,1260,3768
2022-06-06 17:00:00,2022-06-06 18:00:00,233,108,551,258,1150,3570
2022-06-06 18:00:00,2022-06-06 19:00:00,232,21,611,375,1239,3386
2022-06-06 19:00:00,2022-06-06 20:00:00,199,1,587,569,1356,3290
2022-06-06 20:00:00,2022-06-06 21:00:00,168,0,565,635,1368,3149
2022-06-06 21:00:00,2022-06-06 22:00:00,170,0,574,470,1214,3089
2022-06-06 22:00:00,2022-06-06 23:00:00,167,0,726,429,1322,2895
2022-06-06 23:00:00,2022-06-07 00:00:00,169,0,919,456,1544,2812
2022-06-07 00:00:00,2022-06-07 01:00:00,181,0,1040,451,1672,2829
2022-06-07 01:00:00,2022-06-07 02:00:00,172,1,844,423,1440,2849
2022-06-07 02:00:00,2022-06-07 03:00:00,183,21,693,500,1397,3012
2022-06-07 03:00:00,2022-06-07 04:00:00,244,85,610,607,1546,3466
2022-06-07 04:00:00,2022-06-07 05:00:00,238,216,590,673,1717,4092
2022-06-07 05:00:00,2022-06-07 06:00:00,220,342,679,795,2036,4456
2022-06-07 06:00:00,2022-06-07 07:00:00,177,469,709,916,2271,4653
2022-06-07 07:00:00,2022-06-07 08:00:00,163,536,739,1086,2524,4652
2022-06-07 08:00:00,2022-06-07 09:00:00,163,582,711,1263,2719,4515
2022-06-07 09:00:00,2022-06-07 10:00:00,164,575,564,1496,2799,4422
2022-06-07 10:00:00,2022-06-07 11:00:00,157,515,509,1646,2827,4395
2022-06-07 11:00:00,2022-06-07 12:00:00,152,539,473,1687,2851,4378
2022-06-07 12:00:00,2022-06-07 13:00:00,165,503,648,1724,3040,4264
2022-06-07 13:00:00,2022-06-07 14:00:00,167,424,953,1706,3250,4283
2022-06-07 14:00:00,2022-06-07 15:00:00,168,301,1041,1569,3079,4567
2022-06-07 15:00:00,2022-06-07 16:00:00,222,212,1174,1507,3115,4367
2022-06-07 16:00:00,2022-06-07 17:00:00,229,129,1346,1489,3193,4108
2022-06-07 17:00:00,2022-06-07 18:00:00,228,60,1248,1431,2967,3937
2022-06-07 18:00:00,2022-06-07 19:00:00,252,14,998,1285,2549,3666
2022-06-07 19:00:00,2022-06-07 20:00:00,244,1,901,1166,2312,3519
2022-06-07 20:00:00,2022-06-07 21:00:00,221,0,984,1046,2251,3318
2022-06-07 21:00:00,2022-06-07 22:00:00,283,0,904,1075,2262,3079
2022-06-07 22:00:00,2022-06-07 23:00:00,319,0,1050,1131,2500,2972
2022-06-07 23:00:00,2022-06-08 00:00:00,265,0,1363,1168,2796,2953
2022-06-08 00:00:00,2022-06-08 01:00:00,226,0,1230,1148,2604,2917
2022-06-08 01:00:00,2022-06-08 02:00:00,228,1,1210,1101,2540,2938
2022-06-08 02:00:00,2022-06-08 03:00:00,197,20,1061,963,2241,3090
2022-06-08 03:00:00,2022-06-08 04:00:00,275,65,932,884,2156,3556
2022-06-08 04:00:00,2022-06-08 05:00:00,287,168,699,776,1930,4098
2022-06-08 05:00:00,2022-06-08 06:00:00,294,302,641,709,1946,4365
2022-06-08 06:00:00,2022-06-08 07:00:00,284,392,586,758,2020,4480
2022-06-08 07:00:00,2022-06-08 08:00:00,255,521,503,727,2006,4593
2022-06-08 08:00:00,2022-06-08 09:00:00,213,656,485,641,1995,4605
2022-06-08 09:00:00,2022-06-08 10:00:00,273,805,370,548,1996,4446
2022-06-08 10:00:00,2022-06-08 11:00:00,303,877,370,466,2016,4443
2022-06-08 11:00:00,2022-06-08 12:00:00,312,887,366,423,1988,4396
2022-06-08 12:00:00,2022-06-08 13:00:00,306,825,332,393,1856,4231
2022-06-08 13:00:00,2022-06-08 14:00:00,309,760,330,333,1732,4242
2022-06-08 14:00:00,2022-06-08 15:00:00,291,641,230,262,1424,4411
2022-06-08 15:00:00,2022-06-08 16:00:00,298,426,131,190,1045,4288
2022-06-08 16:00:00,2022-06-08 17:00:00,308,249,137,139,833,4072
2022-06-08 17:00:00,2022-06-08 18:00:00,302,96,166,112,676,3862
2022-06-08 18:00:00,2022-06-08 19:00:00,297,22,194,110,623,3655
2022-06-08 19:00:00,2022-06-08 20:00:00,283,1,191,145,620,3528
2022-06-08 20:00:00,2022-06-08 21:00:00,285,0,189,194,668,3341
2022-06-08 21:00:00,2022-06-08 22:00:00,284,0,223,200,707,3127
2022-06-08 22:00:00,2022-06-08 23:00:00,302,0,208,211,721,2966
2022-06-08 23:00:00,2022-06-09 00:00:00,307,0,173,190,670,2896
2022-06-09 00:00:00,2022-06-09 01:00:00,304,0,164,184,652,2879
2022-06-09 01:00:00,2022-06-09 02:00:00,288,1,153,178,620,2918
2022-06-09 02:00:00,2022-06-09 03:00:00,289,18,147,177,631,3055
2022-06-09 03:00:00,2022-06-09 04:00:00,303,65,187,171,726,3571
2022-06-09 04:00:00,2022-06-09 05:00:00,287,125,171,142,725,4131
2022-06-09 05:00:00,2022-06-09 06:00:00,290,214,153,120,777,4408
2022-06-09 06:00:00,2022-06-09 07:00:00,293,319,156,109,877,4503
2022-06-09 07:00:00,2022-06-09 08:00:00,287,412,162,111,972,4561
2022-06-09 08:00:00,2022-06-09 09:00:00,238,502,156,132,1028,4566
2022-06-09 09:00:00,2022-06-09 10:00:00,233,634,176,170,1213,4510
2022-06-09 10:00:00,2022-06-09 11:00:00,283,806,203,248,1540,4505
2022-06-09 11:00:00,2022-06-09 12:00:00,222,742,221,347,1532,4432
2022-06-09 12:00:00,2022-06-09 13:00:00,210,779,253,392,1634,4350
2022-06-09 13:00:00,2022-06-09 14:00:00,226,737,273,454,1690,4345
2022-06-09 14:00:00,2022-06-09 15:00:00,268,575,190,523,1556,4440
2022-06-09 15:00:00,2022-06-09 16:00:00,264,347,168,611,1390,4288
2022-06-09 16:00:00,2022-06-09 17:00:00,278,189,381,687,1535,4057
2022-06-09 17:00:00,2022-06-09 18:00:00,284,76,552,727,1639,3848
2022-06-09 18:00:00,2022-06-09 19:00:00,284,15,542,700,1541,3647
2022-06-09 19:00:00,2022-06-09 20:00:00,254,1,647,638,1540,3505
2022-06-09 20:00:00,2022-06-09 21:00:00,283,0,739,681,1703,3279
2022-06-09 21:00:00,2022-06-09 22:00:00,273,0,772,749,1794,3087
2022-06-09 22:00:00,2022-06-09 23:00:00,213,0,829,743,1785,2957
2022-06-09 23:00:00,2022-06-10 00:00:00,267,0,857,742,1866,2869
2022-06-10 00:00:00,2022-06-10 01:00:00,291,0,826,725,1842,2843
2022-06-10 01:00:00,2022-06-10 02:00:00,204,1,668,648,1521,2867
2022-06-10 02:00:00,2022-06-10 03:00:00,221,19,735,466,1441,2997
2022-06-10 03:00:00,2022-06-10 04:00:00,306,92,694,347,1439,3496
2022-06-10 04:00:00,2022-06-10 05:00:00,314,250,574,296,1434,4025
2022-06-10 05:00:00,2022-06-10 06:00:00,313,512,495,325,1645,4313
2022-06-10 06:00:00,2022-06-10 07:00:00,279,837,379,473,1968,4440
2022-06-10 07:00:00,2022-06-10 08:00:00,200,1076,423,633,2332,4551
2022-06-10 08:00:00,2022-06-10 09:00:00,172,1131,395,773,2471,4483
2022-06-10 09:00:00,2022-06-10 10:00:00,174,1170,441,948,2733,4382
2022-06-10 10:00:00,2022-06-10 11:00:00,168,1089,580,1040,2877,4274
2022-06-10 11:00:00,2022-06-10 12:00:00,141,1085,725,1228,3179,4294
2022-06-10 12:00:00,2022-06-10 13:00:00,126,1020,796,1318,3260,4166
2022-06-10 13:00:00,2022-06-10 14:00:00,127,758,748,1259,2892,4059
2022-06-10 14:00:00,2022-06-10 15:00:00,209,494,560,1137,2400,4083
2022-06-10 15:00:00,2022-06-10 16:00:00,207,327,490,971,1995,4049
2022-06-10 16:00:00,2022-06-10 17:00:00,214,214,459,858,1745,3834
2022-06-10 17:00:00,2022-06-10 18:00:00,247,106,345,757,1455,3597
2022-06-10 18:00:00,2022-06-10 19:00:00,235,26,307,586,1154,3376
2022-06-10 19:00:00,2022-06-10 20:00:00,225,1,321,572,1119,3296
2022-06-10 20:00:00,2022-06-10 21:00:00,227,0,382,628,1237,3163
2022-06-10 21:00:00,2022-06-10 22:00:00,158,0,461,624,1243,2994
2022-06-10 22:00:00,2022-06-10 23:00:00,43,0,448,580,1071,2831
2022-06-10 23:00:00,2022-06-11 00:00:00,37,0,500,548,1085,2710
2022-06-11 00:00:00,2022-06-11 01:00:00,37,0,504,502,1043,2654
2022-06-11 01:00:00,2022-06-11 02:00:00,29,3,495,467,994,2618
2022-06-11 02:00:00,2022-06-11 03:00:00,35,37,431,414,917,2638
2022-06-11 03:00:00,2022-06-11 04:00:00,37,134,370,408,949,2756
2022-06-11 04:00:00,2022-06-11 05:00:00,37,312,396,404,1149,3034
2022-06-11 05:00:00,2022-06-11 06:00:00,38,598,354,498,1488,3317
2022-06-11 06:00:00,2022-06-11 07:00:00,16,791,351,656,1814,3550
2022-06-11 07:00:00,2022-06-11 08:00:00,8,930,332,800,2070,3710
2022-06-11 08:00:00,2022-06-11 09:00:00,9,1098,410,944,2461,3781
2022-06-11 09:00:00,2022-06-11 10:00:00,8,1140,401,1318,2867,3789
2022-06-11 10:00:00,2022-06-11 11:00:00,8,1131,460,1533,3132,3775
2022-06-11 11:00:00,2022-06-11 12:00:00,9,1342,618,1589,3558,3849
2022-06-11 12:00:00,2022-06-11 13:00:00,9,1295,810,1907,4021,3764
2022-06-11 13:00:00,2022-06-11 14:00:00,9,1194,979,2308,4490,3746
2022-06-11 14:00:00,2022-06-11 15:00:00,8,963,993,2214,4178,3857
2022-06-11 15:00:00,2022-06-11 16:00:00,7,649,1118,2006,3780,3855
2022-06-11 16:00:00,2022-06-11 17:00:00,17,312,1099,1952,3380,3570
2022-06-11 17:00:00,2022-06-11 18:00:00,35,115,1120,1499,2769,3337
2022-06-11 18:00:00,2022-06-11 19:00:00,35,32,971,1057,2095,3121
2022-06-11 19:00:00,2022-06-11 20:00:00,35,3,942,845,1825,3031
2022-06-11 20:00:00,2022-06-11 21:00:00,35,0,827,855,1717,2953
2022-06-11 21:00:00,2022-06-11 22:00:00,35,0,738,956,1729,2818
2022-06-11 22:00:00,2022-06-11 23:00:00,25,0,606,1002,1633,2746
2022-06-11 23:00:00,2022-06-12 00:00:00,24,0,545,973,1542,2725
2022-06-12 00:00:00,2022-06-12 01:00:00,34,1,570,1048,1653,2594
2022-06-12 01:00:00,2022-06-12 02:00:00,35,3,551,1020,1609,2508
2022-06-12 02:00:00,2022-06-12 03:00:00,36,39,561,983,1619,2530
2022-06-12 03:00:00,2022-06-12 04:00:00,36,136,650,988,1810,2651
2022-06-12 04:00:00,2022-06-12 05:00:00,34,330,683,1047,2094,2900
2022-06-12 05:00:00,2022-06-12 06:00:00,13,562,562,1146,2283,3210
2022-06-12 06:00:00,2022-06-12 07:00:00,7,803,600,1359,2769,3412
2022-06-12 07:00:00,2022-06-12 08:00:00,7,976,590,1659,3232,3517
2022-06-12 08:00:00,2022-06-12 09:00:00,7,1081,625,1884,3597,3627
2022-06-12 09:00:00,2022-06-12 10:00:00,7,1089,768,2146,4010,3736
2022-06-12 10:00:00,2022-06-12 11:00:00,7,1120,805,2231,4163,3792
2022-06-12 11:00:00,2022-06-12 12:00:00,8,1117,777,2128,4030,3818
2022-06-12 12:00:00,2022-06-12 13:00:00,8,1062,911,2295,4276,3848
2022-06-12 13:00:00,2022-06-12 14:00:00,7,980,1051,2191,4229,3844
2022-06-12 14:00:00,2022-06-12 15:00:00,7,772,1182,2466,4427,3905
2022-06-12 15:00:00,2022-06-12 16:00:00,7,483,1074,2305,3869,3855
2022-06-12 16:00:00,2022-06-12 17:00:00,25,237,1117,2019,3398,3665
2022-06-12 17:00:00,2022-06-12 18:00:00,34,92,1083,1691,2900,3492
2022-06-12 18:00:00,2022-06-12 19:00:00,34,23,1062,1329,2448,3334
2022-06-12 19:00:00,2022-06-12 20:00:00,33,1,1025,1260,2319,3232
2022-06-12 20:00:00,2022-06-12 21:00:00,35,1,1162,1239,2437,3061
2022-06-12 21:00:00,2022-06-12 22:00:00,34,0,1142,1311,2487,2916
2022-06-12 22:00:00,2022-06-12 23:00:00,33,0,1194,1226,2453,2805
2022-06-12 23:00:00,2022-06-13 00:00:00,36,0,1138,1146,2320,2739
2022-06-13 00:00:00,2022-06-13 01:00:00,64,1,1176,1000,2241,2707
2022-06-13 01:00:00,2022-06-13 02:00:00,124,4,1079,915,2122,2739
2022-06-13 02:00:00,2022-06-13 03:00:00,159,48,1009,833,2049,2932
2022-06-13 03:00:00,2022-06-13 04:00:00,182,160,945,735,2022,3447
2022-06-13 04:00:00,2022-06-13 05:00:00,217,334,884,812,2247,3985
2022-06-13 05:00:00,2022-06-13 06:00:00,253,584,775,1090,2702,4273
2022-06-13 06:00:00,2022-06-13 07:00:00,238,849,665,1280,3032,4457
2022-06-13 07:00:00,2022-06-13 08:00:00,221,994,701,1445,3361,4530
2022-06-13 08:00:00,2022-06-13 09:00:00,160,1166,677,1565,3568,4667
2022-06-13 09:00:00,2022-06-13 10:00:00,153,1221,708,2151,4233,4579
2022-06-13 10:00:00,2022-06-13 11:00:00,147,1222,756,2470,4595,4557
2022-06-13 11:00:00,2022-06-13 12:00:00,139,1144,981,2678,4942,4470
2022-06-13 12:00:00,2022-06-13 13:00:00,125,1100,1197,2885,5307,4396
2022-06-13 13:00:00,2022-06-13 14:00:00,131,968,1570,2955,5624,4306
2022-06-13 14:00:00,2022-06-13 15:00:00,159,774,1447,2998,5378,4483
2022-06-13 15:00:00,2022-06-13 16:00:00,209,538,1596,2868,5211,4323
2022-06-13 16:00:00,2022-06-13 17:00:00,232,256,1651,2738,4877,4097
2022-06-13 17:00:00,2022-06-13 18:00:00,210,101,1736,2551,4598,3872
2022-06-13 18:00:00,2022-06-13 19:00:00,205,22,1823,2354,4404,3663
2022-06-13 19:00:00,2022-06-13 20:00:00,210,1,1796,2232,4239,3514
2022-06-13 20:00:00,2022-06-13 21:00:00,201,0,1830,2157,4188,3336
2022-06-13 21:00:00,2022-06-13 22:00:00,160,0,1915,2100,4175,3144
2022-06-13 22:00:00,2022-06-13 23:00:00,142,0,1894,2050,4086,3056
2022-06-13 23:00:00,2022-06-14 00:00:00,136,0,1798,1948,3882,2975
2022-06-14 00:00:00,2022-06-14 01:00:00,140,0,1713,1911,3764,2919
2022-06-14 01:00:00,2022-06-14 02:00:00,143,4,1718,1807,3672,2930
2022-06-14 02:00:00,2022-06-14 03:00:00,148,33,1706,1659,3546,3082
2022-06-14 03:00:00,2022-06-14 04:00:00,232,106,1572,1588,3498,3562
2022-06-14 04:00:00,2022-06-14 05:00:00,218,226,1444,1655,3543,4071
2022-06-14 05:00:00,2022-06-14 06:00:00,263,398,1356,1696,3713,4329
2022-06-14 06:00:00,2022-06-14 07:00:00,230,592,1227,1774,3823,4362
2022-06-14 07:00:00,2022-06-14 08:00:00,215,744,1061,1740,3760,4415
2022-06-14 08:00:00,2022-06-14 09:00:00,247,876,796,1729,3648,4451
2022-06-14 09:00:00,2022-06-14 10:00:00,241,1006,813,1725,3785,4498
2022-06-14 10:00:00,2022-06-14 11:00:00,239,1043,939,1781,4002,4488
2022-06-14 11:00:00,2022-06-14 12:00:00,226,996,904,1851,3977,4408
2022-06-14 12:00:00,2022-06-14 13:00:00,250,897,952,1791,3890,4306
2022-06-14 13:00:00,2022-06-14 14:00:00,249,821,817,1766,3653,4242
2022-06-14 14:00:00,2022-06-14 15:00:00,226,650,854,1637,3367,4437
2022-06-14 15:00:00,2022-06-14 16:00:00,250,458,1113,1409,3230,4321
2022-06-14 16:00:00,2022-06-14 17:00:00,224,257,1024,1160,2665,4100
2022-06-14 17:00:00,2022-06-14 18:00:00,226,97,870,1001,2194,3871
2022-06-14 18:00:00,2022-06-14 19:00:00,255,27,634,716,1632,3669
2022-06-14 19:00:00,2022-06-14 20:00:00,246,1,570,554,1371,3513
2022-06-14 20:00:00,2022-06-14 21:00:00,235,0,521,474,1230,3330
2022-06-14 21:00:00,2022-06-14 22:00:00,232,0,436,479,1147,3145
2022-06-14 22:00:00,2022-06-14 23:00:00,238,0,472,513,1223,3010
2022-06-14 23:00:00,2022-06-15 00:00:00,229,0,460,530,1219,2926
2022-06-15 00:00:00,2022-06-15 01:00:00,230,0,429,513,1172,2923
2022-06-15 01:00:00,2022-06-15 02:00:00,247,2,433,522,1204,2920
2022-06-15 02:00:00,2022-06-15 03:00:00,208,38,371,492,1109,3076
2022-06-15 03:00:00,2022-06-15 04:00:00,254,130,316,412,1112,3561
2022-06-15 04:00:00,2022-06-15 05:00:00,253,338,218,428,1237,4053
2022-06-15 05:00:00,2022-06-15 06:00:00,253,387,158,328,1126,4039
2022-06-15 06:00:00,2022-06-15 07:00:00,247,526,151,334,1258,4078
2022-06-15 07:00:00,2022-06-15 08:00:00,228,602,151,392,1373,4095
2022-06-15 08:00:00,2022-06-15 09:00:00,210,720,130,412,1472,4029
2022-06-15 09:00:00,2022-06-15 10:00:00,238,815,77,361,1491,3977
2022-06-15 10:00:00,2022-06-15 11:00:00,198,863,70,345,1476,4026
2022-06-15 11:00:00,2022-06-15 12:00:00,206,771,113,452,1542,3895
2022-06-15 12:00:00,2022-06-15 13:00:00,232,723,165,503,1623,3765
2022-06-15 13:00:00,2022-06-15 14:00:00,224,629,175,441,1469,3844
2022-06-15 14:00:00,2022-06-15 15:00:00,239,491,158,439,1327,4040
2022-06-15 15:00:00,2022-06-15 16:00:00,213,355,152,410,1130,3931
2022-06-15 16:00:00,2022-06-15 17:00:00,185,210,112,385,892,3791
2022-06-15 17:00:00,2022-06-15 18:00:00,172,94,102,342,710,3638
2022-06-15 18:00:00,2022-06-15 19:00:00,175,24,111,270,580,3459
2022-06-15 19:00:00,2022-06-15 20:00:00,238,2,205,300,745,3333
2022-06-15 20:00:00,2022-06-15 21:00:00,247,0,231,382,860,3140
2022-06-15 21:00:00,2022-06-15 22:00:00,249,0,213,423,885,2914
2022-06-15 22:00:00,2022-06-15 23:00:00,245,0,210,461,916,2780
2022-06-15 23:00:00,2022-06-16 00:00:00,252,0,240,487,979,2713
2022-06-16 00:00:00,2022-06-16 01:00:00,245,0,251,518,1014,2648
2022-06-16 01:00:00,2022-06-16 02:00:00,228,3,335,528,1094,2603
2022-06-16 02:00:00,2022-06-16 03:00:00,254,31,360,545,1190,2755
2022-06-16 03:00:00,2022-06-16 04:00:00,249,104,453,573,1379,3223
2022-06-16 04:00:00,2022-06-16 05:00:00,251,246,462,741,1700,3620
2022-06-16 05:00:00,2022-06-16 06:00:00,244,460,401,907,2012,3742
2022-06-16 06:00:00,2022-06-16 07:00:00,187,672,353,974,2186,3724
2022-06-16 07:00:00,2022-06-16 08:00:00,146,846,356,1105,2453,3708
2022-06-16 08:00:00,2022-06-16 09:00:00,196,977,315,1282,2770,3652
2022-06-16 09:00:00,2022-06-16 10:00:00,139,1069,325,1335,2868,3611
2022-06-16 10:00:00,2022-06-16 11:00:00,138,1077,367,1254,2836,3660
2022-06-16 11:00:00,2022-06-16 12:00:00,185,1044,505,1159,2893,3691
2022-06-16 12:00:00,2022-06-16 13:00:00,198,1001,491,1072,2762,3544
2022-06-16 13:00:00,2022-06-16 14:00:00,147,874,455,1177,2653,3518
2022-06-16 14:00:00,2022-06-16 15:00:00,180,697,475,1212,2564,3649
2022-06-16 15:00:00,2022-06-16 16:00:00,223,460,501,1270,2454,3607
2022-06-16 16:00:00,2022-06-16 17:00:00,221,210,505,960,1896,3539
2022-06-16 17:00:00,2022-06-16 18:00:00,235,77,612,615,1539,3437
2022-06-16 18:00:00,2022-06-16 19:00:00,266,20,620,631,1537,3296
2022-06-16 19:00:00,2022-06-16 20:00:00,267,1,726,606,1600,3235
2022-06-16 20:00:00,2022-06-16 21:00:00,250,0,736,593,1579,3085
2022-06-16 21:00:00,2022-06-16 22:00:00,247,0,716,569,1532,2917
2022-06-16 22:00:00,2022-06-16 23:00:00,249,0,687,485,1421,2807
2022-06-16 23:00:00,2022-06-17 00:00:00,252,0,656,395,1303,2757
2022-06-17 00:00:00,2022-06-17 01:00:00,251,0,467,374,1092,2699
2022-06-17 01:00:00,2022-06-17 02:00:00,250,3,420,381,1054,2668
2022-06-17 02:00:00,2022-06-17 03:00:00,252,30,505,373,1160,2851
2022-06-17 03:00:00,2022-06-17 04:00:00,245,105,498,278,1126,3358
2022-06-17 04:00:00,2022-06-17 05:00:00,223,289,427,204,1143,3796
2022-06-17 05:00:00,2022-06-17 06:00:00,239,513,405,182,1339,3966
2022-06-17 06:00:00,2022-06-17 07:00:00,224,681,456,226,1587,3985
2022-06-17 07:00:00,2022-06-17 08:00:00,237,747,373,350,1707,4025
2022-06-17 08:00:00,2022-06-17 09:00:00,163,686,387,419,1655,4044
2022-06-17 09:00:00,2022-06-17 10:00:00,162,555,461,440,1618,3969
2022-06-17 10:00:00,2022-06-17 11:00:00,202,474,529,482,1687,3925
2022-06-17 11:00:00,2022-06-17 12:00:00,192,389,662,484,1727,3771
2022-06-17 12:00:00,2022-06-17 13:00:00,248,343,761,490,1842,3697
2022-06-17 13:00:00,2022-06-17 14:00:00,247,315,833,568,1963,3727
2022-06-17 14:00:00,2022-06-17 15:00:00,251,217,886,686,2040,3831
2022-06-17 15:00:00,2022-06-17 16:00:00,247,151,956,830,2184,3655
2022-06-17 16:00:00,2022-06-17 17:00:00,253,88,1005,927,2273,3374
2022-06-17 17:00:00,2022-06-17 18:00:00,238,47,1039,1084,2408,3080
2022-06-17 18:00:00,2022-06-17 19:00:00,264,10,1141,1301,2716,2869
2022-06-17 19:00:00,2022-06-17 20:00:00,259,0,1263,1381,2903,2721
2022-06-17 20:00:00,2022-06-17 21:00:00,109,0,1243,1375,2727,2635
2022-06-17 21:00:00,2022-06-17 22:00:00,37,0,999,1220,2256,2500
2022-06-17 22:00:00,2022-06-17 23:00:00,36,0,1191,1017,2244,2511
2022-06-17 23:00:00,2022-06-18 00:00:00,37,0,1390,835,2262,2478
2022-06-18 00:00:00,2022-06-18 01:00:00,37,0,1412,734,2183,2477
2022-06-18 01:00:00,2022-06-18 02:00:00,36,2,1355,654,2047,2458
2022-06-18 02:00:00,2022-06-18 03:00:00,37,16,1250,581,1884,2517
2022-06-18 03:00:00,2022-06-18 04:00:00,39,64,1296,644,2043,2563
2022-06-18 04:00:00,2022-06-18 05:00:00,40,157,1161,651,2009,2743
2022-06-18 05:00:00,2022-06-18 06:00:00,39,281,928,565,1813,2954
2022-06-18 06:00:00,2022-06-18 07:00:00,41,538,629,622,1830,3094
2022-06-18 07:00:00,2022-06-18 08:00:00,38,782,573,769,2162,3106
2022-06-18 08:00:00,2022-06-18 09:00:00,38,964,412,876,2290,3022
2022-06-18 09:00:00,2022-06-18 10:00:00,40,1003,364,970,2377,3036
2022-06-18 10:00:00,2022-06-18 11:00:00,41,1080,275,970,2366,3056
2022-06-18 11:00:00,2022-06-18 12:00:00,43,1088,355,970,2456,2969
2022-06-18 12:00:00,2022-06-18 13:00:00,41,1037,400,1033,2511,2853
2022-06-18 13:00:00,2022-06-18 14:00:00,28,883,563,1023,2497,2822
2022-06-18 14:00:00,2022-06-18 15:00:00,41,627,691,977,2336,3002
2022-06-18 15:00:00,2022-06-18 16:00:00,50,344,809,894,2097,3141
2022-06-18 16:00:00,2022-06-18 17:00:00,122,175,975,755,2027,3093
2022-06-18 17:00:00,2022-06-18 18:00:00,158,80,927,592,1757,3031
2022-06-18 18:00:00,2022-06-18 19:00:00,178,17,756,461,1412,2926
2022-06-18 19:00:00,2022-06-18 20:00:00,237,1,776,284,1298,2950
2022-06-18 20:00:00,2022-06-18 21:00:00,263,0,842,192,1297,2917
2022-06-18 21:00:00,2022-06-18 22:00:00,230,0,608,213,1051,2698
2022-06-18 22:00:00,2022-06-18 23:00:00,217,0,427,274,918,2533
2022-06-18 23:00:00,2022-06-19 00:00:00,160,0,266,247,673,2491
2022-06-19 00:00:00,2022-06-19 01:00:00,160,0,180,154,494,2485
2022-06-19 01:00:00,2022-06-19 02:00:00,159,0,85,154,398,2455
2022-06-19 02:00:00,2022-06-19 03:00:00,158,6,206,173,543,2486
2022-06-19 03:00:00,2022-06-19 04:00:00,142,22,381,147,692,2621
2022-06-19 04:00:00,2022-06-19 05:00:00,139,66,643,150,998,2847
2022-06-19 05:00:00,2022-06-19 06:00:00,159,151,582,182,1074,3123
2022-06-19 06:00:00,2022-06-19 07:00:00,153,276,650,238,1317,3298
2022-06-19 07:00:00,2022-06-19 08:00:00,187,293,650,250,1380,3395
2022-06-19 08:00:00,2022-06-19 09:00:00,239,337,539,320,1435,3370
2022-06-19 09:00:00,2022-06-19 10:00:00,256,422,389,400,1467,3243
2022-06-19 10:00:00,2022-06-19 11:00:00,155,562,337,435,1489,3285
2022-06-19 11:00:00,2022-06-19 12:00:00,217,515,374,524,1630,3145
2022-06-19 12:00:00,2022-06-19 13:00:00,257,511,310,614,1692,3125
2022-06-19 13:00:00,2022-06-19 14:00:00,250,480,349,622,1701,3108
2022-06-19 14:00:00,2022-06-19 15:00:00,225,448,301,568,1542,3469
2022-06-19 15:00:00,2022-06-19 16:00:00,255,326,291,533,1405,3530
2022-06-19 16:00:00,2022-06-19 17:00:00,227,186,296,413,1122,3454
2022-06-19 17:00:00,2022-06-19 18:00:00,227,83,217,258,785,3382
2022-06-19 18:00:00,2022-06-19 19:00:00,264,25,187,140,616,3222
2022-06-19 19:00:00,2022-06-19 20:00:00,273,1,169,105,548,3194
2022-06-19 20:00:00,2022-06-19 21:00:00,260,0,150,83,493,3042
2022-06-19 21:00:00,2022-06-19 22:00:00,259,0,130,63,452,2932
2022-06-19 22:00:00,2022-06-19 23:00:00,248,0,85,41,374,2842
2022-06-19 23:00:00,2022-06-20 00:00:00,264,0,63,26,353,2784
2022-06-20 00:00:00,2022-06-20 01:00:00,263,0,30,24,317,2766
2022-06-20 01:00:00,2022-06-20 02:00:00,270,2,46,25,343,2793
2022-06-20 02:00:00,2022-06-20 03:00:00,277,28,45,21,371,2966
2022-06-20 03:00:00,2022-06-20 04:00:00,281,91,27,21,420,3493
2022-06-20 04:00:00,2022-06-20 05:00:00,285,179,64,19,547,3988
2022-06-20 05:00:00,2022-06-20 06:00:00,350,313,68,21,752,4210
2022-06-20 06:00:00,2022-06-20 07:00:00,314,496,73,34,917,4320
2022-06-20 07:00:00,2022-06-20 08:00:00,354,565,90,74,1083,4287
2022-06-20 08:00:00,2022-06-20 09:00:00,351,632,172,115,1270,4225
2022-06-20 09:00:00,2022-06-20 10:00:00,341,672,201,181,1395,4233
2022-06-20 10:00:00,2022-06-20 11:00:00,342,615,240,222,1419,4219
2022-06-20 11:00:00,2022-06-20 12:00:00,338,685,256,265,1544,4256
2022-06-20 12:00:00,2022-06-20 13:00:00,337,687,286,262,1572,3953
2022-06-20 13:00:00,2022-06-20 14:00:00,336,692,345,370,1743,3938
2022-06-20 14:00:00,2022-06-20 15:00:00,324,556,395,447,1722,4201
2022-06-20 15:00:00,2022-06-20 16:00:00,311,423,441,517,1692,4054
2022-06-20 16:00:00,2022-06-20 17:00:00,278,225,497,539,1539,3781
2022-06-20 17:00:00,2022-06-20 18:00:00,328,86,541,457,1412,3507
2022-06-20 18:00:00,2022-06-20 19:00:00,308,22,511,435,1276,3406
2022-06-20 19:00:00,2022-06-20 20:00:00,328,1,616,625,1570,3165
2022-06-20 20:00:00,2022-06-20 21:00:00,318,0,939,766,2023,2947
2022-06-20 21:00:00,2022-06-20 22:00:00,321,0,948,813,2082,2810
2022-06-20 22:00:00,2022-06-20 23:00:00,345,0,1060,840,2245,2683
2022-06-20 23:00:00,2022-06-21 00:00:00,333,0,1064,914,2311,2558
2022-06-21 00:00:00,2022-06-21 01:00:00,212,0,1129,1024,2365,2534
2022-06-21 01:00:00,2022-06-21 02:00:00,204,1,1192,1123,2520,2537
2022-06-21 02:00:00,2022-06-21 03:00:00,276,26,1297,1185,2784,2677
2022-06-21 03:00:00,2022-06-21 04:00:00,234,92,1301,1191,2818,3122
2022-06-21 04:00:00,2022-06-21 05:00:00,185,218,1184,1195,2782,3566
2022-06-21 05:00:00,2022-06-21 06:00:00,230,493,1041,1117,2881,3925
2022-06-21 06:00:00,2022-06-21 07:00:00,273,1022,943,1256,3494,4488
2022-06-21 07:00:00,2022-06-21 08:00:00,185,1171,699,1211,3266,4508
2022-06-21 08:00:00,2022-06-21 09:00:00,250,1322,594,1263,3429,4500
2022-06-21 09:00:00,2022-06-21 10:00:00,282,1384,648,1400,3714,4480
2022-06-21 10:00:00,2022-06-21 11:00:00,249,1391,629,1623,3892,4517
2022-06-21 11:00:00,2022-06-21 12:00:00,281,1394,656,1783,4114,4488
2022-06-21 12:00:00,2022-06-21 13:00:00,274,1293,770,1543,3880,4478
2022-06-21 13:00:00,2022-06-21 14:00:00,198,1131,751,1477,3557,4362
2022-06-21 14:00:00,2022-06-21 15:00:00,190,838,786,1352,3166,4463
2022-06-21 15:00:00,2022-06-21 16:00:00,224,508,648,1172,2552,4313
2022-06-21 16:00:00,2022-06-21 17:00:00,301,271,659,1024,2255,4035
2022-06-21 17:00:00,2022-06-21 18:00:00,326,123,566,746,1761,3784
2022-06-21 18:00:00,2022-06-21 19:00:00,352,30,542,579,1503,3643
2022-06-21 19:00:00,2022-06-21 20:00:00,354,2,517,556,1429,3537
2022-06-21 20:00:00,2022-06-21 21:00:00,219,0,510,635,1364,3391
2022-06-21 21:00:00,2022-06-21 22:00:00,180,0,504,723,1407,3119
2022-06-21 22:00:00,2022-06-21 23:00:00,127,0,498,651,1276,3019
2022-06-21 23:00:00,2022-06-22 00:00:00,115,0,472,625,1212,2968
2022-06-22 00:00:00,2022-06-22 01:00:00,115,0,433,623,1171,2947
2022-06-22 01:00:00,2022-06-22 02:00:00,115,2,397,608,1122,2938
2022-06-22 02:00:00,2022-06-22 03:00:00,116,29,337,529,1011,3029
2022-06-22 03:00:00,2022-06-22 04:00:00,119,108,357,481,1065,3552
2022-06-22 04:00:00,2022-06-22 05:00:00,119,198,311,574,1202,4066
2022-06-22 05:00:00,2022-06-22 06:00:00,120,299,350,692,1461,4249
2022-06-22 06:00:00,2022-06-22 07:00:00,119,391,374,788,1672,4455
2022-06-22 07:00:00,2022-06-22 08:00:00,121,457,292,900,1770,4581
2022-06-22 08:00:00,2022-06-22 09:00:00,123,473,217,856,1669,4588
2022-06-22 09:00:00,2022-06-22 10:00:00,121,566,225,892,1804,4454
2022-06-22 10:00:00,2022-06-22 11:00:00,121,717,275,1036,2149,4525
2022-06-22 11:00:00,2022-06-22 12:00:00,122,831,341,1140,2434,4465
2022-06-22 12:00:00,2022-06-22 13:00:00,118,832,299,1144,2393,4364
2022-06-22 13:00:00,2022-06-22 14:00:00,118,807,283,1119,2327,4334
2022-06-22 14:00:00,2022-06-22 15:00:00,117,633,254,1077,2081,4444
2022-06-22 15:00:00,2022-06-22 16:00:00,116,441,252,1038,1847,4302
2022-06-22 16:00:00,2022-06-22 17:00:00,116,246,267,927,1556,4047
2022-06-22 17:00:00,2022-06-22 18:00:00,117,108,298,820,1343,3843
2022-06-22 18:00:00,2022-06-22 19:00:00,116,28,361,659,1164,3667
2022-06-22 19:00:00,2022-06-22 20:00:00,109,1,436,580,1126,3579
2022-06-22 20:00:00,2022-06-22 21:00:00,91,0,380,538,1009,3413
2022-06-22 21:00:00,2022-06-22 22:00:00,104,0,261,508,873,3204
2022-06-22 22:00:00,2022-06-22 23:00:00,122,0,246,472,840,3079
2022-06-22 23:00:00,2022-06-23 00:00:00,171,0,225,423,819,2986
2022-06-23 00:00:00,2022-06-23 01:00:00,218,0,149,357,724,2940
2022-06-23 01:00:00,2022-06-23 02:00:00,253,1,92,335,681,2942
2022-06-23 02:00:00,2022-06-23 03:00:00,261,21,45,268,595,3082
2022-06-23 03:00:00,2022-06-23 04:00:00,289,89,37,216,631,3575
2022-06-23 04:00:00,2022-06-23 05:00:00,341,225,26,217,809,4131
2022-06-23 05:00:00,2022-06-23 06:00:00,307,393,25,200,925,4372
2022-06-23 06:00:00,2022-06-23 07:00:00,244,583,30,147,1004,4418
2022-06-23 07:00:00,2022-06-23 08:00:00,242,806,39,129,1216,4536
2022-06-23 08:00:00,2022-06-23 09:00:00,335,1061,30,116,1542,4546
2022-06-23 09:00:00,2022-06-23 10:00:00,358,1276,18,105,1757,4503
2022-06-23 10:00:00,2022-06-23 11:00:00,359,1413,25,83,1880,4601
2022-06-23 11:00:00,2022-06-23 12:00:00,356,1442,24,79,1901,4534
2022-06-23 12:00:00,2022-06-23 13:00:00,326,1431,8,91,1856,4416
2022-06-23 13:00:00,2022-06-23 14:00:00,325,1270,19,94,1708,4348
2022-06-23 14:00:00,2022-06-23 15:00:00,327,1010,58,93,1488,4369
2022-06-23 15:00:00,2022-06-23 16:00:00,290,679,90,100,1159,4162
2022-06-23 16:00:00,2022-06-23 17:00:00,285,336,139,127,887,3903
2022-06-23 17:00:00,2022-06-23 18:00:00,304,113,231,164,812,3699
2022-06-23 18:00:00,2022-06-23 19:00:00,352,29,301,253,935,3578
2022-06-23 19:00:00,2022-06-23 20:00:00,363,2,451,425,1241,3548
2022-06-23 20:00:00,2022-06-23 21:00:00,288,0,643,581,1512,3446
2022-06-23 21:00:00,2022-06-23 22:00:00,218,0,798,441,1457,3385
2022-06-23 22:00:00,2022-06-23 23:00:00,159,0,922,463,1544,3274
2022-06-23 23:00:00,2022-06-24 00:00:00,167,0,912,489,1568,3163
2022-06-24 00:00:00,2022-06-24 01:00:00,159,0,962,538,1659,3093
2022-06-24 01:00:00,2022-06-24 02:00:00,183,3,972,641,1799,3026
2022-06-24 02:00:00,2022-06-24 03:00:00,217,39,992,1022,2270,3128
2022-06-24 03:00:00,2022-06-24 04:00:00,238,137,942,763,2080,3637
2022-06-24 04:00:00,2022-06-24 05:00:00,188,391,1169,733,2481,4153
2022-06-24 05:00:00,2022-06-24 06:00:00,160,740,1153,658,2711,4430
2022-06-24 06:00:00,2022-06-24 07:00:00,199,1067,1191,880,3337,4518
2022-06-24 07:00:00,2022-06-24 08:00:00,160,1326,1175,1103,3764,4633
2022-06-24 08:00:00,2022-06-24 09:00:00,172,1477,1050,1201,3900,4709
2022-06-24 09:00:00,2022-06-24 10:00:00,115,1539,1279,1498,4431,4736
2022-06-24 10:00:00,2022-06-24 11:00:00,112,1549,1277,1663,4601,4653
2022-06-24 11:00:00,2022-06-24 12:00:00,141,1517,1199,1773,4630,4532
2022-06-24 12:00:00,2022-06-24 13:00:00,137,1432,1170,2170,4909,4332
2022-06-24 13:00:00,2022-06-24 14:00:00,109,1191,1239,1681,4220,4395
2022-06-24 14:00:00,2022-06-24 15:00:00,140,833,1107,2104,4184,4348
2022-06-24 15:00:00,2022-06-24 16:00:00,271,495,1347,1948,4061,4215
2022-06-24 16:00:00,2022-06-24 17:00:00,330,216,1146,1256,2948,3878
2022-06-24 17:00:00,2022-06-24 18:00:00,334,99,987,745,2165,3704
2022-06-24 18:00:00,2022-06-24 19:00:00,336,25,938,475,1774,3545
2022-06-24 19:00:00,2022-06-24 20:00:00,325,1,937,486,1749,3479
2022-06-24 20:00:00,2022-06-24 21:00:00,316,0,813,426,1555,3395
2022-06-24 21:00:00,2022-06-24 22:00:00,348,0,826,373,1547,3154
2022-06-24 22:00:00,2022-06-24 23:00:00,288,0,795,327,1410,3009
2022-06-24 23:00:00,2022-06-25 00:00:00,261,0,655,250,1166,2949
2022-06-25 00:00:00,2022-06-25 01:00:00,260,0,484,202,946,2870
2022-06-25 01:00:00,2022-06-25 02:00:00,262,3,251,176,692,2808
2022-06-25 02:00:00,2022-06-25 03:00:00,252,38,139,146,575,2788
2022-06-25 03:00:00,2022-06-25 04:00:00,187,144,92,86,509,2933
2022-06-25 04:00:00,2022-06-25 05:00:00,234,303,92,64,693,3225
2022-06-25 05:00:00,2022-06-25 06:00:00,233,550,63,47,893,3528
2022-06-25 06:00:00,2022-06-25 07:00:00,175,835,42,46,1098,3803
2022-06-25 07:00:00,2022-06-25 08:00:00,124,1008,61,48,1241,3944
2022-06-25 08:00:00,2022-06-25 09:00:00,105,1095,114,47,1361,3950
2022-06-25 09:00:00,2022-06-25 10:00:00,105,1130,183,53,1471,3937
2022-06-25 10:00:00,2022-06-25 11:00:00,105,1128,161,62,1456,3888
2022-06-25 11:00:00,2022-06-25 12:00:00,106,1072,82,84,1344,3777
2022-06-25 12:00:00,2022-06-25 13:00:00,127,1037,37,125,1326,3657
2022-06-25 13:00:00,2022-06-25 14:00:00,142,867,53,151,1213,3667
2022-06-25 14:00:00,2022-06-25 15:00:00,58,664,30,170,922,3915
2022-06-25 15:00:00,2022-06-25 16:00:00,16,496,22,157,691,3813
2022-06-25 16:00:00,2022-06-25 17:00:00,15,300,9,134,458,3727
2022-06-25 17:00:00,2022-06-25 18:00:00,14,135,9,133,291,3581
2022-06-25 18:00:00,2022-06-25 19:00:00,29,33,55,138,255,3434
2022-06-25 19:00:00,2022-06-25 20:00:00,113,2,63,121,299,3374
2022-06-25 20:00:00,2022-06-25 21:00:00,172,0,76,113,361,3256
2022-06-25 21:00:00,2022-06-25 22:00:00,83,0,132,130,345,3084
2022-06-25 22:00:00,2022-06-25 23:00:00,26,0,176,150,352,2935
2022-06-25 23:00:00,2022-06-26 00:00:00,14,0,250,197,461,2816
2022-06-26 00:00:00,2022-06-26 01:00:00,5,0,267,295,567,2768
2022-06-26 01:00:00,2022-06-26 02:00:00,5,3,413,434,855,2672
2022-06-26 02:00:00,2022-06-26 03:00:00,5,40,605,436,1086,2620
2022-06-26 03:00:00,2022-06-26 04:00:00,6,132,849,430,1417,2732
2022-06-26 04:00:00,2022-06-26 05:00:00,6,288,821,399,1514,2994
2022-06-26 05:00:00,2022-06-26 06:00:00,7,520,518,369,1414,3334
2022-06-26 06:00:00,2022-06-26 07:00:00,14,780,349,434,1577,3605
2022-06-26 07:00:00,2022-06-26 08:00:00,65,1081,184,514,1844,3838
2022-06-26 08:00:00,2022-06-26 09:00:00,127,1166,214,520,2027,3840
2022-06-26 09:00:00,2022-06-26 10:00:00,134,1166,227,547,2074,3815
2022-06-26 10:00:00,2022-06-26 11:00:00,135,1257,318,706,2416,3919
2022-06-26 11:00:00,2022-06-26 12:00:00,117,1143,203,1060,2523,3841
2022-06-26 12:00:00,2022-06-26 13:00:00,140,1099,172,1008,2419,3808
2022-06-26 13:00:00,2022-06-26 14:00:00,150,960,200,804,2114,3854
2022-06-26 14:00:00,2022-06-26 15:00:00,223,722,141,536,1622,4056
2022-06-26 15:00:00,2022-06-26 16:00:00,229,451,83,439,1202,3945
2022-06-26 16:00:00,2022-06-26 17:00:00,257,246,46,313,862,3745
2022-06-26 17:00:00,2022-06-26 18:00:00,260,100,65,208,633,3632
2022-06-26 18:00:00,2022-06-26 19:00:00,260,24,64,163,511,3438
2022-06-26 19:00:00,2022-06-26 20:00:00,258,1,75,122,456,3404
2022-06-26 20:00:00,2022-06-26 21:00:00,259,0,97,121,477,3318
2022-06-26 21:00:00,2022-06-26 22:00:00,257,0,151,138,546,3157
2022-06-26 22:00:00,2022-06-26 23:00:00,241,0,182,185,608,3046
2022-06-26 23:00:00,2022-06-27 00:00:00,212,0,252,229,693,2984
2022-06-27 00:00:00,2022-06-27 01:00:00,227,0,345,293,865,2914
2022-06-27 01:00:00,2022-06-27 02:00:00,229,2,246,306,783,2923
2022-06-27 02:00:00,2022-06-27 03:00:00,217,26,306,232,781,3090
2022-06-27 03:00:00,2022-06-27 04:00:00,275,63,363,239,940,3562
2022-06-27 04:00:00,2022-06-27 05:00:00,304,124,345,321,1094,4102
2022-06-27 05:00:00,2022-06-27 06:00:00,288,219,306,468,1281,4416
2022-06-27 06:00:00,2022-06-27 07:00:00,295,325,395,529,1544,4532
2022-06-27 07:00:00,2022-06-27 08:00:00,312,450,472,506,1740,4603
2022-06-27 08:00:00,2022-06-27 09:00:00,349,529,466,397,1741,4645
2022-06-27 09:00:00,2022-06-27 10:00:00,331,550,484,280,1645,4588
2022-06-27 10:00:00,2022-06-27 11:00:00,329,614,483,255,1681,4652
2022-06-27 11:00:00,2022-06-27 12:00:00,321,458,424,233,1436,4596
2022-06-27 12:00:00,2022-06-27 13:00:00,318,363,476,259,1416,4481
2022-06-27 13:00:00,2022-06-27 14:00:00,322,351,557,438,1668,4483
2022-06-27 14:00:00,2022-06-27 15:00:00,295,275,627,618,1815,4622
2022-06-27 15:00:00,2022-06-27 16:00:00,284,138,837,732,1991,4456
2022-06-27 16:00:00,2022-06-27 17:00:00,317,66,743,762,1888,4150
2022-06-27 17:00:00,2022-06-27 18:00:00,338,25,971,882,2216,3944
2022-06-27 18:00:00,2022-06-27 19:00:00,265,12,1077,761,2115,3756
2022-06-27 19:00:00,2022-06-27 20:00:00,300,2,821,513,1636,3632
2022-06-27 20:00:00,2022-06-27 21:00:00,303,1,672,285,1261,3417
2022-06-27 21:00:00,2022-06-27 22:00:00,271,0,622,288,1181,3206
2022-06-27 22:00:00,2022-06-27 23:00:00,263,0,449,263,975,3093
2022-06-27 23:00:00,2022-06-28 00:00:00,265,0,460,377,1102,2982
2022-06-28 00:00:00,2022-06-28 01:00:00,264,0,523,543,1330,2928
2022-06-28 01:00:00,2022-06-28 02:00:00,250,1,803,613,1667,2961
2022-06-28 02:00:00,2022-06-28 03:00:00,205,21,847,614,1687,3130
2022-06-28 03:00:00,2022-06-28 04:00:00,197,102,934,469,1702,3565
2022-06-28 04:00:00,2022-06-28 05:00:00,223,262,911,345,1741,4057
2022-06-28 05:00:00,2022-06-28 06:00:00,248,581,697,292,1818,4396
2022-06-28 06:00:00,2022-06-28 07:00:00,236,867,466,434,2003,4489
2022-06-28 07:00:00,2022-06-28 08:00:00,236,1096,334,480,2146,4627
2022-06-28 08:00:00,2022-06-28 09:00:00,264,1275,243,487,2269,4694
2022-06-28 09:00:00,2022-06-28 10:00:00,268,1323,146,446,2183,4650
2022-06-28 10:00:00,2022-06-28 11:00:00,273,1279,68,395,2015,4668
2022-06-28 11:00:00,2022-06-28 12:00:00,274,1311,39,295,1919,4601
2022-06-28 12:00:00,2022-06-28 13:00:00,279,1209,30,249,1767,4428
2022-06-28 13:00:00,2022-06-28 14:00:00,297,1168,27,223,1715,4421
2022-06-28 14:00:00,2022-06-28 15:00:00,307,945,21,165,1438,4533
2022-06-28 15:00:00,2022-06-28 16:00:00,312,673,26,118,1129,4366
2022-06-28 16:00:00,2022-06-28 17:00:00,319,346,18,85,768,4144
2022-06-28 17:00:00,2022-06-28 18:00:00,316,121,5,62,504,3922
2022-06-28 18:00:00,2022-06-28 19:00:00,284,31,18,47,380,3753
2022-06-28 19:00:00,2022-06-28 20:00:00,276,2,15,39,332,3648
2022-06-28 20:00:00,2022-06-28 21:00:00,303,1,13,38,355,3485
2022-06-28 21:00:00,2022-06-28 22:00:00,311,0,15,36,362,3272
2022-06-28 22:00:00,2022-06-28 23:00:00,266,0,28,42,336,3104
2022-06-28 23:00:00,2022-06-29 00:00:00,264,0,36,70,370,3005
2022-06-29 00:00:00,2022-06-29 01:00:00,261,0,64,104,429,2963
2022-06-29 01:00:00,2022-06-29 02:00:00,268,3,103,137,511,2927
2022-06-29 02:00:00,2022-06-29 03:00:00,258,41,72,129,500,3084
2022-06-29 03:00:00,2022-06-29 04:00:00,251,143,78,121,593,3524
2022-06-29 04:00:00,2022-06-29 05:00:00,265,393,131,102,891,4065
2022-06-29 05:00:00,2022-06-29 06:00:00,268,739,198,88,1293,4330
2022-06-29 06:00:00,2022-06-29 07:00:00,237,1030,215,152,1634,4465
2022-06-29 07:00:00,2022-06-29 08:00:00,238,1230,205,193,1866,4594
2022-06-29 08:00:00,2022-06-29 09:00:00,235,1305,218,216,1974,4573
2022-06-29 09:00:00,2022-06-29 10:00:00,238,1374,204,243,2059,4575
2022-06-29 10:00:00,2022-06-29 11:00:00,232,1370,199,319,2120,4613
2022-06-29 11:00:00,2022-06-29 12:00:00,265,1335,213,382,2195,4515
2022-06-29 12:00:00,2022-06-29 13:00:00,237,1267,303,451,2258,4396
2022-06-29 13:00:00,2022-06-29 14:00:00,249,1081,325,499,2154,4259
2022-06-29 14:00:00,2022-06-29 15:00:00,327,884,382,529,2122,4387
2022-06-29 15:00:00,2022-06-29 16:00:00,338,600,348,517,1803,4236
2022-06-29 16:00:00,2022-06-29 17:00:00,341,319,456,477,1593,4017
2022-06-29 17:00:00,2022-06-29 18:00:00,331,119,510,431,1391,3790
2022-06-29 18:00:00,2022-06-29 19:00:00,337,29,470,418,1254,3615
2022-06-29 19:00:00,2022-06-29 20:00:00,320,1,461,513,1295,3544
2022-06-29 20:00:00,2022-06-29 21:00:00,309,1,540,535,1385,3392
2022-06-29 21:00:00,2022-06-29 22:00:00,264,0,535,440,1239,3232
2022-06-29 22:00:00,2022-06-29 23:00:00,218,0,466,363,1047,3117
2022-06-29 23:00:00,2022-06-30 00:00:00,191,0,451,430,1072,3011
2022-06-30 00:00:00,2022-06-30 01:00:00,240,0,405,444,1089,2937
2022-06-30 01:00:00,2022-06-30 02:00:00,156,3,288,301,748,3039
2022-06-30 02:00:00,2022-06-30 03:00:00,165,43,385,278,871,3131
2022-06-30 03:00:00,2022-06-30 04:00:00,180,147,332,197,856,3578
2022-06-30 04:00:00,2022-06-30 05:00:00,240,389,403,130,1162,4113
2022-06-30 05:00:00,2022-06-30 06:00:00,255,719,325,179,1478,4328
2022-06-30 06:00:00,2022-06-30 07:00:00,232,1053,333,241,1859,4545
2022-06-30 07:00:00,2022-06-30 08:00:00,202,1305,279,304,2090,4726
2022-06-30 08:00:00,2022-06-30 09:00:00,255,1444,205,354,2258,4658
2022-06-30 09:00:00,2022-06-30 10:00:00,271,1479,186,286,2222,4672
2022-06-30 10:00:00,2022-06-30 11:00:00,311,1477,154,286,2228,4636
2022-06-30 11:00:00,2022-06-30 12:00:00,318,1471,157,327,2273,4530
2022-06-30 12:00:00,2022-06-30 13:00:00,331,1366,190,348,2235,4384
2022-06-30 13:00:00,2022-06-30 14:00:00,314,1176,189,360,2039,4286
2022-06-30 14:00:00,2022-06-30 15:00:00,367,889,194,328,1778,4335
2022-06-30 15:00:00,2022-06-30 16:00:00,378,635,216,317,1546,4226
2022-06-30 16:00:00,2022-06-30 17:00:00,372,329,172,284,1157,4010
2022-06-30 17:00:00,2022-06-30 18:00:00,328,124,162,240,854,3812
2022-06-30 18:00:00,2022-06-30 19:00:00,369,32,202,284,887,3643
2022-06-30 19:00:00,2022-06-30 20:00:00,373,2,246,461,1082,3539
2022-06-30 20:00:00,2022-06-30 21:00:00,363,0,308,600,1271,3379
2022-06-30 21:00:00,2022-06-30 22:00:00,349,0,308,620,1277,3186
2022-06-30 22:00:00,2022-06-30 23:00:00,252,0,305,602,1159,3030
2022-06-30 23:00:00,2022-07-01 00:00:00,312,0,408,485,1205,2927
2022-07-01 00:00:00,2022-07-01 01:00:00,336,0,432,413,1181,2882
2022-07-01 01:00:00,2022-07-01 02:00:00,333,3,319,388,1043,2864
2022-07-01 02:00:00,2022-07-01 03:00:00,362,50,393,396,1201,2993
2022-07-01 03:00:00,2022-07-01 04:00:00,363,140,309,361,1173,3473
2022-07-01 04:00:00,2022-07-01 05:00:00,361,237,372,340,1310,3948
2022-07-01 05:00:00,2022-07-01 06:00:00,353,357,612,455,1777,4242
2022-07-01 06:00:00,2022-07-01 07:00:00,325,411,744,659,2139,4394
2022-07-01 07:00:00,2022-07-01 08:00:00,339,378,720,855,2292,4497
2022-07-01 08:00:00,2022-07-01 09:00:00,362,432,578,831,2203,4494
2022-07-01 09:00:00,2022-07-01 10:00:00,344,470,508,881,2203,4422
2022-07-01 10:00:00,2022-07-01 11:00:00,301,423,533,1065,2322,4356
2022-07-01 11:00:00,2022-07-01 12:00:00,300,364,460,1240,2364,4229
2022-07-01 12:00:00,2022-07-01 13:00:00,298,322,638,1235,2493,4099
2022-07-01 13:00:00,2022-07-01 14:00:00,288,346,766,1188,2588,4133
2022-07-01 14:00:00,2022-07-01 15:00:00,297,282,915,1100,2594,4191
2022-07-01 15:00:00,2022-07-01 16:00:00,368,194,1160,864,2586,4061
2022-07-01 16:00:00,2022-07-01 17:00:00,383,135,1347,730,2595,3819
2022-07-01 17:00:00,2022-07-01 18:00:00,374,70,1399,689,2532,3581
2022-07-01 18:00:00,2022-07-01 19:00:00,306,15,1132,696,2149,3390
2022-07-01 19:00:00,2022-07-01 20:00:00,263,1,923,657,1844,3271
2022-07-01 20:00:00,2022-07-01 21:00:00,231,0,795,734,1760,3101
2022-07-01 21:00:00,2022-07-01 22:00:00,275,0,900,895,2070,2929
2022-07-01 22:00:00,2022-07-01 23:00:00,202,0,1170,1024,2396,2792
2022-07-01 23:00:00,2022-07-02 00:00:00,138,0,1140,970,2248,2775
2022-07-02 00:00:00,2022-07-02 01:00:00,140,0,828,895,1863,2727
2022-07-02 01:00:00,2022-07-02 02:00:00,203,1,863,958,2025,2610
2022-07-02 02:00:00,2022-07-02 03:00:00,231,26,865,955,2077,2593
2022-07-02 03:00:00,2022-07-02 04:00:00,162,130,864,758,1914,2756
2022-07-02 04:00:00,2022-07-02 05:00:00,212,384,802,672,2070,3043
2022-07-02 05:00:00,2022-07-02 06:00:00,203,662,797,970,2632,3357
2022-07-02 06:00:00,2022-07-02 07:00:00,124,942,793,1263,3122,3547
2022-07-02 07:00:00,2022-07-02 08:00:00,105,1140,707,1411,3363,3724
2022-07-02 08:00:00,2022-07-02 09:00:00,98,1292,716,1471,3577,3894
2022-07-02 09:00:00,2022-07-02 10:00:00,98,1320,931,1572,3921,3857
2022-07-02 10:00:00,2022-07-02 11:00:00,100,1339,1089,1583,4111,3869
2022-07-02 11:00:00,2022-07-02 12:00:00,103,1320,1061,1692,4176,3723
2022-07-02 12:00:00,2022-07-02 13:00:00,103,1297,1060,1737,4197,3647
2022-07-02 13:00:00,2022-07-02 14:00:00,107,1128,1096,1826,4157,3657
2022-07-02 14:00:00,2022-07-02 15:00:00,135,864,1088,1921,4008,3734
2022-07-02 15:00:00,2022-07-02 16:00:00,114,631,911,1767,3423,3723
2022-07-02 16:00:00,2022-07-02 17:00:00,191,341,827,1460,2819,3539
2022-07-02 17:00:00,2022-07-02 18:00:00,260,135,719,1185,2299,3365
2022-07-02 18:00:00,2022-07-02 19:00:00,255,32,551,927,1765,3192
2022-07-02 19:00:00,2022-07-02 20:00:00,253,2,575,805,1635,3127
2022-07-02 20:00:00,2022-07-02 21:00:00,222,0,596,787,1605,3009
2022-07-02 21:00:00,2022-07-02 22:00:00,83,0,617,855,1555,2846
2022-07-02 22:00:00,2022-07-02 23:00:00,12,0,709,898,1619,2738
2022-07-02 23:00:00,2022-07-03 00:00:00,14,0,812,996,1822,2639
2022-07-03 00:00:00,2022-07-03 01:00:00,6,0,1066,1013,2085,2584
2022-07-03 01:00:00,2022-07-03 02:00:00,5,1,1071,958,2035,2525
2022-07-03 02:00:00,2022-07-03 03:00:00,5,21,1148,946,2120,2534
2022-07-03 03:00:00,2022-07-03 04:00:00,6,99,1193,773,2071,2656
2022-07-03 04:00:00,2022-07-03 05:00:00,6,253,1060,548,1867,2893
2022-07-03 05:00:00,2022-07-03 06:00:00,7,497,787,462,1753,3189
2022-07-03 06:00:00,2022-07-03 07:00:00,8,836,521,515,1880,3424
2022-07-03 07:00:00,2022-07-03 08:00:00,8,1108,373,498,1987,3662
2022-07-03 08:00:00,2022-07-03 09:00:00,9,1164,273,427,1873,3799
2022-07-03 09:00:00,2022-07-03 10:00:00,9,1174,256,409,1848,3770
2022-07-03 10:00:00,2022-07-03 11:00:00,9,1170,282,393,1854,3822
2022-07-03 11:00:00,2022-07-03 12:00:00,9,1225,388,332,1954,3785
2022-07-03 12:00:00,2022-07-03 13:00:00,8,1136,511,343,1998,3713
2022-07-03 13:00:00,2022-07-03 14:00:00,10,1042,570,337,1959,3756
2022-07-03 14:00:00,2022-07-03 15:00:00,25,763,551,298,1637,3880
2022-07-03 15:00:00,2022-07-03 16:00:00,118,473,454,273,1318,3846
2022-07-03 16:00:00,2022-07-03 17:00:00,126,254,432,228,1040,3652
2022-07-03 17:00:00,2022-07-03 18:00:00,167,109,406,272,954,3494
2022-07-03 18:00:00,2022-07-03 19:00:00,259,28,203,282,772,3334
2022-07-03 19:00:00,2022-07-03 20:00:00,265,3,355,317,940,3299
2022-07-03 20:00:00,2022-07-03 21:00:00,245,0,297,203,745,3136
2022-07-03 21:00:00,2022-07-03 22:00:00,203,0,466,222,891,2980
2022-07-03 22:00:00,2022-07-03 23:00:00,136,0,443,311,890,2840
2022-07-03 23:00:00,2022-07-04 00:00:00,203,0,492,409,1104,2782
2022-07-04 00:00:00,2022-07-04 01:00:00,206,0,473,441,1120,2752
2022-07-04 01:00:00,2022-07-04 02:00:00,214,1,565,461,1241,2687
2022-07-04 02:00:00,2022-07-04 03:00:00,220,32,596,507,1355,2875
2022-07-04 03:00:00,2022-07-04 04:00:00,234,142,602,478,1456,3332
2022-07-04 04:00:00,2022-07-04 05:00:00,250,347,584,449,1630,3857
2022-07-04 05:00:00,2022-07-04 06:00:00,248,551,705,636,2140,4189
2022-07-04 06:00:00,2022-07-04 07:00:00,211,642,634,777,2264,4227
2022-07-04 07:00:00,2022-07-04 08:00:00,194,637,671,817,2319,4126
2022-07-04 08:00:00,2022-07-04 09:00:00,157,764,787,1103,2811,4186
2022-07-04 09:00:00,2022-07-04 10:00:00,197,779,844,1382,3202,4159
2022-07-04 10:00:00,2022-07-04 11:00:00,142,786,1023,1554,3505,4054
2022-07-04 11:00:00,2022-07-04 12:00:00,127,745,1043,1740,3655,4196
2022-07-04 12:00:00,2022-07-04 13:00:00,131,769,1150,2157,4207,4389
2022-07-04 13:00:00,2022-07-04 14:00:00,152,648,1068,1707,3575,4426
2022-07-04 14:00:00,2022-07-04 15:00:00,137,563,1173,1728,3601,4571
2022-07-04 15:00:00,2022-07-04 16:00:00,140,453,1235,1624,3452,4412
2022-07-04 16:00:00,2022-07-04 17:00:00,139,273,1146,1355,2913,4179
2022-07-04 17:00:00,2022-07-04 18:00:00,135,120,1224,1268,2747,3921
2022-07-04 18:00:00,2022-07-04 19:00:00,137,29,1278,1477,2921,3679
2022-07-04 19:00:00,2022-07-04 20:00:00,143,1,1518,1228,2890,3488
2022-07-04 20:00:00,2022-07-04 21:00:00,203,0,1430,1268,2901,3276
2022-07-04 21:00:00,2022-07-04 22:00:00,209,0,1368,1200,2777,3120
2022-07-04 22:00:00,2022-07-04 23:00:00,138,0,1262,1189,2589,2985
2022-07-04 23:00:00,2022-07-05 00:00:00,137,0,1100,1221,2458,2881
2022-07-05 00:00:00,2022-07-05 01:00:00,135,0,982,1169,2286,2853
2022-07-05 01:00:00,2022-07-05 02:00:00,155,2,1035,1166,2358,2862
2022-07-05 02:00:00,2022-07-05 03:00:00,237,29,915,1096,2277,2928
2022-07-05 03:00:00,2022-07-05 04:00:00,253,127,920,981,2281,3388
2022-07-05 04:00:00,2022-07-05 05:00:00,235,330,932,1109,2606,3913
2022-07-05 05:00:00,2022-07-05 06:00:00,252,610,863,1338,3063,4176
2022-07-05 06:00:00,2022-07-05 07:00:00,0,782,941,1577,3300,4355
2022-07-05 07:00:00,2022-07-05 08:00:00,187,884,701,1722,3494,4506
2022-07-05 08:00:00,2022-07-05 09:00:00,251,1021,633,1683,3588,4573
2022-07-05 09:00:00,2022-07-05 10:00:00,164,1091,779,1699,3733,4591
2022-07-05 10:00:00,2022-07-05 11:00:00,139,1094,877,1759,3869,4644
2022-07-05 11:00:00,2022-07-05 12:00:00,156,996,804,2001,3957,4414
2022-07-05 12:00:00,2022-07-05 13:00:00,161,900,806,2053,3920,4287
2022-07-05 13:00:00,2022-07-05 14:00:00,163,844,1158,2085,4250,4274
2022-07-05 14:00:00,2022-07-05 15:00:00,141,688,1175,1853,3857,4441
2022-07-05 15:00:00,2022-07-05 16:00:00,140,500,1315,1643,3598,4315
2022-07-05 16:00:00,2022-07-05 17:00:00,141,277,1253,1589,3260,4031
2022-07-05 17:00:00,2022-07-05 18:00:00,254,118,1054,1365,2791,3719
2022-07-05 18:00:00,2022-07-05 19:00:00,276,33,1214,1244,2767,3428
2022-07-05 19:00:00,2022-07-05 20:00:00,274,2,1177,1232,2685,3364
2022-07-05 20:00:00,2022-07-05 21:00:00,246,0,1207,1331,2784,3171
2022-07-05 21:00:00,2022-07-05 22:00:00,221,0,1168,1294,2683,3044
2022-07-05 22:00:00,2022-07-05 23:00:00,248,0,1245,1344,2837,2927
2022-07-05 23:00:00,2022-07-06 00:00:00,251,0,1340,1394,2985,2849
2022-07-06 00:00:00,2022-07-06 01:00:00,252,0,1342,1451,3045,2834
2022-07-06 01:00:00,2022-07-06 02:00:00,254,1,1314,1513,3082,2847
2022-07-06 02:00:00,2022-07-06 03:00:00,213,38,1239,1562,3052,3001
2022-07-06 03:00:00,2022-07-06 04:00:00,267,137,1196,1490,3090,3396
2022-07-06 04:00:00,2022-07-06 05:00:00,291,387,1119,1571,3368,3854
2022-07-06 05:00:00,2022-07-06 06:00:00,292,674,1061,1820,3847,4212
2022-07-06 06:00:00,2022-07-06 07:00:00,280,894,889,1821,3884,4355
2022-07-06 07:00:00,2022-07-06 08:00:00,279,1114,928,1672,3993,4529
2022-07-06 08:00:00,2022-07-06 09:00:00,273,1208,1025,1539,4045,4526
2022-07-06 09:00:00,2022-07-06 10:00:00,178,1287,1127,1593,4185,4480
2022-07-06 10:00:00,2022-07-06 11:00:00,137,1289,1261,1723,4410,4490
2022-07-06 11:00:00,2022-07-06 12:00:00,128,1240,1417,1994,4779,4422
2022-07-06 12:00:00,2022-07-06 13:00:00,151,1102,1509,2011,4773,4397
2022-07-06 13:00:00,2022-07-06 14:00:00,162,842,1346,2067,4417,4280
2022-07-06 14:00:00,2022-07-06 15:00:00,156,510,1283,2168,4117,4337
2022-07-06 15:00:00,2022-07-06 16:00:00,182,288,1381,1994,3845,4223
2022-07-06 16:00:00,2022-07-06 17:00:00,239,139,1507,1666,3551,3985
2022-07-06 17:00:00,2022-07-06 18:00:00,167,42,1505,1542,3256,3770
2022-07-06 18:00:00,2022-07-06 19:00:00,161,7,1612,1411,3191,3655
2022-07-06 19:00:00,2022-07-06 20:00:00,137,1,1636,1461,3235,3483
2022-07-06 20:00:00,2022-07-06 21:00:00,128,0,1736,1193,3057,3383
2022-07-06 21:00:00,2022-07-06 22:00:00,114,0,1432,773,2319,3238
2022-07-06 22:00:00,2022-07-06 23:00:00,122,0,1237,687,2046,3137
2022-07-06 23:00:00,2022-07-07 00:00:00,114,0,1175,670,1959,3076
2022-07-07 00:00:00,2022-07-07 01:00:00,109,0,1276,796,2181,3031
2022-07-07 01:00:00,2022-07-07 02:00:00,122,1,1016,803,1942,3058
2022-07-07 02:00:00,2022-07-07 03:00:00,135,20,1264,1102,2521,3072
2022-07-07 03:00:00,2022-07-07 04:00:00,138,91,1230,953,2412,3539
2022-07-07 04:00:00,2022-07-07 05:00:00,150,238,1069,1060,2517,4044
2022-07-07 05:00:00,2022-07-07 06:00:00,212,388,1369,1551,3520,4171
2022-07-07 06:00:00,2022-07-07 07:00:00,225,627,1207,1853,3912,4408
2022-07-07 07:00:00,2022-07-07 08:00:00,154,828,1160,1789,3931,4658
2022-07-07 08:00:00,2022-07-07 09:00:00,148,916,1184,1944,4192,4636
2022-07-07 09:00:00,2022-07-07 10:00:00,149,943,1209,1619,3920,4666
2022-07-07 10:00:00,2022-07-07 11:00:00,156,1029,1218,1793,4196,4553
2022-07-07 11:00:00,2022-07-07 12:00:00,132,1163,1412,1692,4399,4435
2022-07-07 12:00:00,2022-07-07 13:00:00,129,1133,1477,1464,4203,4342
2022-07-07 13:00:00,2022-07-07 14:00:00,137,1140,1385,1281,3943,4353
2022-07-07 14:00:00,2022-07-07 15:00:00,138,956,1384,1379,3857,4378
2022-07-07 15:00:00,2022-07-07 16:00:00,139,669,1241,1243,3292,4271
2022-07-07 16:00:00,2022-07-07 17:00:00,151,347,1106,1227,2831,4056
2022-07-07 17:00:00,2022-07-07 18:00:00,138,118,1197,914,2367,3825
2022-07-07 18:00:00,2022-07-07 19:00:00,139,28,1167,1058,2392,3601
2022-07-07 19:00:00,2022-07-07 20:00:00,138,2,1220,1102,2462,3485
2022-07-07 20:00:00,2022-07-07 21:00:00,184,0,1332,1354,2870,3288
2022-07-07 21:00:00,2022-07-07 22:00:00,99,0,1383,1503,2985,3121
2022-07-07 22:00:00,2022-07-07 23:00:00,53,0,1119,1240,2412,3070
2022-07-07 23:00:00,2022-07-08 00:00:00,5,0,1246,1413,2664,2939
2022-07-08 00:00:00,2022-07-08 01:00:00,6,0,1133,1548,2687,2928
2022-07-08 01:00:00,2022-07-08 02:00:00,6,1,1638,1601,3246,2947
2022-07-08 02:00:00,2022-07-08 03:00:00,7,20,1694,1937,3658,2978
2022-07-08 03:00:00,2022-07-08 04:00:00,12,101,1671,2049,3833,3379
2022-07-08 04:00:00,2022-07-08 05:00:00,16,200,1504,2090,3810,3824
2022-07-08 05:00:00,2022-07-08 06:00:00,16,328,1607,2199,4150,4099
2022-07-08 06:00:00,2022-07-08 07:00:00,16,505,1537,2264,4322,4280
2022-07-08 07:00:00,2022-07-08 08:00:00,17,663,1390,2185,4255,4372
2022-07-08 08:00:00,2022-07-08 09:00:00,17,842,1419,2243,4521,4431
2022-07-08 09:00:00,2022-07-08 10:00:00,17,960,1283,2372,4632,4399
2022-07-08 10:00:00,2022-07-08 11:00:00,18,1152,1271,2224,4665,4419
2022-07-08 11:00:00,2022-07-08 12:00:00,10,1238,1215,2080,4543,4334
2022-07-08 12:00:00,2022-07-08 13:00:00,8,1177,1278,2212,4675,4166
2022-07-08 13:00:00,2022-07-08 14:00:00,8,1082,1093,2205,4388,4099
2022-07-08 14:00:00,2022-07-08 15:00:00,7,861,1052,2037,3957,4166
2022-07-08 15:00:00,2022-07-08 16:00:00,7,580,1119,1816,3522,4126
2022-07-08 16:00:00,2022-07-08 17:00:00,6,287,1190,1771,3254,3869
2022-07-08 17:00:00,2022-07-08 18:00:00,6,110,1224,2031,3371,3567
2022-07-08 18:00:00,2022-07-08 19:00:00,6,22,1585,2131,3744,3334
2022-07-08 19:00:00,2022-07-08 20:00:00,6,1,1715,2026,3748,3170
2022-07-08 20:00:00,2022-07-08 21:00:00,6,0,1871,2008,3885,3075
2022-07-08 21:00:00,2022-07-08 22:00:00,6,0,1872,1962,3840,2921
2022-07-08 22:00:00,2022-07-08 23:00:00,6,0,1642,1784,3432,2824
2022-07-08 23:00:00,2022-07-09 00:00:00,6,0,1563,1776,3345,2703
2022-07-09 00:00:00,2022-07-09 01:00:00,6,0,1603,1814,3423,2657
2022-07-09 01:00:00,2022-07-09 02:00:00,6,1,1475,1792,3274,2590
2022-07-09 02:00:00,2022-07-09 03:00:00,6,29,1645,1724,3404,2560
2022-07-09 03:00:00,2022-07-09 04:00:00,6,128,1631,1856,3621,2720
2022-07-09 04:00:00,2022-07-09 05:00:00,6,326,1710,2263,4305,2989
2022-07-09 05:00:00,2022-07-09 06:00:00,6,549,1623,2689,4867,3328
2022-07-09 06:00:00,2022-07-09 07:00:00,6,791,1687,2823,5307,3567
2022-07-09 07:00:00,2022-07-09 08:00:00,6,945,1772,3027,5750,3693
2022-07-09 08:00:00,2022-07-09 09:00:00,7,1067,1779,2742,5595,3864
2022-07-09 09:00:00,2022-07-09 10:00:00,6,1024,1849,2692,5571,3893
2022-07-09 10:00:00,2022-07-09 11:00:00,7,987,1769,2649,5412,3815
2022-07-09 11:00:00,2022-07-09 12:00:00,7,917,1136,2298,4358,3817
2022-07-09 12:00:00,2022-07-09 13:00:00,7,929,1063,2308,4307,3761
2022-07-09 13:00:00,2022-07-09 14:00:00,7,813,1505,2336,4661,3721
2022-07-09 14:00:00,2022-07-09 15:00:00,7,635,1443,2281,4366,3832
2022-07-09 15:00:00,2022-07-09 16:00:00,10,435,1414,2288,4147,3760
2022-07-09 16:00:00,2022-07-09 17:00:00,10,241,1439,2317,4007,3570
2022-07-09 17:00:00,2022-07-09 18:00:00,10,101,1449,2230,3790,3409
2022-07-09 18:00:00,2022-07-09 19:00:00,10,25,1473,2236,3744,3228
2022-07-09 19:00:00,2022-07-09 20:00:00,10,1,1459,2266,3736,3119
2022-07-09 20:00:00,2022-07-09 21:00:00,10,0,1382,2211,3603,3039
2022-07-09 21:00:00,2022-07-09 22:00:00,9,0,1427,1778,3214,2931
2022-07-09 22:00:00,2022-07-09 23:00:00,5,0,1617,1506,3128,2789
2022-07-09 23:00:00,2022-07-10 00:00:00,6,0,1570,1343,2919,2690
2022-07-10 00:00:00,2022-07-10 01:00:00,5,0,1485,1300,2790,2611
2022-07-10 01:00:00,2022-07-10 02:00:00,5,1,1290,1220,2516,2542
2022-07-10 02:00:00,2022-07-10 03:00:00,5,30,1315,1122,2472,2509
2022-07-10 03:00:00,2022-07-10 04:00:00,5,126,1412,1019,2562,2622
2022-07-10 04:00:00,2022-07-10 05:00:00,6,336,1404,1282,3028,2905
2022-07-10 05:00:00,2022-07-10 06:00:00,6,617,1237,1191,3051,3232
2022-07-10 06:00:00,2022-07-10 07:00:00,7,887,1183,1040,3117,3461
2022-07-10 07:00:00,2022-07-10 08:00:00,7,1086,1061,911,3065,3558
2022-07-10 08:00:00,2022-07-10 09:00:00,8,1265,1273,1241,3787,3552
2022-07-10 09:00:00,2022-07-10 10:00:00,8,1375,1327,911,3621,3642
2022-07-10 10:00:00,2022-07-10 11:00:00,8,1378,1093,896,3375,3657
2022-07-10 11:00:00,2022-07-10 12:00:00,8,1321,992,887,3208,3601
2022-07-10 12:00:00,2022-07-10 13:00:00,30,1267,935,777,3009,3555
2022-07-10 13:00:00,2022-07-10 14:00:00,95,1093,1034,912,3134,3517
2022-07-10 14:00:00,2022-07-10 15:00:00,98,866,1082,906,2952,3645
2022-07-10 15:00:00,2022-07-10 16:00:00,96,581,1020,1019,2716,3668
2022-07-10 16:00:00,2022-07-10 17:00:00,97,322,979,700,2098,3522
2022-07-10 17:00:00,2022-07-10 18:00:00,169,124,933,688,1914,3323
2022-07-10 18:00:00,2022-07-10 19:00:00,158,30,1008,728,1924,3164
2022-07-10 19:00:00,2022-07-10 20:00:00,233,3,1010,756,2002,3079
2022-07-10 20:00:00,2022-07-10 21:00:00,343,0,857,726,1926,2988
2022-07-10 21:00:00,2022-07-10 22:00:00,355,0,772,657,1784,2802
2022-07-10 22:00:00,2022-07-10 23:00:00,354,0,628,610,1592,2716
2022-07-10 23:00:00,2022-07-11 00:00:00,348,0,637,539,1524,2594
2022-07-11 00:00:00,2022-07-11 01:00:00,325,0,718,421,1464,2578
2022-07-11 01:00:00,2022-07-11 02:00:00,333,1,671,334,1339,2588
2022-07-11 02:00:00,2022-07-11 03:00:00,340,28,582,265,1215,2726
2022-07-11 03:00:00,2022-07-11 04:00:00,344,117,527,201,1189,3174
2022-07-11 04:00:00,2022-07-11 05:00:00,328,359,479,156,1322,3684
2022-07-11 05:00:00,2022-07-11 06:00:00,327,692,409,207,1635,4032
2022-07-11 06:00:00,2022-07-11 07:00:00,327,1023,311,134,1795,4239
2022-07-11 07:00:00,2022-07-11 08:00:00,325,1322,260,109,2016,4369
2022-07-11 08:00:00,2022-07-11 09:00:00,314,1472,274,141,2201,4422
2022-07-11 09:00:00,2022-07-11 10:00:00,328,1554,308,184,2374,4392
2022-07-11 10:00:00,2022-07-11 11:00:00,350,1554,286,201,2391,4368
2022-07-11 11:00:00,2022-07-11 12:00:00,377,1534,249,235,2395,4275
2022-07-11 12:00:00,2022-07-11 13:00:00,380,1508,219,266,2373,4167
2022-07-11 13:00:00,2022-07-11 14:00:00,381,1358,268,301,2308,4110
2022-07-11 14:00:00,2022-07-11 15:00:00,381,1070,302,389,2142,4219
2022-07-11 15:00:00,2022-07-11 16:00:00,379,705,252,372,1708,4101
2022-07-11 16:00:00,2022-07-11 17:00:00,378,333,139,339,1189,3903
2022-07-11 17:00:00,2022-07-11 18:00:00,377,106,110,297,890,3644
2022-07-11 18:00:00,2022-07-11 19:00:00,376,23,165,302,866,3488
2022-07-11 19:00:00,2022-07-11 20:00:00,377,1,218,317,913,3374
2022-07-11 20:00:00,2022-07-11 21:00:00,375,0,241,381,997,3204
2022-07-11 21:00:00,2022-07-11 22:00:00,368,0,204,376,948,3021
2022-07-11 22:00:00,2022-07-11 23:00:00,367,0,318,368,1053,2866
2022-07-11 23:00:00,2022-07-12 00:00:00,365,0,362,396,1123,2794
2022-07-12 00:00:00,2022-07-12 01:00:00,365,0,341,399,1105,2770
2022-07-12 01:00:00,2022-07-12 02:00:00,366,2,219,355,942,2773
2022-07-12 02:00:00,2022-07-12 03:00:00,364,28,172,340,904,2899
2022-07-12 03:00:00,2022-07-12 04:00:00,364,106,188,284,942,3259
2022-07-12 04:00:00,2022-07-12 05:00:00,365,275,225,256,1121,3717
2022-07-12 05:00:00,2022-07-12 06:00:00,376,543,206,298,1423,3994
2022-07-12 06:00:00,2022-07-12 07:00:00,379,973,224,378,1954,4193
2022-07-12 07:00:00,2022-07-12 08:00:00,370,1343,298,495,2506,4448
2022-07-12 08:00:00,2022-07-12 09:00:00,346,1521,430,650,2947,4455
2022-07-12 09:00:00,2022-07-12 10:00:00,345,1507,509,850,3211,4440
2022-07-12 10:00:00,2022-07-12 11:00:00,323,1391,480,1000,3194,4447
2022-07-12 11:00:00,2022-07-12 12:00:00,295,970,534,980,2779,3975
2022-07-12 12:00:00,2022-07-12 13:00:00,306,784,483,1042,2615,3774
2022-07-12 13:00:00,2022-07-12 14:00:00,310,632,564,921,2427,3780
2022-07-12 14:00:00,2022-07-12 15:00:00,340,467,671,823,2301,3933
2022-07-12 15:00:00,2022-07-12 16:00:00,356,297,651,793,2097,3923
2022-07-12 16:00:00,2022-07-12 17:00:00,404,159,785,738,2086,3812
2022-07-12 17:00:00,2022-07-12 18:00:00,396,64,893,670,2023,3630
2022-07-12 18:00:00,2022-07-12 19:00:00,402,12,869,595,1878,3475
2022-07-12 19:00:00,2022-07-12 20:00:00,347,0,946,550,1843,3376
2022-07-12 20:00:00,2022-07-12 21:00:00,172,0,721,548,1441,3237
2022-07-12 21:00:00,2022-07-12 22:00:00,93,0,669,516,1278,3066
2022-07-12 22:00:00,2022-07-12 23:00:00,93,0,625,552,1270,2930
2022-07-12 23:00:00,2022-07-13 00:00:00,94,0,662,518,1274,2836
2022-07-13 00:00:00,2022-07-13 01:00:00,94,0,658,510,1262,2774
2022-07-13 01:00:00,2022-07-13 02:00:00,94,0,648,545,1287,2772
2022-07-13 02:00:00,2022-07-13 03:00:00,94,16,652,558,1320,2844
2022-07-13 03:00:00,2022-07-13 04:00:00,95,73,671,557,1396,3255
2022-07-13 04:00:00,2022-07-13 05:00:00,102,208,631,560,1501,3675
2022-07-13 05:00:00,2022-07-13 06:00:00,100,348,693,691,1832,3889
2022-07-13 06:00:00,2022-07-13 07:00:00,95,516,722,1051,2384,3955
2022-07-13 07:00:00,2022-07-13 08:00:00,103,709,711,1350,2873,3937
2022-07-13 08:00:00,2022-07-13 09:00:00,101,922,809,1787,3619,3919
2022-07-13 09:00:00,2022-07-13 10:00:00,49,1047,981,2096,4173,4093
2022-07-13 10:00:00,2022-07-13 11:00:00,46,1050,1144,2016,4256,4244
2022-07-13 11:00:00,2022-07-13 12:00:00,37,1038,1253,2163,4491,4062
2022-07-13 12:00:00,2022-07-13 13:00:00,38,984,980,2234,4236,3858
2022-07-13 13:00:00,2022-07-13 14:00:00,35,941,1209,2199,4384,3871
2022-07-13 14:00:00,2022-07-13 15:00:00,63,757,1722,2683,5225,3848
2022-07-13 15:00:00,2022-07-13 16:00:00,49,498,1737,2438,4722,3880
2022-07-13 16:00:00,2022-07-13 17:00:00,55,242,1736,2508,4541,3624
2022-07-13 17:00:00,2022-07-13 18:00:00,85,85,1715,2294,4179,3331
2022-07-13 18:00:00,2022-07-13 19:00:00,87,19,1685,1941,3732,3261
2022-07-13 19:00:00,2022-07-13 20:00:00,65,1,1693,1802,3561,3224
2022-07-13 20:00:00,2022-07-13 21:00:00,88,0,1677,1699,3464,3013
2022-07-13 21:00:00,2022-07-13 22:00:00,69,0,1792,1814,3675,2871
2022-07-13 22:00:00,2022-07-13 23:00:00,38,0,1625,1810,3473,2777
2022-07-13 23:00:00,2022-07-14 00:00:00,76,0,1630,1760,3466,2660
2022-07-14 00:00:00,2022-07-14 01:00:00,41,0,1674,1559,3274,2649
2022-07-14 01:00:00,2022-07-14 02:00:00,42,0,1521,1556,3119,2622
2022-07-14 02:00:00,2022-07-14 03:00:00,87,20,1435,1397,2939,2741
2022-07-14 03:00:00,2022-07-14 04:00:00,87,87,1510,1343,3027,3122
2022-07-14 04:00:00,2022-07-14 05:00:00,89,241,1437,1469,3236,3502
2022-07-14 05:00:00,2022-07-14 06:00:00,96,423,1449,1783,3751,3750
2022-07-14 06:00:00,2022-07-14 07:00:00,109,540,1169,1874,3692,3794
2022-07-14 07:00:00,2022-07-14 08:00:00,101,624,1081,1872,3678,4049
2022-07-14 08:00:00,2022-07-14 09:00:00,99,713,1156,2105,4073,4057
2022-07-14 09:00:00,2022-07-14 10:00:00,49,783,1357,2319,4508,3941
2022-07-14 10:00:00,2022-07-14 11:00:00,45,744,1528,2476,4793,3880
2022-07-14 11:00:00,2022-07-14 12:00:00,53,706,1783,2537,5079,3786
2022-07-14 12:00:00,2022-07-14 13:00:00,44,702,1768,2783,5297,3744
2022-07-14 13:00:00,2022-07-14 14:00:00,41,679,1877,2670,5267,3799
2022-07-14 14:00:00,2022-07-14 15:00:00,42,545,1889,2414,4890,3940
2022-07-14 15:00:00,2022-07-14 16:00:00,53,380,1871,2374,4678,3983
2022-07-14 16:00:00,2022-07-14 17:00:00,42,209,1829,2241,4321,3791
2022-07-14 17:00:00,2022-07-14 18:00:00,36,89,1918,2097,4140,3595
2022-07-14 18:00:00,2022-07-14 19:00:00,38,19,1851,1876,3784,3490
2022-07-14 19:00:00,2022-07-14 20:00:00,50,1,1741,1898,3690,3344
2022-07-14 20:00:00,2022-07-14 21:00:00,63,0,1944,1867,3874,3196
2022-07-14 21:00:00,2022-07-14 22:00:00,41,0,1931,1822,3794,3033
2022-07-14 22:00:00,2022-07-14 23:00:00,33,0,1886,1818,3737,2868
2022-07-14 23:00:00,2022-07-15 00:00:00,43,0,1927,1759,3729,2797
2022-07-15 00:00:00,2022-07-15 01:00:00,61,0,1904,1611,3576,2759
2022-07-15 01:00:00,2022-07-15 02:00:00,48,0,1812,1472,3332,2712
2022-07-15 02:00:00,2022-07-15 03:00:00,34,20,1716,1338,3108,2808
2022-07-15 03:00:00,2022-07-15 04:00:00,44,89,2006,1663,3802,2990
2022-07-15 04:00:00,2022-07-15 05:00:00,51,230,1973,1838,4092,3326
2022-07-15 05:00:00,2022-07-15 06:00:00,35,443,1766,2100,4344,3578
2022-07-15 06:00:00,2022-07-15 07:00:00,53,611,1780,2227,4671,3672
2022-07-15 07:00:00,2022-07-15 08:00:00,54,737,1746,2289,4826,3717
2022-07-15 08:00:00,2022-07-15 09:00:00,61,848,1561,2395,4865,3714
2022-07-15 09:00:00,2022-07-15 10:00:00,56,871,1551,2437,4915,3644
2022-07-15 10:00:00,2022-07-15 11:00:00,35,860,1535,2386,4816,3647
2022-07-15 11:00:00,2022-07-15 12:00:00,36,839,1415,2494,4784,3534
2022-07-15 12:00:00,2022-07-15 13:00:00,36,767,1399,2212,4414,3557
2022-07-15 13:00:00,2022-07-15 14:00:00,40,638,1429,2300,4407,3529
2022-07-15 14:00:00,2022-07-15 15:00:00,95,510,1486,1996,4087,3631
2022-07-15 15:00:00,2022-07-15 16:00:00,201,364,1468,1991,4024,3562
2022-07-15 16:00:00,2022-07-15 17:00:00,325,195,1568,1831,3919,3346
2022-07-15 17:00:00,2022-07-15 18:00:00,416,67,1572,1371,3426,3204
2022-07-15 18:00:00,2022-07-15 19:00:00,407,14,1306,1187,2914,3100
2022-07-15 19:00:00,2022-07-15 20:00:00,408,0,1191,1149,2748,3005
2022-07-15 20:00:00,2022-07-15 21:00:00,439,0,1253,1126,2818,2817
2022-07-15 21:00:00,2022-07-15 22:00:00,332,0,1166,1141,2639,2640
2022-07-15 22:00:00,2022-07-15 23:00:00,172,0,1193,1229,2594,2527
2022-07-15 23:00:00,2022-07-16 00:00:00,57,0,1683,1334,3074,2425
2022-07-16 00:00:00,2022-07-16 01:00:00,43,0,1726,1493,3262,2394
2022-07-16 01:00:00,2022-07-16 02:00:00,44,0,1467,1618,3129,2338
2022-07-16 02:00:00,2022-07-16 03:00:00,36,17,1580,1737,3370,2340
2022-07-16 03:00:00,2022-07-16 04:00:00,34,85,1843,1680,3642,2563
2022-07-16 04:00:00,2022-07-16 05:00:00,35,240,1939,1757,3971,2744
2022-07-16 05:00:00,2022-07-16 06:00:00,35,463,1957,2150,4605,2912
2022-07-16 06:00:00,2022-07-16 07:00:00,35,661,1888,2431,5015,3036
2022-07-16 07:00:00,2022-07-16 08:00:00,36,803,1776,1928,4543,3310
2022-07-16 08:00:00,2022-07-16 09:00:00,37,943,1554,1558,4092,3424
2022-07-16 09:00:00,2022-07-16 10:00:00,37,1039,1485,1777,4338,3191
2022-07-16 10:00:00,2022-07-16 11:00:00,36,1017,237,1750,3040,3192
2022-07-16 11:00:00,2022-07-16 12:00:00,36,1016,116,1846,3014,3076
2022-07-16 12:00:00,2022-07-16 13:00:00,36,989,187,1870,3082,2971
2022-07-16 13:00:00,2022-07-16 14:00:00,37,849,1045,2060,3991,2936
2022-07-16 14:00:00,2022-07-16 15:00:00,47,676,1157,2294,4174,3130
2022-07-16 15:00:00,2022-07-16 16:00:00,52,440,1256,2361,4109,3138
2022-07-16 16:00:00,2022-07-16 17:00:00,45,216,1437,2304,4002,3062
2022-07-16 17:00:00,2022-07-16 18:00:00,46,74,1633,2180,3933,2953
2022-07-16 18:00:00,2022-07-16 19:00:00,64,14,1886,1817,3781,2840
2022-07-16 19:00:00,2022-07-16 20:00:00,98,0,1863,1685,3646,2816
2022-07-16 20:00:00,2022-07-16 21:00:00,99,0,1797,1626,3522,2682
2022-07-16 21:00:00,2022-07-16 22:00:00,90,0,1595,1550,3235,2520
2022-07-16 22:00:00,2022-07-16 23:00:00,90,0,1378,1369,2837,2404
2022-07-16 23:00:00,2022-07-17 00:00:00,89,0,1347,1366,2802,2371
2022-07-17 00:00:00,2022-07-17 01:00:00,89,0,1367,1534,2990,2316
2022-07-17 01:00:00,2022-07-17 02:00:00,83,0,1411,1612,3106,2311
2022-07-17 02:00:00,2022-07-17 03:00:00,89,16,1378,1584,3067,2233
2022-07-17 03:00:00,2022-07-17 04:00:00,89,75,1154,1417,2735,2324
2022-07-17 04:00:00,2022-07-17 05:00:00,89,167,1011,1353,2620,2514
2022-07-17 05:00:00,2022-07-17 06:00:00,88,344,1031,1480,2943,2733
2022-07-17 06:00:00,2022-07-17 07:00:00,62,492,1079,1662,3295,2805
2022-07-17 07:00:00,2022-07-17 08:00:00,35,686,1044,1877,3642,2846
2022-07-17 08:00:00,2022-07-17 09:00:00,37,827,1060,1793,3717,2926
2022-07-17 09:00:00,2022-07-17 10:00:00,66,952,1038,1381,3437,3242
2022-07-17 10:00:00,2022-07-17 11:00:00,131,980,738,1205,3054,3293
2022-07-17 11:00:00,2022-07-17 12:00:00,157,999,755,1113,3024,3208
2022-07-17 12:00:00,2022-07-17 13:00:00,172,971,519,1414,3076,3133
2022-07-17 13:00:00,2022-07-17 14:00:00,296,721,879,1593,3489,2961
2022-07-17 14:00:00,2022-07-17 15:00:00,382,508,921,1551,3362,3261
2022-07-17 15:00:00,2022-07-17 16:00:00,424,315,858,1422,3019,3388
2022-07-17 16:00:00,2022-07-17 17:00:00,442,134,679,1206,2461,3268
2022-07-17 17:00:00,2022-07-17 18:00:00,480,60,745,940,2225,3156
2022-07-17 18:00:00,2022-07-17 19:00:00,528,12,780,714,2034,3100
2022-07-17 19:00:00,2022-07-17 20:00:00,591,0,703,548,1842,3036
2022-07-17 20:00:00,2022-07-17 21:00:00,652,0,815,536,2003,2854
2022-07-17 21:00:00,2022-07-17 22:00:00,623,0,767,470,1860,2707
2022-07-17 22:00:00,2022-07-17 23:00:00,599,0,657,444,1700,2580
2022-07-17 23:00:00,2022-07-18 00:00:00,551,0,574,485,1610,2476
2022-07-18 00:00:00,2022-07-18 01:00:00,576,0,535,434,1545,2480
2022-07-18 01:00:00,2022-07-18 02:00:00,616,0,602,463,1681,2474
2022-07-18 02:00:00,2022-07-18 03:00:00,592,7,624,448,1671,2600
2022-07-18 03:00:00,2022-07-18 04:00:00,662,44,737,452,1895,2898
2022-07-18 04:00:00,2022-07-18 05:00:00,671,93,811,538,2113,3269
2022-07-18 05:00:00,2022-07-18 06:00:00,664,151,867,631,2313,3565
2022-07-18 06:00:00,2022-07-18 07:00:00,659,238,905,827,2629,3673
2022-07-18 07:00:00,2022-07-18 08:00:00,645,381,966,1072,3064,3718
2022-07-18 08:00:00,2022-07-18 09:00:00,646,464,958,1319,3387,3681
2022-07-18 09:00:00,2022-07-18 10:00:00,645,614,1208,1348,3815,3633
2022-07-18 10:00:00,2022-07-18 11:00:00,622,776,1277,1278,3953,3674
2022-07-18 11:00:00,2022-07-18 12:00:00,568,901,1123,1253,3845,3601
2022-07-18 12:00:00,2022-07-18 13:00:00,398,805,973,1154,3330,3463
2022-07-18 13:00:00,2022-07-18 14:00:00,565,825,1011,1127,3528,3488
2022-07-18 14:00:00,2022-07-18 15:00:00,681,640,1035,972,3328,3650
2022-07-18 15:00:00,2022-07-18 16:00:00,684,450,765,817,2716,3678
2022-07-18 16:00:00,2022-07-18 17:00:00,687,231,817,626,2361,3553
2022-07-18 17:00:00,2022-07-18 18:00:00,674,81,834,489,2078,3406
2022-07-18 18:00:00,2022-07-18 19:00:00,685,16,765,469,1935,3244
2022-07-18 19:00:00,2022-07-18 20:00:00,688,1,663,554,1906,3192
2022-07-18 20:00:00,2022-07-18 21:00:00,681,0,700,531,1912,3002
2022-07-18 21:00:00,2022-07-18 22:00:00,617,0,762,436,1815,2819
2022-07-18 22:00:00,2022-07-18 23:00:00,329,0,655,384,1368,2710
2022-07-18 23:00:00,2022-07-19 00:00:00,346,0,456,300,1102,2664
2022-07-19 00:00:00,2022-07-19 01:00:00,459,0,336,259,1054,2612
2022-07-19 01:00:00,2022-07-19 02:00:00,632,0,220,174,1026,2643
2022-07-19 02:00:00,2022-07-19 03:00:00,641,17,122,121,901,2723
2022-07-19 03:00:00,2022-07-19 04:00:00,647,84,82,106,919,3008
2022-07-19 04:00:00,2022-07-19 05:00:00,364,237,65,62,728,3434
2022-07-19 05:00:00,2022-07-19 06:00:00,313,464,80,48,905,3700
2022-07-19 06:00:00,2022-07-19 07:00:00,208,711,68,51,1038,3844
2022-07-19 07:00:00,2022-07-19 08:00:00,186,929,72,66,1253,3887
2022-07-19 08:00:00,2022-07-19 09:00:00,369,1086,43,58,1556,3927
2022-07-19 09:00:00,2022-07-19 10:00:00,389,1157,52,74,1672,3894
2022-07-19 10:00:00,2022-07-19 11:00:00,416,1175,103,99,1793,3828
2022-07-19 11:00:00,2022-07-19 12:00:00,499,1154,92,105,1850,3744
2022-07-19 12:00:00,2022-07-19 13:00:00,526,1065,115,121,1827,3690
2022-07-19 13:00:00,2022-07-19 14:00:00,496,908,152,121,1677,3696
2022-07-19 14:00:00,2022-07-19 15:00:00,623,684,184,110,1601,3799
2022-07-19 15:00:00,2022-07-19 16:00:00,651,424,203,93,1371,3785
2022-07-19 16:00:00,2022-07-19 17:00:00,663,204,261,74,1202,3672
2022-07-19 17:00:00,2022-07-19 18:00:00,663,71,245,100,1079,3510
2022-07-19 18:00:00,2022-07-19 19:00:00,655,13,335,248,1251,3358
2022-07-19 19:00:00,2022-07-19 20:00:00,633,0,550,510,1693,3252
2022-07-19 20:00:00,2022-07-19 21:00:00,614,0,857,805,2276,3028
2022-07-19 21:00:00,2022-07-19 22:00:00,449,0,1008,937,2394,2850
2022-07-19 22:00:00,2022-07-19 23:00:00,303,0,1002,918,2223,2786
2022-07-19 23:00:00,2022-07-20 00:00:00,282,0,987,1152,2421,2616
2022-07-20 00:00:00,2022-07-20 01:00:00,296,0,935,1107,2338,2687
2022-07-20 01:00:00,2022-07-20 02:00:00,292,0,764,838,1894,2771
2022-07-20 02:00:00,2022-07-20 03:00:00,296,15,474,805,1590,2855
2022-07-20 03:00:00,2022-07-20 04:00:00,280,82,467,769,1598,3136
2022-07-20 04:00:00,2022-07-20 05:00:00,282,228,681,960,2151,3391
2022-07-20 05:00:00,2022-07-20 06:00:00,299,472,1141,883,2795,3604
2022-07-20 06:00:00,2022-07-20 07:00:00,541,726,1324,808,3399,3609
2022-07-20 07:00:00,2022-07-20 08:00:00,622,952,1325,807,3706,3704
2022-07-20 08:00:00,2022-07-20 09:00:00,483,1100,1393,783,3759,3697
2022-07-20 09:00:00,2022-07-20 10:00:00,460,1172,1418,805,3855,3679
2022-07-20 10:00:00,2022-07-20 11:00:00,514,1191,1327,884,3916,3659
2022-07-20 11:00:00,2022-07-20 12:00:00,293,1163,1276,1023,3755,3635
2022-07-20 12:00:00,2022-07-20 13:00:00,293,1087,1127,1253,3760,3533
2022-07-20 13:00:00,2022-07-20 14:00:00,541,939,1034,1129,3643,3508
2022-07-20 14:00:00,2022-07-20 15:00:00,578,706,1248,923,3455,3617
2022-07-20 15:00:00,2022-07-20 16:00:00,610,448,1492,898,3448,3635
2022-07-20 16:00:00,2022-07-20 17:00:00,340,210,1548,794,2892,3587
2022-07-20 17:00:00,2022-07-20 18:00:00,372,74,1644,885,2975,3479
2022-07-20 18:00:00,2022-07-20 19:00:00,258,12,1591,912,2773,3473
2022-07-20 19:00:00,2022-07-20 20:00:00,367,0,1402,773,2542,3362
2022-07-20 20:00:00,2022-07-20 21:00:00,306,0,1124,402,1832,3274
2022-07-20 21:00:00,2022-07-20 22:00:00,392,0,722,370,1484,2963
2022-07-20 22:00:00,2022-07-20 23:00:00,312,0,471,262,1045,2930
2022-07-20 23:00:00,2022-07-21 00:00:00,326,0,408,322,1056,2785
2022-07-21 00:00:00,2022-07-21 01:00:00,278,0,466,234,978,2814
2022-07-21 01:00:00,2022-07-21 02:00:00,276,0,487,256,1019,2809
2022-07-21 02:00:00,2022-07-21 03:00:00,288,15,359,180,842,2877
2022-07-21 03:00:00,2022-07-21 04:00:00,291,71,280,144,786,3135
2022-07-21 04:00:00,2022-07-21 05:00:00,319,172,242,134,867,3482
2022-07-21 05:00:00,2022-07-21 06:00:00,604,316,371,188,1479,3702
2022-07-21 06:00:00,2022-07-21 07:00:00,606,491,494,188,1779,3857
2022-07-21 07:00:00,2022-07-21 08:00:00,386,609,644,205,1844,3896
2022-07-21 08:00:00,2022-07-21 09:00:00,335,750,523,268,1876,3938
2022-07-21 09:00:00,2022-07-21 10:00:00,337,821,869,379,2406,3777
2022-07-21 10:00:00,2022-07-21 11:00:00,336,830,1080,633,2879,3901
2022-07-21 11:00:00,2022-07-21 12:00:00,332,754,1049,741,2876,3771
2022-07-21 12:00:00,2022-07-21 13:00:00,329,549,1137,831,2846,3595
2022-07-21 13:00:00,2022-07-21 14:00:00,329,466,1176,933,2904,3630
2022-07-21 14:00:00,2022-07-21 15:00:00,335,422,1134,1026,2917,3708
2022-07-21 15:00:00,2022-07-21 16:00:00,339,278,903,1040,2560,3721
2022-07-21 16:00:00,2022-07-21 17:00:00,341,144,786,938,2209,3614
2022-07-21 17:00:00,2022-07-21 18:00:00,331,46,767,814,1958,3496
2022-07-21 18:00:00,2022-07-21 19:00:00,324,7,1219,734,2284,3352
2022-07-21 19:00:00,2022-07-21 20:00:00,256,0,1048,727,2031,3208
2022-07-21 20:00:00,2022-07-21 21:00:00,433,0,873,772,2078,2995
2022-07-21 21:00:00,2022-07-21 22:00:00,363,0,951,825,2139,2821
2022-07-21 22:00:00,2022-07-21 23:00:00,331,0,970,891,2192,2699
2022-07-21 23:00:00,2022-07-22 00:00:00,328,0,955,1035,2318,2608
2022-07-22 00:00:00,2022-07-22 01:00:00,380,0,982,1196,2558,2556
2022-07-22 01:00:00,2022-07-22 02:00:00,403,0,1100,1279,2782,2573
2022-07-22 02:00:00,2022-07-22 03:00:00,388,6,1152,1300,2846,2638
2022-07-22 03:00:00,2022-07-22 04:00:00,445,50,1170,1335,3000,2877
2022-07-22 04:00:00,2022-07-22 05:00:00,553,111,1141,1396,3201,3193
2022-07-22 05:00:00,2022-07-22 06:00:00,593,159,1086,1434,3272,3464
2022-07-22 06:00:00,2022-07-22 07:00:00,560,251,1062,1438,3311,3592
2022-07-22 07:00:00,2022-07-22 08:00:00,510,332,1097,1417,3356,3647
2022-07-22 08:00:00,2022-07-22 09:00:00,502,433,1061,1437,3433,3576
2022-07-22 09:00:00,2022-07-22 10:00:00,491,502,1020,1506,3519,3524
2022-07-22 10:00:00,2022-07-22 11:00:00,479,515,1149,1533,3676,3546
2022-07-22 11:00:00,2022-07-22 12:00:00,582,527,1191,1479,3779,3498
2022-07-22 12:00:00,2022-07-22 13:00:00,657,459,1200,1406,3722,3407
2022-07-22 13:00:00,2022-07-22 14:00:00,640,393,1292,1309,3634,3430
2022-07-22 14:00:00,2022-07-22 15:00:00,410,268,1306,1191,3175,3562
2022-07-22 15:00:00,2022-07-22 16:00:00,397,166,1268,1091,2922,3586
2022-07-22 16:00:00,2022-07-22 17:00:00,634,83,1238,997,2952,3410
2022-07-22 17:00:00,2022-07-22 18:00:00,664,29,1172,828,2693,3254
2022-07-22 18:00:00,2022-07-22 19:00:00,671,3,1023,666,2363,3132
2022-07-22 19:00:00,2022-07-22 20:00:00,676,0,911,598,2185,3066
2022-07-22 20:00:00,2022-07-22 21:00:00,667,0,875,562,2104,2893
2022-07-22 21:00:00,2022-07-22 22:00:00,640,0,743,517,1900,2714
2022-07-22 22:00:00,2022-07-22 23:00:00,681,0,642,475,1798,2573
2022-07-22 23:00:00,2022-07-23 00:00:00,678,0,584,444,1706,2470
2022-07-23 00:00:00,2022-07-23 01:00:00,659,0,549,383,1591,2457
2022-07-23 01:00:00,2022-07-23 02:00:00,667,0,517,367,1551,2452
2022-07-23 02:00:00,2022-07-23 03:00:00,667,2,512,395,1576,2443
2022-07-23 03:00:00,2022-07-23 04:00:00,680,20,618,466,1784,2505
2022-07-23 04:00:00,2022-07-23 05:00:00,686,59,660,560,1965,2730
2022-07-23 05:00:00,2022-07-23 06:00:00,683,119,731,661,2194,2970
2022-07-23 06:00:00,2022-07-23 07:00:00,683,155,738,783,2359,3164
2022-07-23 07:00:00,2022-07-23 08:00:00,684,188,776,838,2486,3263
2022-07-23 08:00:00,2022-07-23 09:00:00,641,213,742,868,2464,3283
2022-07-23 09:00:00,2022-07-23 10:00:00,602,270,773,864,2509,3236
2022-07-23 10:00:00,2022-07-23 11:00:00,556,287,800,891,2534,3257
2022-07-23 11:00:00,2022-07-23 12:00:00,550,308,790,936,2584,3283
2022-07-23 12:00:00,2022-07-23 13:00:00,570,314,788,973,2645,3313
2022-07-23 13:00:00,2022-07-23 14:00:00,636,284,763,1266,2949,3320
2022-07-23 14:00:00,2022-07-23 15:00:00,638,262,760,1293,2953,3363
2022-07-23 15:00:00,2022-07-23 16:00:00,612,193,931,1237,2973,3408
2022-07-23 16:00:00,2022-07-23 17:00:00,554,112,1134,1129,2929,3271
2022-07-23 17:00:00,2022-07-23 18:00:00,599,49,1195,912,2755,3111
2022-07-23 18:00:00,2022-07-23 19:00:00,585,8,1114,753,2460,3018
2022-07-23 19:00:00,2022-07-23 20:00:00,555,0,992,642,2189,2970
2022-07-23 20:00:00,2022-07-23 21:00:00,529,0,875,506,1910,2810
2022-07-23 21:00:00,2022-07-23 22:00:00,527,0,709,415,1651,2656
2022-07-23 22:00:00,2022-07-23 23:00:00,617,0,598,345,1560,2558
2022-07-23 23:00:00,2022-07-24 00:00:00,627,0,485,350,1462,2480
2022-07-24 00:00:00,2022-07-24 01:00:00,607,0,422,383,1412,2427
2022-07-24 01:00:00,2022-07-24 02:00:00,615,0,467,421,1503,2406
2022-07-24 02:00:00,2022-07-24 03:00:00,613,15,502,461,1591,2349
2022-07-24 03:00:00,2022-07-24 04:00:00,615,83,590,478,1766,2433
2022-07-24 04:00:00,2022-07-24 05:00:00,611,206,606,399,1822,2565
2022-07-24 05:00:00,2022-07-24 06:00:00,593,362,665,483,2103,2758
2022-07-24 06:00:00,2022-07-24 07:00:00,532,507,692,624,2355,2921
2022-07-24 07:00:00,2022-07-24 08:00:00,403,667,806,849,2725,3025
2022-07-24 08:00:00,2022-07-24 09:00:00,267,709,885,1010,2871,3014
2022-07-24 09:00:00,2022-07-24 10:00:00,245,750,1005,1223,3223,3138
2022-07-24 10:00:00,2022-07-24 11:00:00,245,692,1017,1411,3365,3177
2022-07-24 11:00:00,2022-07-24 12:00:00,224,604,1013,1511,3352,3256
2022-07-24 12:00:00,2022-07-24 13:00:00,249,555,912,1625,3341,3195
2022-07-24 13:00:00,2022-07-24 14:00:00,293,393,911,1633,3230,3193
2022-07-24 14:00:00,2022-07-24 15:00:00,523,289,863,1532,3207,3395
2022-07-24 15:00:00,2022-07-24 16:00:00,634,182,840,1243,2899,3392
2022-07-24 16:00:00,2022-07-24 17:00:00,635,107,872,1000,2614,3270
2022-07-24 17:00:00,2022-07-24 18:00:00,633,41,868,807,2349,3147
2022-07-24 18:00:00,2022-07-24 19:00:00,611,5,918,699,2233,3099
2022-07-24 19:00:00,2022-07-24 20:00:00,612,0,886,586,2084,3039
2022-07-24 20:00:00,2022-07-24 21:00:00,624,0,913,557,2094,2822
2022-07-24 21:00:00,2022-07-24 22:00:00,614,0,1054,612,2280,2650
2022-07-24 22:00:00,2022-07-24 23:00:00,394,0,1381,660,2435,2650
2022-07-24 23:00:00,2022-07-25 00:00:00,323,0,1570,636,2529,2602
2022-07-25 00:00:00,2022-07-25 01:00:00,292,0,1584,856,2732,2589
2022-07-25 01:00:00,2022-07-25 02:00:00,288,0,1587,1126,3001,2645
2022-07-25 02:00:00,2022-07-25 03:00:00,288,4,1521,1152,2965,2677
2022-07-25 03:00:00,2022-07-25 04:00:00,283,45,1469,1193,2990,2825
2022-07-25 04:00:00,2022-07-25 05:00:00,278,130,1342,1227,2977,3167
2022-07-25 05:00:00,2022-07-25 06:00:00,308,201,1204,1183,2896,3450
2022-07-25 06:00:00,2022-07-25 07:00:00,403,267,1240,1152,3062,3635
2022-07-25 07:00:00,2022-07-25 08:00:00,486,365,912,1082,2845,3782
2022-07-25 08:00:00,2022-07-25 09:00:00,505,488,793,902,2688,3789
2022-07-25 09:00:00,2022-07-25 10:00:00,470,573,673,789,2505,3795
2022-07-25 10:00:00,2022-07-25 11:00:00,452,601,805,754,2612,3853
2022-07-25 11:00:00,2022-07-25 12:00:00,540,574,749,775,2638,3736
2022-07-25 12:00:00,2022-07-25 13:00:00,342,546,731,787,2406,3677
2022-07-25 13:00:00,2022-07-25 14:00:00,377,437,535,954,2303,3652
2022-07-25 14:00:00,2022-07-25 15:00:00,321,401,660,1101,2483,3875
2022-07-25 15:00:00,2022-07-25 16:00:00,301,275,1090,1279,2945,3888
2022-07-25 16:00:00,2022-07-25 17:00:00,317,120,1032,1132,2601,3689
2022-07-25 17:00:00,2022-07-25 18:00:00,298,47,1086,915,2346,3457
2022-07-25 18:00:00,2022-07-25 19:00:00,303,8,736,772,1819,3269
2022-07-25 19:00:00,2022-07-25 20:00:00,302,0,781,786,1869,3159
2022-07-25 20:00:00,2022-07-25 21:00:00,497,0,967,834,2298,2892
2022-07-25 21:00:00,2022-07-25 22:00:00,429,0,1023,877,2329,2673
2022-07-25 22:00:00,2022-07-25 23:00:00,347,0,1060,956,2363,2541
2022-07-25 23:00:00,2022-07-26 00:00:00,279,0,1524,1172,2975,2460
2022-07-26 00:00:00,2022-07-26 01:00:00,151,0,1545,1350,3046,2438
2022-07-26 01:00:00,2022-07-26 02:00:00,144,0,1544,1610,3298,2441
2022-07-26 02:00:00,2022-07-26 03:00:00,144,7,1814,1815,3780,2510
2022-07-26 03:00:00,2022-07-26 04:00:00,145,60,1792,1967,3964,2768
2022-07-26 04:00:00,2022-07-26 05:00:00,145,167,1804,2118,4234,3197
2022-07-26 05:00:00,2022-07-26 06:00:00,139,329,1792,2391,4651,3407
2022-07-26 06:00:00,2022-07-26 07:00:00,134,718,1800,2915,5567,3930
2022-07-26 07:00:00,2022-07-26 08:00:00,123,883,1757,2665,5428,4204
2022-07-26 08:00:00,2022-07-26 09:00:00,112,1086,1780,2713,5691,4250
2022-07-26 09:00:00,2022-07-26 10:00:00,111,1181,1783,2690,5765,4162
2022-07-26 10:00:00,2022-07-26 11:00:00,115,1139,1775,2621,5650,4171
2022-07-26 11:00:00,2022-07-26 12:00:00,109,1086,1316,2964,5475,4145
2022-07-26 12:00:00,2022-07-26 13:00:00,104,1065,1343,2596,5108,4101
2022-07-26 13:00:00,2022-07-26 14:00:00,102,841,1447,2394,4784,3975
2022-07-26 14:00:00,2022-07-26 15:00:00,69,649,1391,2307,4416,4065
2022-07-26 15:00:00,2022-07-26 16:00:00,69,446,1338,2253,4106,3984
2022-07-26 16:00:00,2022-07-26 17:00:00,70,224,1478,2715,4487,3720
2022-07-26 17:00:00,2022-07-26 18:00:00,68,73,1754,2710,4605,3514
2022-07-26 18:00:00,2022-07-26 19:00:00,75,9,1950,2796,4830,3382
2022-07-26 19:00:00,2022-07-26 20:00:00,82,0,1991,2753,4826,3273
2022-07-26 20:00:00,2022-07-26 21:00:00,83,0,1926,2562,4571,3117
2022-07-26 21:00:00,2022-07-26 22:00:00,88,0,1979,2554,4621,2972
2022-07-26 22:00:00,2022-07-26 23:00:00,84,0,1812,2594,4490,2821
2022-07-26 23:00:00,2022-07-27 00:00:00,48,0,1877,2535,4460,2773
2022-07-27 00:00:00,2022-07-27 01:00:00,23,0,1824,2441,4288,2758
2022-07-27 01:00:00,2022-07-27 02:00:00,23,1,1986,2337,4347,2758
2022-07-27 02:00:00,2022-07-27 03:00:00,24,7,2007,2354,4392,2796
2022-07-27 03:00:00,2022-07-27 04:00:00,24,61,1914,2263,4262,3092
2022-07-27 04:00:00,2022-07-27 05:00:00,32,169,2018,2604,4823,3417
2022-07-27 05:00:00,2022-07-27 06:00:00,33,327,2000,2548,4908,3713
2022-07-27 06:00:00,2022-07-27 07:00:00,32,515,1984,2488,5019,3933
2022-07-27 07:00:00,2022-07-27 08:00:00,19,646,1893,2435,4993,4014
2022-07-27 08:00:00,2022-07-27 09:00:00,29,794,1867,2414,5104,4009
2022-07-27 09:00:00,2022-07-27 10:00:00,16,901,1729,2265,4911,4101
2022-07-27 10:00:00,2022-07-27 11:00:00,60,913,1792,2153,4918,4089
2022-07-27 11:00:00,2022-07-27 12:00:00,102,875,1547,1754,4278,4016
2022-07-27 12:00:00,2022-07-27 13:00:00,107,846,1658,1903,4514,3868
2022-07-27 13:00:00,2022-07-27 14:00:00,147,801,1434,1916,4298,3837
2022-07-27 14:00:00,2022-07-27 15:00:00,177,638,1606,1742,4163,4022
2022-07-27 15:00:00,2022-07-27 16:00:00,184,447,1535,1982,4148,3889
2022-07-27 16:00:00,2022-07-27 17:00:00,349,230,1456,1936,3971,3627
2022-07-27 17:00:00,2022-07-27 18:00:00,473,77,1398,1665,3613,3419
2022-07-27 18:00:00,2022-07-27 19:00:00,474,9,1463,1408,3354,3294
2022-07-27 19:00:00,2022-07-27 20:00:00,498,1,1317,1248,3064,3201
2022-07-27 20:00:00,2022-07-27 21:00:00,543,0,1119,1110,2772,2984
2022-07-27 21:00:00,2022-07-27 22:00:00,562,0,919,1039,2520,2812
2022-07-27 22:00:00,2022-07-27 23:00:00,602,0,799,932,2333,2680
2022-07-27 23:00:00,2022-07-28 00:00:00,611,0,599,866,2076,2622
2022-07-28 00:00:00,2022-07-28 01:00:00,629,0,548,780,1957,2596
2022-07-28 01:00:00,2022-07-28 02:00:00,629,0,463,629,1721,2615
2022-07-28 02:00:00,2022-07-28 03:00:00,631,9,399,494,1533,2665
2022-07-28 03:00:00,2022-07-28 04:00:00,631,78,408,376,1493,2954
2022-07-28 04:00:00,2022-07-28 05:00:00,631,236,294,337,1498,3369
2022-07-28 05:00:00,2022-07-28 06:00:00,630,458,172,401,1661,3643
2022-07-28 06:00:00,2022-07-28 07:00:00,633,742,155,340,1870,3828
2022-07-28 07:00:00,2022-07-28 08:00:00,630,951,133,273,1987,3952
2022-07-28 08:00:00,2022-07-28 09:00:00,630,1141,86,227,2084,3968
2022-07-28 09:00:00,2022-07-28 10:00:00,632,1284,69,221,2206,3918
2022-07-28 10:00:00,2022-07-28 11:00:00,603,1380,62,203,2248,3924
2022-07-28 11:00:00,2022-07-28 12:00:00,371,1418,39,194,2022,3877
2022-07-28 12:00:00,2022-07-28 13:00:00,620,1399,28,189,2236,3850
2022-07-28 13:00:00,2022-07-28 14:00:00,642,1288,21,193,2144,3841
2022-07-28 14:00:00,2022-07-28 15:00:00,641,1025,33,191,1890,3943
2022-07-28 15:00:00,2022-07-28 16:00:00,639,653,38,222,1552,3889
2022-07-28 16:00:00,2022-07-28 17:00:00,641,293,14,245,1193,3682
2022-07-28 17:00:00,2022-07-28 18:00:00,642,82,7,198,929,3471
2022-07-28 18:00:00,2022-07-28 19:00:00,639,11,12,164,826,3334
2022-07-28 19:00:00,2022-07-28 20:00:00,636,0,10,166,812,3252
2022-07-28 20:00:00,2022-07-28 21:00:00,633,0,2,162,797,3045
2022-07-28 21:00:00,2022-07-28 22:00:00,628,0,3,154,785,2875
2022-07-28 22:00:00,2022-07-28 23:00:00,633,0,4,145,782,2759
2022-07-28 23:00:00,2022-07-29 00:00:00,633,0,7,127,767,2684
2022-07-29 00:00:00,2022-07-29 01:00:00,632,0,8,110,750,2637
2022-07-29 01:00:00,2022-07-29 02:00:00,632,0,17,121,770,2649
2022-07-29 02:00:00,2022-07-29 03:00:00,632,12,20,136,800,2711
2022-07-29 03:00:00,2022-07-29 04:00:00,632,94,24,130,880,2982
2022-07-29 04:00:00,2022-07-29 05:00:00,636,303,19,89,1047,3382
2022-07-29 05:00:00,2022-07-29 06:00:00,627,617,19,59,1322,3733
2022-07-29 06:00:00,2022-07-29 07:00:00,633,908,36,69,1646,3942
2022-07-29 07:00:00,2022-07-29 08:00:00,632,1189,42,81,1944,4075
2022-07-29 08:00:00,2022-07-29 09:00:00,631,1309,75,119,2134,4073
2022-07-29 09:00:00,2022-07-29 10:00:00,637,1414,131,169,2351,4017
2022-07-29 10:00:00,2022-07-29 11:00:00,632,1421,186,203,2442,3967
2022-07-29 11:00:00,2022-07-29 12:00:00,616,1405,239,242,2502,3902
2022-07-29 12:00:00,2022-07-29 13:00:00,645,1336,290,310,2581,3834
2022-07-29 13:00:00,2022-07-29 14:00:00,645,1203,363,373,2584,3819
2022-07-29 14:00:00,2022-07-29 15:00:00,642,940,427,422,2431,3911
2022-07-29 15:00:00,2022-07-29 16:00:00,642,563,429,437,2071,3846
2022-07-29 16:00:00,2022-07-29 17:00:00,644,279,456,360,1739,3573
2022-07-29 17:00:00,2022-07-29 18:00:00,643,91,472,290,1496,3376
2022-07-29 18:00:00,2022-07-29 19:00:00,644,11,515,308,1478,3261
2022-07-29 19:00:00,2022-07-29 20:00:00,643,1,482,335,1461,3197
2022-07-29 20:00:00,2022-07-29 21:00:00,641,0,418,357,1416,3021
2022-07-29 21:00:00,2022-07-29 22:00:00,634,0,376,327,1337,2846
2022-07-29 22:00:00,2022-07-29 23:00:00,634,0,312,291,1237,2729
2022-07-29 23:00:00,2022-07-30 00:00:00,633,0,270,263,1166,2634
2022-07-30 00:00:00,2022-07-30 01:00:00,634,0,250,247,1131,2562
2022-07-30 01:00:00,2022-07-30 02:00:00,622,0,236,232,1090,2566
2022-07-30 02:00:00,2022-07-30 03:00:00,573,10,254,253,1090,2529
2022-07-30 03:00:00,2022-07-30 04:00:00,603,81,303,318,1305,2621
2022-07-30 04:00:00,2022-07-30 05:00:00,625,242,345,304,1516,2874
2022-07-30 05:00:00,2022-07-30 06:00:00,633,446,355,211,1645,3146
2022-07-30 06:00:00,2022-07-30 07:00:00,636,723,401,189,1949,3393
2022-07-30 07:00:00,2022-07-30 08:00:00,635,880,392,212,2119,3527
2022-07-30 08:00:00,2022-07-30 09:00:00,634,980,369,227,2210,3565
2022-07-30 09:00:00,2022-07-30 10:00:00,633,1094,332,248,2307,3602
2022-07-30 10:00:00,2022-07-30 11:00:00,618,1107,336,306,2367,3556
2022-07-30 11:00:00,2022-07-30 12:00:00,616,1018,363,341,2338,3486
2022-07-30 12:00:00,2022-07-30 13:00:00,633,897,379,355,2264,3439
2022-07-30 13:00:00,2022-07-30 14:00:00,636,788,376,402,2202,3458
2022-07-30 14:00:00,2022-07-30 15:00:00,638,697,331,410,2076,3646
2022-07-30 15:00:00,2022-07-30 16:00:00,639,423,337,386,1785,3661
2022-07-30 16:00:00,2022-07-30 17:00:00,639,216,318,356,1529,3517
2022-07-30 17:00:00,2022-07-30 18:00:00,639,61,319,263,1282,3303
2022-07-30 18:00:00,2022-07-30 19:00:00,581,6,291,218,1096,3167
2022-07-30 19:00:00,2022-07-30 20:00:00,583,1,342,197,1123,3059
2022-07-30 20:00:00,2022-07-30 21:00:00,584,0,326,220,1130,2926
2022-07-30 21:00:00,2022-07-30 22:00:00,571,0,303,235,1109,2770
2022-07-30 22:00:00,2022-07-30 23:00:00,571,0,257,239,1067,2665
2022-07-30 23:00:00,2022-07-31 00:00:00,571,0,192,247,1010,2589
2022-07-31 00:00:00,2022-07-31 01:00:00,568,0,153,213,934,2528
2022-07-31 01:00:00,2022-07-31 02:00:00,572,0,146,179,897,2514
2022-07-31 02:00:00,2022-07-31 03:00:00,571,6,181,138,896,2486
2022-07-31 03:00:00,2022-07-31 04:00:00,565,62,206,104,937,2577
2022-07-31 04:00:00,2022-07-31 05:00:00,547,177,241,71,1036,2791
2022-07-31 05:00:00,2022-07-31 06:00:00,566,338,258,70,1232,3053
2022-07-31 06:00:00,2022-07-31 07:00:00,570,532,283,90,1475,3288
2022-07-31 07:00:00,2022-07-31 08:00:00,540,710,260,115,1625,3440
2022-07-31 08:00:00,2022-07-31 09:00:00,526,831,318,149,1824,3508
2022-07-31 09:00:00,2022-07-31 10:00:00,527,861,273,202,1863,3531
2022-07-31 10:00:00,2022-07-31 11:00:00,525,868,235,281,1909,3511
2022-07-31 11:00:00,2022-07-31 12:00:00,321,708,203,277,1509,3504
2022-07-31 12:00:00,2022-07-31 13:00:00,382,527,237,269,1415,3443
2022-07-31 13:00:00,2022-07-31 14:00:00,520,367,264,267,1418,3500
2022-07-31 14:00:00,2022-07-31 15:00:00,580,223,282,297,1382,3733
2022-07-31 15:00:00,2022-07-31 16:00:00,574,135,230,295,1234,3769
2022-07-31 16:00:00,2022-07-31 17:00:00,588,77,291,286,1242,3602
2022-07-31 17:00:00,2022-07-31 18:00:00,583,21,266,287,1157,3422
2022-07-31 18:00:00,2022-07-31 19:00:00,673,4,173,265,1115,3287
2022-07-31 19:00:00,2022-07-31 20:00:00,685,0,265,293,1243,3153
2022-07-31 20:00:00,2022-07-31 21:00:00,640,0,595,318,1553,3001
2022-07-31 21:00:00,2022-07-31 22:00:00,627,0,697,373,1697,2829
2022-07-31 22:00:00,2022-07-31 23:00:00,630,0,697,467,1794,2724
2022-07-31 23:00:00,2022-08-01 00:00:00,629,0,697,615,1941,2684
2022-08-01 00:00:00,2022-08-01 01:00:00,666,0,672,644,1982,2620
2022-08-01 01:00:00,2022-08-01 02:00:00,651,0,703,795,2149,2631
2022-08-01 02:00:00,2022-08-01 03:00:00,628,5,680,1006,2319,2808
2022-08-01 03:00:00,2022-08-01 04:00:00,631,53,645,1044,2373,3169
2022-08-01 04:00:00,2022-08-01 05:00:00,626,211,822,1141,2800,3661
2022-08-01 05:00:00,2022-08-01 06:00:00,419,462,568,1092,2541,4124
2022-08-01 06:00:00,2022-08-01 07:00:00,320,724,679,1770,3493,4291
2022-08-01 07:00:00,2022-08-01 08:00:00,280,997,695,1934,3906,4432
2022-08-01 08:00:00,2022-08-01 09:00:00,274,1246,693,2039,4252,4483
2022-08-01 09:00:00,2022-08-01 10:00:00,287,1429,693,2015,4424,4420
2022-08-01 10:00:00,2022-08-01 11:00:00,280,1529,796,1907,4512,4451
2022-08-01 11:00:00,2022-08-01 12:00:00,269,1527,884,1826,4506,4378
2022-08-01 12:00:00,2022-08-01 13:00:00,270,1472,777,1840,4359,4249
2022-08-01 13:00:00,2022-08-01 14:00:00,278,1297,688,1678,3941,4187
2022-08-01 14:00:00,2022-08-01 15:00:00,293,1005,674,1759,3731,4294
2022-08-01 15:00:00,2022-08-01 16:00:00,346,628,626,1783,3383,4180
2022-08-01 16:00:00,2022-08-01 17:00:00,582,268,566,1682,3098,3897
2022-08-01 17:00:00,2022-08-01 18:00:00,635,73,544,1281,2533,3593
2022-08-01 18:00:00,2022-08-01 19:00:00,640,9,522,1000,2171,3338
2022-08-01 19:00:00,2022-08-01 20:00:00,638,0,478,835,1951,3288
2022-08-01 20:00:00,2022-08-01 21:00:00,634,0,510,660,1804,3109
2022-08-01 21:00:00,2022-08-01 22:00:00,596,0,476,628,1700,2967
2022-08-01 22:00:00,2022-08-01 23:00:00,589,0,404,611,1604,2841
2022-08-01 23:00:00,2022-08-02 00:00:00,595,0,363,538,1496,2773
2022-08-02 00:00:00,2022-08-02 01:00:00,619,0,371,410,1400,2740
2022-08-02 01:00:00,2022-08-02 02:00:00,627,0,328,326,1281,2768
2022-08-02 02:00:00,2022-08-02 03:00:00,631,7,327,326,1291,2840
2022-08-02 03:00:00,2022-08-02 04:00:00,631,79,410,441,1561,3188
2022-08-02 04:00:00,2022-08-02 05:00:00,620,250,607,488,1965,3688
2022-08-02 05:00:00,2022-08-02 06:00:00,630,516,727,527,2400,3997
2022-08-02 06:00:00,2022-08-02 07:00:00,417,750,762,867,2796,4200
2022-08-02 07:00:00,2022-08-02 08:00:00,312,893,517,871,2593,4349
2022-08-02 08:00:00,2022-08-02 09:00:00,297,901,658,810,2666,4408
2022-08-02 09:00:00,2022-08-02 10:00:00,302,861,739,957,2859,4347
2022-08-02 10:00:00,2022-08-02 11:00:00,303,812,744,1476,3335,4360
2022-08-02 11:00:00,2022-08-02 12:00:00,312,660,732,1702,3406,4310
2022-08-02 12:00:00,2022-08-02 13:00:00,325,524,720,1507,3076,4336
2022-08-02 13:00:00,2022-08-02 14:00:00,306,326,686,1508,2826,4296
2022-08-02 14:00:00,2022-08-02 15:00:00,311,207,897,1801,3216,4388
2022-08-02 15:00:00,2022-08-02 16:00:00,545,129,1058,2126,3858,4232
2022-08-02 16:00:00,2022-08-02 17:00:00,630,73,1141,1976,3820,3898
2022-08-02 17:00:00,2022-08-02 18:00:00,642,22,1172,1716,3552,3780
2022-08-02 18:00:00,2022-08-02 19:00:00,642,1,1148,1410,3201,3617
2022-08-02 19:00:00,2022-08-02 20:00:00,624,0,1095,1274,2993,3469
2022-08-02 20:00:00,2022-08-02 21:00:00,423,0,1079,1178,2680,3237
2022-08-02 21:00:00,2022-08-02 22:00:00,562,0,1124,1126,2812,3049
2022-08-02 22:00:00,2022-08-02 23:00:00,524,0,1067,1137,2728,2930
2022-08-02 23:00:00,2022-08-03 00:00:00,530,0,1150,1083,2763,2835
2022-08-03 00:00:00,2022-08-03 01:00:00,424,0,1295,1114,2833,2821
2022-08-03 01:00:00,2022-08-03 02:00:00,342,0,1434,1186,2962,2898
2022-08-03 02:00:00,2022-08-03 03:00:00,422,3,1577,1272,3274,2994
2022-08-03 03:00:00,2022-08-03 04:00:00,319,52,1476,1157,3004,3370
2022-08-03 04:00:00,2022-08-03 05:00:00,416,162,1592,1420,3590,3780
2022-08-03 05:00:00,2022-08-03 06:00:00,439,320,1531,1460,3750,4069
2022-08-03 06:00:00,2022-08-03 07:00:00,601,513,1445,1529,4088,4201
2022-08-03 07:00:00,2022-08-03 08:00:00,596,715,1412,1756,4479,4394
2022-08-03 08:00:00,2022-08-03 09:00:00,418,932,1310,1838,4498,4449
2022-08-03 09:00:00,2022-08-03 10:00:00,308,1046,1245,1961,4560,4535
2022-08-03 10:00:00,2022-08-03 11:00:00,313,1031,1147,1823,4314,4608
2022-08-03 11:00:00,2022-08-03 12:00:00,297,977,1173,2088,4535,4522
2022-08-03 12:00:00,2022-08-03 13:00:00,311,784,1086,1996,4177,4342
2022-08-03 13:00:00,2022-08-03 14:00:00,555,606,942,1929,4032,4200
2022-08-03 14:00:00,2022-08-03 15:00:00,469,450,708,1722,3349,4277
2022-08-03 15:00:00,2022-08-03 16:00:00,626,283,615,1421,2945,4165
2022-08-03 16:00:00,2022-08-03 17:00:00,636,172,456,1095,2359,3935
2022-08-03 17:00:00,2022-08-03 18:00:00,703,63,435,763,1964,3688
2022-08-03 18:00:00,2022-08-03 19:00:00,714,6,314,567,1601,3525
2022-08-03 19:00:00,2022-08-03 20:00:00,714,0,237,478,1429,3474
2022-08-03 20:00:00,2022-08-03 21:00:00,708,0,158,360,1226,3249
2022-08-03 21:00:00,2022-08-03 22:00:00,701,0,106,297,1104,3024
2022-08-03 22:00:00,2022-08-03 23:00:00,702,0,48,242,992,2920
2022-08-03 23:00:00,2022-08-04 00:00:00,708,0,41,178,927,2845
2022-08-04 00:00:00,2022-08-04 01:00:00,709,0,58,144,911,2800
2022-08-04 01:00:00,2022-08-04 02:00:00,712,0,182,147,1041,2813
2022-08-04 02:00:00,2022-08-04 03:00:00,711,4,365,231,1311,2895
2022-08-04 03:00:00,2022-08-04 04:00:00,709,55,434,342,1540,3254
2022-08-04 04:00:00,2022-08-04 05:00:00,687,186,506,361,1740,3733
2022-08-04 05:00:00,2022-08-04 06:00:00,712,448,636,300,2096,4085
2022-08-04 06:00:00,2022-08-04 07:00:00,709,761,648,499,2617,4294
2022-08-04 07:00:00,2022-08-04 08:00:00,710,958,500,812,2980,4424
2022-08-04 08:00:00,2022-08-04 09:00:00,694,1160,325,749,2928,4512
2022-08-04 09:00:00,2022-08-04 10:00:00,690,1186,292,669,2837,4486
2022-08-04 10:00:00,2022-08-04 11:00:00,691,968,220,676,2555,4444
2022-08-04 11:00:00,2022-08-04 12:00:00,689,867,226,704,2486,4371
2022-08-04 12:00:00,2022-08-04 13:00:00,689,739,212,662,2302,4140
2022-08-04 13:00:00,2022-08-04 14:00:00,707,650,219,520,2096,4159
2022-08-04 14:00:00,2022-08-04 15:00:00,718,538,311,613,2180,4336
2022-08-04 15:00:00,2022-08-04 16:00:00,721,392,392,709,2214,4238
2022-08-04 16:00:00,2022-08-04 17:00:00,720,210,419,770,2119,3948
2022-08-04 17:00:00,2022-08-04 18:00:00,721,65,594,684,2064,3777
2022-08-04 18:00:00,2022-08-04 19:00:00,720,5,447,522,1694,3622
2022-08-04 19:00:00,2022-08-04 20:00:00,724,0,179,460,1363,3445
2022-08-04 20:00:00,2022-08-04 21:00:00,726,0,200,479,1405,3196
2022-08-04 21:00:00,2022-08-04 22:00:00,711,0,232,456,1399,3006
2022-08-04 22:00:00,2022-08-04 23:00:00,710,0,303,489,1502,2877
2022-08-04 23:00:00,2022-08-05 00:00:00,707,0,332,582,1621,2767
2022-08-05 00:00:00,2022-08-05 01:00:00,711,0,354,616,1681,2757
2022-08-05 01:00:00,2022-08-05 02:00:00,712,0,361,605,1678,2760
2022-08-05 02:00:00,2022-08-05 03:00:00,664,3,533,609,1809,2847
2022-08-05 03:00:00,2022-08-05 04:00:00,583,40,485,565,1673,3184
2022-08-05 04:00:00,2022-08-05 05:00:00,579,193,403,445,1620,3664
2022-08-05 05:00:00,2022-08-05 06:00:00,585,362,463,495,1905,3990
2022-08-05 06:00:00,2022-08-05 07:00:00,570,575,211,589,1945,4158
2022-08-05 07:00:00,2022-08-05 08:00:00,414,874,212,538,2038,4303
2022-08-05 08:00:00,2022-08-05 09:00:00,415,1064,213,516,2208,4318
2022-08-05 09:00:00,2022-08-05 10:00:00,421,974,153,594,2142,4253
2022-08-05 10:00:00,2022-08-05 11:00:00,469,908,94,773,2244,4217
2022-08-05 11:00:00,2022-08-05 12:00:00,542,819,67,994,2422,4126
2022-08-05 12:00:00,2022-08-05 13:00:00,560,759,113,1150,2582,3986
2022-08-05 13:00:00,2022-08-05 14:00:00,564,732,190,1376,2862,4003
2022-08-05 14:00:00,2022-08-05 15:00:00,554,673,280,1629,3136,4072
2022-08-05 15:00:00,2022-08-05 16:00:00,429,423,490,1760,3102,4007
2022-08-05 16:00:00,2022-08-05 17:00:00,207,177,625,1678,2687,3845
2022-08-05 17:00:00,2022-08-05 18:00:00,401,51,840,1711,3003,3467
2022-08-05 18:00:00,2022-08-05 19:00:00,465,4,958,1708,3135,3361
2022-08-05 19:00:00,2022-08-05 20:00:00,465,0,1148,1708,3321,3251
2022-08-05 20:00:00,2022-08-05 21:00:00,442,0,1414,1756,3612,3082
2022-08-05 21:00:00,2022-08-05 22:00:00,431,0,1304,1743,3478,2896
2022-08-05 22:00:00,2022-08-05 23:00:00,312,0,1465,1772,3549,2770
2022-08-05 23:00:00,2022-08-06 00:00:00,265,0,1470,1779,3514,2669
2022-08-06 00:00:00,2022-08-06 01:00:00,273,0,1519,1717,3509,2636
2022-08-06 01:00:00,2022-08-06 02:00:00,284,0,1459,1648,3391,2608
2022-08-06 02:00:00,2022-08-06 03:00:00,198,4,1490,1592,3284,2638
2022-08-06 03:00:00,2022-08-06 04:00:00,273,65,1442,1532,3312,2739
2022-08-06 04:00:00,2022-08-06 05:00:00,210,237,1630,1595,3672,3001
2022-08-06 05:00:00,2022-08-06 06:00:00,209,547,1664,1984,4404,3300
2022-08-06 06:00:00,2022-08-06 07:00:00,258,798,1500,2461,5017,3550
2022-08-06 07:00:00,2022-08-06 08:00:00,198,954,1561,2497,5210,3719
2022-08-06 08:00:00,2022-08-06 09:00:00,178,1031,1420,2622,5251,3802
2022-08-06 09:00:00,2022-08-06 10:00:00,140,1116,1322,2474,5052,3873
2022-08-06 10:00:00,2022-08-06 11:00:00,169,1122,1175,2607,5073,3764
2022-08-06 11:00:00,2022-08-06 12:00:00,153,1090,1155,2625,5023,3707
2022-08-06 12:00:00,2022-08-06 13:00:00,181,1090,1117,2710,5098,3700
2022-08-06 13:00:00,2022-08-06 14:00:00,169,939,1108,2363,4579,3720
2022-08-06 14:00:00,2022-08-06 15:00:00,179,715,1093,1993,3980,3868
2022-08-06 15:00:00,2022-08-06 16:00:00,184,420,1097,2037,3738,3686
2022-08-06 16:00:00,2022-08-06 17:00:00,323,207,985,1821,3336,3473
2022-08-06 17:00:00,2022-08-06 18:00:00,462,53,848,1290,2653,3276
2022-08-06 18:00:00,2022-08-06 19:00:00,474,3,760,925,2162,3176
2022-08-06 19:00:00,2022-08-06 20:00:00,470,0,683,831,1984,3083
2022-08-06 20:00:00,2022-08-06 21:00:00,469,0,644,766,1879,2907
2022-08-06 21:00:00,2022-08-06 22:00:00,450,0,682,675,1807,2744
2022-08-06 22:00:00,2022-08-06 23:00:00,429,0,644,588,1661,2627
2022-08-06 23:00:00,2022-08-07 00:00:00,401,0,552,522,1475,2538
2022-08-07 00:00:00,2022-08-07 01:00:00,367,0,529,478,1374,2497
2022-08-07 01:00:00,2022-08-07 02:00:00,366,0,456,397,1219,2487
2022-08-07 02:00:00,2022-08-07 03:00:00,424,2,409,391,1226,2454
2022-08-07 03:00:00,2022-08-07 04:00:00,434,45,388,419,1286,2548
2022-08-07 04:00:00,2022-08-07 05:00:00,396,140,385,397,1318,2760
2022-08-07 05:00:00,2022-08-07 06:00:00,428,244,412,437,1521,3074
2022-08-07 06:00:00,2022-08-07 07:00:00,399,399,377,575,1750,3355
2022-08-07 07:00:00,2022-08-07 08:00:00,168,479,383,605,1635,3663
2022-08-07 08:00:00,2022-08-07 09:00:00,124,519,455,630,1728,3681
2022-08-07 09:00:00,2022-08-07 10:00:00,123,584,516,616,1839,3673
2022-08-07 10:00:00,2022-08-07 11:00:00,123,596,540,753,2012,3663
2022-08-07 11:00:00,2022-08-07 12:00:00,122,507,553,786,1968,3651
2022-08-07 12:00:00,2022-08-07 13:00:00,123,531,464,812,1930,3618
2022-08-07 13:00:00,2022-08-07 14:00:00,152,456,309,752,1669,3647
2022-08-07 14:00:00,2022-08-07 15:00:00,325,385,236,631,1577,3880
2022-08-07 15:00:00,2022-08-07 16:00:00,432,282,219,510,1443,3876
2022-08-07 16:00:00,2022-08-07 17:00:00,434,149,241,374,1198,3652
2022-08-07 17:00:00,2022-08-07 18:00:00,442,41,149,257,889,3451
2022-08-07 18:00:00,2022-08-07 19:00:00,450,3,86,235,774,3363
2022-08-07 19:00:00,2022-08-07 20:00:00,444,0,77,200,721,3190
2022-08-07 20:00:00,2022-08-07 21:00:00,432,0,83,214,729,2982
2022-08-07 21:00:00,2022-08-07 22:00:00,424,0,92,234,750,2833
2022-08-07 22:00:00,2022-08-07 23:00:00,421,0,88,227,736,2755
2022-08-07 23:00:00,2022-08-08 00:00:00,428,0,100,215,743,2692
2022-08-08 00:00:00,2022-08-08 01:00:00,417,0,95,194,706,2667
2022-08-08 01:00:00,2022-08-08 02:00:00,408,0,90,185,683,2726
2022-08-08 02:00:00,2022-08-08 03:00:00,391,2,98,159,650,2874
2022-08-08 03:00:00,2022-08-08 04:00:00,428,41,107,136,712,3324
2022-08-08 04:00:00,2022-08-08 05:00:00,428,160,88,110,786,3882
2022-08-08 05:00:00,2022-08-08 06:00:00,431,328,42,111,912,4185
2022-08-08 06:00:00,2022-08-08 07:00:00,443,622,33,176,1274,4338
2022-08-08 07:00:00,2022-08-08 08:00:00,442,810,27,240,1519,4498
2022-08-08 08:00:00,2022-08-08 09:00:00,438,817,7,274,1536,4513
2022-08-08 09:00:00,2022-08-08 10:00:00,431,973,7,345,1756,4515
2022-08-08 10:00:00,2022-08-08 11:00:00,404,1005,8,486,1903,4491
2022-08-08 11:00:00,2022-08-08 12:00:00,379,1049,13,597,2038,4443
2022-08-08 12:00:00,2022-08-08 13:00:00,376,996,35,661,2068,4327
2022-08-08 13:00:00,2022-08-08 14:00:00,381,859,95,685,2020,4300
2022-08-08 14:00:00,2022-08-08 15:00:00,391,695,32,627,1745,4565
2022-08-08 15:00:00,2022-08-08 16:00:00,392,425,16,571,1404,4357
2022-08-08 16:00:00,2022-08-08 17:00:00,405,177,18,476,1076,4086
2022-08-08 17:00:00,2022-08-08 18:00:00,434,39,14,306,793,3862
2022-08-08 18:00:00,2022-08-08 19:00:00,442,2,35,209,688,3729
2022-08-08 19:00:00,2022-08-08 20:00:00,448,0,36,198,682,3532
2022-08-08 20:00:00,2022-08-08 21:00:00,440,0,19,180,639,3264
2022-08-08 21:00:00,2022-08-08 22:00:00,401,0,17,163,581,3064
2022-08-08 22:00:00,2022-08-08 23:00:00,415,0,16,168,599,2943
2022-08-08 23:00:00,2022-08-09 00:00:00,283,0,12,183,478,2872
2022-08-09 00:00:00,2022-08-09 01:00:00,248,0,7,171,426,2842
2022-08-09 01:00:00,2022-08-09 02:00:00,380,0,6,185,571,2887
2022-08-09 02:00:00,2022-08-09 03:00:00,432,3,4,194,633,3022
2022-08-09 03:00:00,2022-08-09 04:00:00,442,49,3,164,658,3497
2022-08-09 04:00:00,2022-08-09 05:00:00,445,163,9,132,749,4005
2022-08-09 05:00:00,2022-08-09 06:00:00,429,362,5,118,914,4309
2022-08-09 06:00:00,2022-08-09 07:00:00,446,592,6,124,1168,4450
2022-08-09 07:00:00,2022-08-09 08:00:00,453,776,9,160,1398,4590
2022-08-09 08:00:00,2022-08-09 09:00:00,448,873,3,192,1516,4584
2022-08-09 09:00:00,2022-08-09 10:00:00,400,961,3,208,1572,4573
2022-08-09 10:00:00,2022-08-09 11:00:00,391,1018,1,214,1624,4570
2022-08-09 11:00:00,2022-08-09 12:00:00,389,1026,2,240,1657,4476
2022-08-09 12:00:00,2022-08-09 13:00:00,343,982,3,225,1553,4310
2022-08-09 13:00:00,2022-08-09 14:00:00,449,882,3,249,1583,4320
2022-08-09 14:00:00,2022-08-09 15:00:00,462,701,2,208,1373,4472
2022-08-09 15:00:00,2022-08-09 16:00:00,464,496,2,156,1118,4383
2022-08-09 16:00:00,2022-08-09 17:00:00,480,201,27,127,835,4150
2022-08-09 17:00:00,2022-08-09 18:00:00,463,44,21,112,640,3933
2022-08-09 18:00:00,2022-08-09 19:00:00,463,2,18,105,588,3810
2022-08-09 19:00:00,2022-08-09 20:00:00,481,0,10,101,592,3593
2022-08-09 20:00:00,2022-08-09 21:00:00,454,0,6,90,550,3313
2022-08-09 21:00:00,2022-08-09 22:00:00,434,0,10,95,539,3143
2022-08-09 22:00:00,2022-08-09 23:00:00,440,0,7,88,535,3024
2022-08-09 23:00:00,2022-08-10 00:00:00,436,0,1,87,524,2941
2022-08-10 00:00:00,2022-08-10 01:00:00,440,0,0,86,526,2915
2022-08-10 01:00:00,2022-08-10 02:00:00,435,0,0,106,541,2942
2022-08-10 02:00:00,2022-08-10 03:00:00,438,2,1,139,580,3084
2022-08-10 03:00:00,2022-08-10 04:00:00,437,43,1,164,645,3544
2022-08-10 04:00:00,2022-08-10 05:00:00,440,187,1,143,771,4065
2022-08-10 05:00:00,2022-08-10 06:00:00,441,477,3,157,1078,4365
2022-08-10 06:00:00,2022-08-10 07:00:00,442,775,12,171,1400,4507
2022-08-10 07:00:00,2022-08-10 08:00:00,444,1094,8,158,1704,4612
2022-08-10 08:00:00,2022-08-10 09:00:00,447,1306,1,147,1901,4618
2022-08-10 09:00:00,2022-08-10 10:00:00,446,1374,1,138,1959,4600
2022-08-10 10:00:00,2022-08-10 11:00:00,444,1442,2,158,2046,4659
2022-08-10 11:00:00,2022-08-10 12:00:00,448,1449,4,196,2097,4585
2022-08-10 12:00:00,2022-08-10 13:00:00,444,1349,5,232,2030,4462
2022-08-10 13:00:00,2022-08-10 14:00:00,447,1155,4,239,1845,4417
2022-08-10 14:00:00,2022-08-10 15:00:00,447,783,3,214,1447,4431
2022-08-10 15:00:00,2022-08-10 16:00:00,450,470,9,159,1088,4283
2022-08-10 16:00:00,2022-08-10 17:00:00,469,180,24,124,797,4041
2022-08-10 17:00:00,2022-08-10 18:00:00,466,35,45,104,650,3861
2022-08-10 18:00:00,2022-08-10 19:00:00,464,1,59,133,657,3841
2022-08-10 19:00:00,2022-08-10 20:00:00,447,0,58,139,644,3680
2022-08-10 20:00:00,2022-08-10 21:00:00,425,0,79,140,644,3404
2022-08-10 21:00:00,2022-08-10 22:00:00,432,0,76,123,631,3213
2022-08-10 22:00:00,2022-08-10 23:00:00,419,0,32,105,556,3076
2022-08-10 23:00:00,2022-08-11 00:00:00,413,0,3,77,493,2990
2022-08-11 00:00:00,2022-08-11 01:00:00,417,0,1,66,484,2944
2022-08-11 01:00:00,2022-08-11 02:00:00,414,0,1,63,478,2961
2022-08-11 02:00:00,2022-08-11 03:00:00,412,2,0,64,478,3094
2022-08-11 03:00:00,2022-08-11 04:00:00,432,38,0,68,538,3497
2022-08-11 04:00:00,2022-08-11 05:00:00,436,177,0,61,674,4071
2022-08-11 05:00:00,2022-08-11 06:00:00,434,479,0,62,975,4355
2022-08-11 06:00:00,2022-08-11 07:00:00,431,856,0,74,1361,4505
2022-08-11 07:00:00,2022-08-11 08:00:00,424,1157,0,86,1667,4639
2022-08-11 08:00:00,2022-08-11 09:00:00,406,1357,0,86,1849,4666
2022-08-11 09:00:00,2022-08-11 10:00:00,412,1483,4,106,2005,4680
2022-08-11 10:00:00,2022-08-11 11:00:00,405,1450,10,132,1997,4640
2022-08-11 11:00:00,2022-08-11 12:00:00,419,1442,13,156,2030,4586
2022-08-11 12:00:00,2022-08-11 13:00:00,425,1334,16,157,1932,4386
2022-08-11 13:00:00,2022-08-11 14:00:00,433,1180,30,149,1792,4303
2022-08-11 14:00:00,2022-08-11 15:00:00,422,897,37,140,1496,4405
2022-08-11 15:00:00,2022-08-11 16:00:00,422,531,56,136,1145,4314
2022-08-11 16:00:00,2022-08-11 17:00:00,434,197,54,89,774,4106
2022-08-11 17:00:00,2022-08-11 18:00:00,415,38,68,69,590,3921
2022-08-11 18:00:00,2022-08-11 19:00:00,377,2,81,76,536,3812
2022-08-11 19:00:00,2022-08-11 20:00:00,385,0,78,78,541,3639
2022-08-11 20:00:00,2022-08-11 21:00:00,379,0,64,82,525,3375
2022-08-11 21:00:00,2022-08-11 22:00:00,348,0,39,74,461,3179
2022-08-11 22:00:00,2022-08-11 23:00:00,344,0,5,87,436,3058
2022-08-11 23:00:00,2022-08-12 00:00:00,352,0,13,87,452,2989
2022-08-12 00:00:00,2022-08-12 01:00:00,365,0,18,77,460,2926
2022-08-12 01:00:00,2022-08-12 02:00:00,383,0,30,85,498,2937
2022-08-12 02:00:00,2022-08-12 03:00:00,368,2,29,84,483,3100
2022-08-12 03:00:00,2022-08-12 04:00:00,384,43,17,76,520,3516
2022-08-12 04:00:00,2022-08-12 05:00:00,384,218,33,73,708,4019
2022-08-12 05:00:00,2022-08-12 06:00:00,365,563,47,60,1035,4318
2022-08-12 06:00:00,2022-08-12 07:00:00,364,918,42,69,1393,4439
2022-08-12 07:00:00,2022-08-12 08:00:00,352,1212,38,76,1678,4533
2022-08-12 08:00:00,2022-08-12 09:00:00,366,1412,31,85,1894,4523
2022-08-12 09:00:00,2022-08-12 10:00:00,346,1464,42,103,1955,4434
2022-08-12 10:00:00,2022-08-12 11:00:00,338,1511,48,117,2014,4361
2022-08-12 11:00:00,2022-08-12 12:00:00,317,1493,58,146,2014,4233
2022-08-12 12:00:00,2022-08-12 13:00:00,317,1404,57,154,1932,4107
2022-08-12 13:00:00,2022-08-12 14:00:00,350,1195,76,165,1786,4043
2022-08-12 14:00:00,2022-08-12 15:00:00,328,894,123,188,1533,4136
2022-08-12 15:00:00,2022-08-12 16:00:00,350,523,151,207,1231,4107
2022-08-12 16:00:00,2022-08-12 17:00:00,367,190,177,190,924,3885
2022-08-12 17:00:00,2022-08-12 18:00:00,387,35,184,183,789,3684
2022-08-12 18:00:00,2022-08-12 19:00:00,395,1,199,216,811,3600
2022-08-12 19:00:00,2022-08-12 20:00:00,399,0,186,216,801,3481
2022-08-12 20:00:00,2022-08-12 21:00:00,400,0,270,219,889,3244
2022-08-12 21:00:00,2022-08-12 22:00:00,410,0,264,236,910,3048
2022-08-12 22:00:00,2022-08-12 23:00:00,417,0,171,250,838,2911
2022-08-12 23:00:00,2022-08-13 00:00:00,424,0,99,222,745,2816
2022-08-13 00:00:00,2022-08-13 01:00:00,418,0,80,189,687,2770
2022-08-13 01:00:00,2022-08-13 02:00:00,414,0,78,150,642,2727
2022-08-13 02:00:00,2022-08-13 03:00:00,396,1,83,128,608,2729
2022-08-13 03:00:00,2022-08-13 04:00:00,409,43,108,100,660,2830
2022-08-13 04:00:00,2022-08-13 05:00:00,391,205,95,80,771,3109
2022-08-13 05:00:00,2022-08-13 06:00:00,387,541,109,64,1101,3427
2022-08-13 06:00:00,2022-08-13 07:00:00,403,924,103,68,1498,3645
2022-08-13 07:00:00,2022-08-13 08:00:00,404,1213,114,72,1803,3765
2022-08-13 08:00:00,2022-08-13 09:00:00,391,1408,103,86,1988,3787
2022-08-13 09:00:00,2022-08-13 10:00:00,401,1500,85,107,2093,3782
2022-08-13 10:00:00,2022-08-13 11:00:00,396,1518,79,125,2118,3769
2022-08-13 11:00:00,2022-08-13 12:00:00,402,1481,63,141,2087,3667
2022-08-13 12:00:00,2022-08-13 13:00:00,393,1356,56,165,1970,3616
2022-08-13 13:00:00,2022-08-13 14:00:00,418,1157,73,179,1827,3632
2022-08-13 14:00:00,2022-08-13 15:00:00,441,826,85,183,1535,3723
2022-08-13 15:00:00,2022-08-13 16:00:00,447,488,86,177,1198,3734
2022-08-13 16:00:00,2022-08-13 17:00:00,467,180,85,152,884,3615
2022-08-13 17:00:00,2022-08-13 18:00:00,477,36,68,155,736,3487
2022-08-13 18:00:00,2022-08-13 19:00:00,451,1,89,191,732,3409
2022-08-13 19:00:00,2022-08-13 20:00:00,453,0,120,210,783,3326
2022-08-13 20:00:00,2022-08-13 21:00:00,452,0,153,194,799,3117
2022-08-13 21:00:00,2022-08-13 22:00:00,433,0,171,226,830,2943
2022-08-13 22:00:00,2022-08-13 23:00:00,422,0,127,245,794,2811
2022-08-13 23:00:00,2022-08-14 00:00:00,409,0,135,227,771,2716
2022-08-14 00:00:00,2022-08-14 01:00:00,407,0,218,243,868,2663
2022-08-14 01:00:00,2022-08-14 02:00:00,403,0,261,258,922,2629
2022-08-14 02:00:00,2022-08-14 03:00:00,404,1,337,280,1022,2629
2022-08-14 03:00:00,2022-08-14 04:00:00,406,43,459,280,1188,2676
2022-08-14 04:00:00,2022-08-14 05:00:00,390,192,524,259,1365,2926
2022-08-14 05:00:00,2022-08-14 06:00:00,411,435,495,244,1585,3258
2022-08-14 06:00:00,2022-08-14 07:00:00,412,695,513,248,1868,3490
2022-08-14 07:00:00,2022-08-14 08:00:00,410,886,569,311,2176,3620
2022-08-14 08:00:00,2022-08-14 09:00:00,410,1013,530,403,2356,3688
2022-08-14 09:00:00,2022-08-14 10:00:00,390,1077,516,467,2450,3747
2022-08-14 10:00:00,2022-08-14 11:00:00,198,1160,456,527,2341,3761
2022-08-14 11:00:00,2022-08-14 12:00:00,180,1100,471,588,2339,3739
2022-08-14 12:00:00,2022-08-14 13:00:00,339,939,489,671,2438,3669
2022-08-14 13:00:00,2022-08-14 14:00:00,396,821,564,697,2478,3658
2022-08-14 14:00:00,2022-08-14 15:00:00,399,521,571,667,2158,3882
2022-08-14 15:00:00,2022-08-14 16:00:00,408,292,691,634,2025,3906
2022-08-14 16:00:00,2022-08-14 17:00:00,420,130,763,590,1903,3770
2022-08-14 17:00:00,2022-08-14 18:00:00,388,26,900,630,1944,3641
2022-08-14 18:00:00,2022-08-14 19:00:00,389,0,1060,811,2260,3581
2022-08-14 19:00:00,2022-08-14 20:00:00,335,0,1325,1006,2666,3443
2022-08-14 20:00:00,2022-08-14 21:00:00,182,0,1368,945,2495,3299
2022-08-14 21:00:00,2022-08-14 22:00:00,314,0,1281,975,2570,3090
2022-08-14 22:00:00,2022-08-14 23:00:00,330,0,892,927,2149,2976
2022-08-14 23:00:00,2022-08-15 00:00:00,433,0,804,815,2052,2840
2022-08-15 00:00:00,2022-08-15 01:00:00,356,0,670,753,1779,2843
2022-08-15 01:00:00,2022-08-15 02:00:00,388,0,574,770,1732,2880
2022-08-15 02:00:00,2022-08-15 03:00:00,336,1,458,791,1586,3092
2022-08-15 03:00:00,2022-08-15 04:00:00,299,46,477,677,1499,3550
2022-08-15 04:00:00,2022-08-15 05:00:00,371,197,375,487,1430,4043
2022-08-15 05:00:00,2022-08-15 06:00:00,309,472,445,335,1561,4411
2022-08-15 06:00:00,2022-08-15 07:00:00,386,792,368,344,1890,4522
2022-08-15 07:00:00,2022-08-15 08:00:00,391,1091,279,453,2214,4661
2022-08-15 08:00:00,2022-08-15 09:00:00,389,1310,338,586,2623,4715
2022-08-15 09:00:00,2022-08-15 10:00:00,387,1366,382,723,2858,4632
2022-08-15 10:00:00,2022-08-15 11:00:00,359,1325,408,769,2861,4612
2022-08-15 11:00:00,2022-08-15 12:00:00,353,1314,490,888,3045,4543
2022-08-15 12:00:00,2022-08-15 13:00:00,357,1205,504,938,3004,4451
2022-08-15 13:00:00,2022-08-15 14:00:00,363,1011,417,836,2627,4388
2022-08-15 14:00:00,2022-08-15 15:00:00,386,749,427,627,2189,4540
2022-08-15 15:00:00,2022-08-15 16:00:00,376,431,489,482,1778,4421
2022-08-15 16:00:00,2022-08-15 17:00:00,412,153,589,388,1542,4193
2022-08-15 17:00:00,2022-08-15 18:00:00,469,24,536,397,1426,4000
2022-08-15 18:00:00,2022-08-15 19:00:00,448,0,367,408,1223,3943
2022-08-15 19:00:00,2022-08-15 20:00:00,414,0,449,419,1282,3711
2022-08-15 20:00:00,2022-08-15 21:00:00,439,0,540,469,1448,3439
2022-08-15 21:00:00,2022-08-15 22:00:00,427,0,447,472,1346,3244
2022-08-15 22:00:00,2022-08-15 23:00:00,420,0,309,472,1201,3141
2022-08-15 23:00:00,2022-08-16 00:00:00,393,0,372,384,1149,3062
2022-08-16 00:00:00,2022-08-16 01:00:00,432,0,456,354,1242,2995
2022-08-16 01:00:00,2022-08-16 02:00:00,386,0,433,356,1175,3067
2022-08-16 02:00:00,2022-08-16 03:00:00,410,1,247,253,911,3215
2022-08-16 03:00:00,2022-08-16 04:00:00,421,25,300,274,1020,3690
2022-08-16 04:00:00,2022-08-16 05:00:00,445,116,354,271,1186,4215
2022-08-16 05:00:00,2022-08-16 06:00:00,436,275,320,201,1232,4516
2022-08-16 06:00:00,2022-08-16 07:00:00,437,442,235,183,1297,4581
2022-08-16 07:00:00,2022-08-16 08:00:00,432,715,212,194,1553,4726
2022-08-16 08:00:00,2022-08-16 09:00:00,434,896,356,209,1895,4718
2022-08-16 09:00:00,2022-08-16 10:00:00,414,1014,403,330,2161,4670
2022-08-16 10:00:00,2022-08-16 11:00:00,425,1112,383,542,2462,4704
2022-08-16 11:00:00,2022-08-16 12:00:00,433,1140,380,715,2668,4589
2022-08-16 12:00:00,2022-08-16 13:00:00,442,1135,438,883,2898,4517
2022-08-16 13:00:00,2022-08-16 14:00:00,451,934,521,1005,2911,4523
2022-08-16 14:00:00,2022-08-16 15:00:00,476,670,453,871,2470,4704
2022-08-16 15:00:00,2022-08-16 16:00:00,496,353,268,649,1766,4496
2022-08-16 16:00:00,2022-08-16 17:00:00,494,131,123,400,1148,4250
2022-08-16 17:00:00,2022-08-16 18:00:00,495,21,63,305,884,3985
2022-08-16 18:00:00,2022-08-16 19:00:00,491,0,69,297,857,3934
2022-08-16 19:00:00,2022-08-16 20:00:00,492,0,82,261,835,3693
2022-08-16 20:00:00,2022-08-16 21:00:00,490,0,125,235,850,3418
2022-08-16 21:00:00,2022-08-16 22:00:00,491,0,175,248,914,3229
2022-08-16 22:00:00,2022-08-16 23:00:00,493,0,180,247,920,3102
2022-08-16 23:00:00,2022-08-17 00:00:00,493,0,159,225,877,3039
2022-08-17 00:00:00,2022-08-17 01:00:00,493,0,138,210,841,3025
2022-08-17 01:00:00,2022-08-17 02:00:00,494,0,93,221,808,3075
2022-08-17 02:00:00,2022-08-17 03:00:00,493,1,63,196,753,3235
2022-08-17 03:00:00,2022-08-17 04:00:00,494,28,13,136,671,3681
2022-08-17 04:00:00,2022-08-17 05:00:00,495,159,20,105,779,4169
2022-08-17 05:00:00,2022-08-17 06:00:00,488,382,2,96,968,4451
2022-08-17 06:00:00,2022-08-17 07:00:00,486,646,2,144,1278,4578
2022-08-17 07:00:00,2022-08-17 08:00:00,458,914,6,186,1564,4624
2022-08-17 08:00:00,2022-08-17 09:00:00,444,1079,2,202,1727,4637
2022-08-17 09:00:00,2022-08-17 10:00:00,443,1081,1,211,1736,4638
2022-08-17 10:00:00,2022-08-17 11:00:00,443,1142,1,202,1788,4690
2022-08-17 11:00:00,2022-08-17 12:00:00,474,1090,9,249,1822,4618
2022-08-17 12:00:00,2022-08-17 13:00:00,468,969,22,315,1774,4491
2022-08-17 13:00:00,2022-08-17 14:00:00,465,765,72,400,1702,4438
2022-08-17 14:00:00,2022-08-17 15:00:00,466,518,75,419,1478,4564
2022-08-17 15:00:00,2022-08-17 16:00:00,477,304,110,410,1301,4456
2022-08-17 16:00:00,2022-08-17 17:00:00,473,128,249,387,1237,4193
2022-08-17 17:00:00,2022-08-17 18:00:00,473,23,340,384,1220,4004
2022-08-17 18:00:00,2022-08-17 19:00:00,476,0,379,349,1204,3902
2022-08-17 19:00:00,2022-08-17 20:00:00,472,0,393,337,1202,3682
2022-08-17 20:00:00,2022-08-17 21:00:00,472,0,445,281,1198,3416
2022-08-17 21:00:00,2022-08-17 22:00:00,472,0,264,301,1037,3190
2022-08-17 22:00:00,2022-08-17 23:00:00,470,0,292,298,1060,3109
2022-08-17 23:00:00,2022-08-18 00:00:00,471,0,366,291,1128,3024
2022-08-18 00:00:00,2022-08-18 01:00:00,473,0,469,360,1302,2987
2022-08-18 01:00:00,2022-08-18 02:00:00,473,0,812,419,1704,3044
2022-08-18 02:00:00,2022-08-18 03:00:00,473,0,818,353,1644,3203
2022-08-18 03:00:00,2022-08-18 04:00:00,472,13,734,334,1553,3646
2022-08-18 04:00:00,2022-08-18 05:00:00,472,73,836,319,1700,4178
2022-08-18 05:00:00,2022-08-18 06:00:00,474,185,869,212,1740,4439
2022-08-18 06:00:00,2022-08-18 07:00:00,449,366,743,170,1728,4537
2022-08-18 07:00:00,2022-08-18 08:00:00,456,506,614,163,1739,4632
2022-08-18 08:00:00,2022-08-18 09:00:00,481,684,624,144,1933,4676
2022-08-18 09:00:00,2022-08-18 10:00:00,482,726,518,178,1904,4611
2022-08-18 10:00:00,2022-08-18 11:00:00,479,707,392,177,1755,4607
2022-08-18 11:00:00,2022-08-18 12:00:00,472,742,308,184,1706,4545
2022-08-18 12:00:00,2022-08-18 13:00:00,474,712,321,208,1715,4435
2022-08-18 13:00:00,2022-08-18 14:00:00,477,635,289,230,1631,4392
2022-08-18 14:00:00,2022-08-18 15:00:00,494,535,216,235,1480,4458
2022-08-18 15:00:00,2022-08-18 16:00:00,500,314,160,229,1203,4376
2022-08-18 16:00:00,2022-08-18 17:00:00,504,116,140,182,942,4156
2022-08-18 17:00:00,2022-08-18 18:00:00,494,16,137,157,804,3984
2022-08-18 18:00:00,2022-08-18 19:00:00,492,0,178,147,817,3913
2022-08-18 19:00:00,2022-08-18 20:00:00,490,0,253,163,906,3666
2022-08-18 20:00:00,2022-08-18 21:00:00,476,0,408,148,1032,3394
2022-08-18 21:00:00,2022-08-18 22:00:00,468,0,167,145,780,3220
2022-08-18 22:00:00,2022-08-18 23:00:00,468,0,107,130,705,3070
2022-08-18 23:00:00,2022-08-19 00:00:00,467,0,121,115,703,3004
2022-08-19 00:00:00,2022-08-19 01:00:00,468,0,123,102,693,2980
2022-08-19 01:00:00,2022-08-19 02:00:00,468,0,106,104,678,3015
2022-08-19 02:00:00,2022-08-19 03:00:00,468,0,62,91,621,3170
2022-08-19 03:00:00,2022-08-19 04:00:00,467,23,41,84,615,3651
2022-08-19 04:00:00,2022-08-19 05:00:00,470,111,20,90,691,4117
2022-08-19 05:00:00,2022-08-19 06:00:00,468,254,10,70,802,4477
2022-08-19 06:00:00,2022-08-19 07:00:00,466,453,11,61,991,4547
2022-08-19 07:00:00,2022-08-19 08:00:00,466,610,17,68,1161,4544
2022-08-19 08:00:00,2022-08-19 09:00:00,462,688,19,76,1245,4498
2022-08-19 09:00:00,2022-08-19 10:00:00,461,695,34,87,1277,4416
2022-08-19 10:00:00,2022-08-19 11:00:00,467,788,66,100,1421,4370
2022-08-19 11:00:00,2022-08-19 12:00:00,465,844,72,115,1496,4275
2022-08-19 12:00:00,2022-08-19 13:00:00,467,843,78,107,1495,4214
2022-08-19 13:00:00,2022-08-19 14:00:00,468,740,113,111,1432,4219
2022-08-19 14:00:00,2022-08-19 15:00:00,473,552,135,138,1298,4317
2022-08-19 15:00:00,2022-08-19 16:00:00,473,356,119,137,1085,4209
2022-08-19 16:00:00,2022-08-19 17:00:00,472,128,119,147,866,3965
2022-08-19 17:00:00,2022-08-19 18:00:00,462,16,151,154,783,3763
2022-08-19 18:00:00,2022-08-19 19:00:00,426,0,162,178,766,3675
2022-08-19 19:00:00,2022-08-19 20:00:00,464,0,196,197,857,3468
2022-08-19 20:00:00,2022-08-19 21:00:00,465,0,206,220,891,3267
2022-08-19 21:00:00,2022-08-19 22:00:00,449,0,199,282,930,3063
2022-08-19 22:00:00,2022-08-19 23:00:00,409,0,173,305,887,2902
2022-08-19 23:00:00,2022-08-20 00:00:00,405,0,265,267,937,2817
2022-08-20 00:00:00,2022-08-20 01:00:00,457,0,339,252,1048,2736
2022-08-20 01:00:00,2022-08-20 02:00:00,462,0,303,287,1052,2721
2022-08-20 02:00:00,2022-08-20 03:00:00,461,0,209,357,1027,2734
2022-08-20 03:00:00,2022-08-20 04:00:00,460,19,235,296,1010,2788
2022-08-20 04:00:00,2022-08-20 05:00:00,463,135,277,235,1110,3038
2022-08-20 05:00:00,2022-08-20 06:00:00,462,364,182,206,1214,3367
2022-08-20 06:00:00,2022-08-20 07:00:00,462,722,256,277,1717,3610
2022-08-20 07:00:00,2022-08-20 08:00:00,460,993,149,343,1945,3718
2022-08-20 08:00:00,2022-08-20 09:00:00,460,1143,92,403,2098,3705
2022-08-20 09:00:00,2022-08-20 10:00:00,461,1135,128,479,2203,3650
2022-08-20 10:00:00,2022-08-20 11:00:00,461,1144,115,521,2241,3596
2022-08-20 11:00:00,2022-08-20 12:00:00,462,1125,76,610,2273,3565
2022-08-20 12:00:00,2022-08-20 13:00:00,466,1003,122,679,2270,3549
2022-08-20 13:00:00,2022-08-20 14:00:00,468,856,153,707,2184,3573
2022-08-20 14:00:00,2022-08-20 15:00:00,468,647,115,684,1914,3750
2022-08-20 15:00:00,2022-08-20 16:00:00,468,410,98,569,1545,3756
2022-08-20 16:00:00,2022-08-20 17:00:00,469,150,166,371,1156,3537
2022-08-20 17:00:00,2022-08-20 18:00:00,468,22,213,200,903,3364
2022-08-20 18:00:00,2022-08-20 19:00:00,467,0,221,276,964,3305
2022-08-20 19:00:00,2022-08-20 20:00:00,468,0,275,456,1199,3174
2022-08-20 20:00:00,2022-08-20 21:00:00,452,0,346,527,1325,3040
2022-08-20 21:00:00,2022-08-20 22:00:00,385,0,327,512,1224,2893
2022-08-20 22:00:00,2022-08-20 23:00:00,382,0,305,524,1211,2798
2022-08-20 23:00:00,2022-08-21 00:00:00,383,0,327,540,1250,2707
2022-08-21 00:00:00,2022-08-21 01:00:00,404,0,306,632,1342,2652
2022-08-21 01:00:00,2022-08-21 02:00:00,404,0,347,741,1492,2654
2022-08-21 02:00:00,2022-08-21 03:00:00,331,0,454,778,1563,2668
2022-08-21 03:00:00,2022-08-21 04:00:00,274,26,513,878,1691,2691
2022-08-21 04:00:00,2022-08-21 05:00:00,264,172,663,819,1918,2947
2022-08-21 05:00:00,2022-08-21 06:00:00,254,453,686,807,2200,3286
2022-08-21 06:00:00,2022-08-21 07:00:00,247,635,620,980,2482,3409
2022-08-21 07:00:00,2022-08-21 08:00:00,254,855,581,1164,2854,3534
2022-08-21 08:00:00,2022-08-21 09:00:00,244,1029,587,1215,3075,3705
2022-08-21 09:00:00,2022-08-21 10:00:00,215,1085,680,1435,3415,3855
2022-08-21 10:00:00,2022-08-21 11:00:00,212,1106,681,1663,3662,3887
2022-08-21 11:00:00,2022-08-21 12:00:00,218,1127,543,1594,3482,3885
2022-08-21 12:00:00,2022-08-21 13:00:00,238,957,400,1638,3233,3761
2022-08-21 13:00:00,2022-08-21 14:00:00,268,888,441,1685,3282,3686
2022-08-21 14:00:00,2022-08-21 15:00:00,252,724,331,1582,2889,3902
2022-08-21 15:00:00,2022-08-21 16:00:00,280,403,259,1330,2272,3868
2022-08-21 16:00:00,2022-08-21 17:00:00,279,138,275,850,1542,3643
2022-08-21 17:00:00,2022-08-21 18:00:00,278,17,403,497,1195,3518
2022-08-21 18:00:00,2022-08-21 19:00:00,281,0,535,371,1187,3457
2022-08-21 19:00:00,2022-08-21 20:00:00,281,0,429,304,1014,3213
2022-08-21 20:00:00,2022-08-21 21:00:00,279,0,258,285,822,3030
2022-08-21 21:00:00,2022-08-21 22:00:00,268,0,193,214,675,2924
2022-08-21 22:00:00,2022-08-21 23:00:00,266,0,151,149,566,2824
2022-08-21 23:00:00,2022-08-22 00:00:00,266,0,91,105,462,2790
2022-08-22 00:00:00,2022-08-22 01:00:00,267,0,90,80,437,2792
2022-08-22 01:00:00,2022-08-22 02:00:00,264,0,89,62,415,2818
2022-08-22 02:00:00,2022-08-22 03:00:00,267,0,63,59,389,3027
2022-08-22 03:00:00,2022-08-22 04:00:00,267,30,50,62,409,3497
2022-08-22 04:00:00,2022-08-22 05:00:00,268,189,36,58,551,3971
2022-08-22 05:00:00,2022-08-22 06:00:00,268,460,32,53,813,4310
2022-08-22 06:00:00,2022-08-22 07:00:00,269,739,18,57,1083,4426
2022-08-22 07:00:00,2022-08-22 08:00:00,264,954,12,53,1283,4539
2022-08-22 08:00:00,2022-08-22 09:00:00,233,1022,5,56,1316,4498
2022-08-22 09:00:00,2022-08-22 10:00:00,231,1044,6,68,1349,4470
2022-08-22 10:00:00,2022-08-22 11:00:00,255,970,18,76,1319,4428
2022-08-22 11:00:00,2022-08-22 12:00:00,244,945,32,73,1294,4371
2022-08-22 12:00:00,2022-08-22 13:00:00,268,928,37,81,1314,4280
2022-08-22 13:00:00,2022-08-22 14:00:00,271,823,34,92,1220,4240
2022-08-22 14:00:00,2022-08-22 15:00:00,272,664,60,107,1103,4404
2022-08-22 15:00:00,2022-08-22 16:00:00,276,401,71,133,881,4304
2022-08-22 16:00:00,2022-08-22 17:00:00,277,140,101,155,673,4064
2022-08-22 17:00:00,2022-08-22 18:00:00,278,17,103,204,602,3884
2022-08-22 18:00:00,2022-08-22 19:00:00,278,0,121,307,706,3783
2022-08-22 19:00:00,2022-08-22 20:00:00,276,0,130,406,812,3521
2022-08-22 20:00:00,2022-08-22 21:00:00,214,0,134,468,816,3259
2022-08-22 21:00:00,2022-08-22 22:00:00,188,0,158,533,879,3050
2022-08-22 22:00:00,2022-08-22 23:00:00,188,0,149,649,986,2962
2022-08-22 23:00:00,2022-08-23 00:00:00,188,0,131,707,1026,2903
2022-08-23 00:00:00,2022-08-23 01:00:00,188,0,146,720,1054,2891
2022-08-23 01:00:00,2022-08-23 02:00:00,188,0,186,741,1115,2940
2022-08-23 02:00:00,2022-08-23 03:00:00,188,0,287,793,1268,3120
2022-08-23 03:00:00,2022-08-23 04:00:00,188,19,341,885,1433,3611
2022-08-23 04:00:00,2022-08-23 05:00:00,188,129,348,923,1588,4100
2022-08-23 05:00:00,2022-08-23 06:00:00,192,338,368,870,1768,4336
2022-08-23 06:00:00,2022-08-23 07:00:00,194,598,405,948,2145,4415
2022-08-23 07:00:00,2022-08-23 08:00:00,219,926,473,1121,2739,4571
2022-08-23 08:00:00,2022-08-23 09:00:00,217,1213,477,1278,3185,4566
2022-08-23 09:00:00,2022-08-23 10:00:00,214,1355,430,1388,3387,4519
2022-08-23 10:00:00,2022-08-23 11:00:00,214,1346,455,1310,3325,4505
2022-08-23 11:00:00,2022-08-23 12:00:00,214,1277,408,1210,3109,4400
2022-08-23 12:00:00,2022-08-23 13:00:00,214,1138,361,1149,2862,4296
2022-08-23 13:00:00,2022-08-23 14:00:00,214,895,316,1114,2539,4250
2022-08-23 14:00:00,2022-08-23 15:00:00,216,610,293,1082,2201,4380
2022-08-23 15:00:00,2022-08-23 16:00:00,231,327,303,912,1773,4294
2022-08-23 16:00:00,2022-08-23 17:00:00,234,109,282,699,1324,4016
2022-08-23 17:00:00,2022-08-23 18:00:00,234,10,539,724,1507,3841
2022-08-23 18:00:00,2022-08-23 19:00:00,233,0,755,898,1886,3805
2022-08-23 19:00:00,2022-08-23 20:00:00,233,0,799,1015,2047,3560
2022-08-23 20:00:00,2022-08-23 21:00:00,233,0,871,1029,2133,3304
2022-08-23 21:00:00,2022-08-23 22:00:00,233,0,900,907,2040,3118
2022-08-23 22:00:00,2022-08-23 23:00:00,233,0,913,896,2042,2978
2022-08-23 23:00:00,2022-08-24 00:00:00,233,0,782,825,1840,2938
2022-08-24 00:00:00,2022-08-24 01:00:00,233,0,797,695,1725,2905
2022-08-24 01:00:00,2022-08-24 02:00:00,232,0,809,698,1739,2958
2022-08-24 02:00:00,2022-08-24 03:00:00,233,0,781,744,1758,3141
2022-08-24 03:00:00,2022-08-24 04:00:00,212,15,793,855,1875,3604
2022-08-24 04:00:00,2022-08-24 05:00:00,198,122,815,871,2006,4131
2022-08-24 05:00:00,2022-08-24 06:00:00,203,333,786,844,2166,4379
2022-08-24 06:00:00,2022-08-24 07:00:00,200,634,765,963,2562,4465
2022-08-24 07:00:00,2022-08-24 08:00:00,194,901,672,1090,2857,4582
2022-08-24 08:00:00,2022-08-24 09:00:00,193,1142,653,1239,3227,4578
2022-08-24 09:00:00,2022-08-24 10:00:00,193,1320,523,1305,3341,4541
2022-08-24 10:00:00,2022-08-24 11:00:00,199,1347,357,1240,3143,4539
2022-08-24 11:00:00,2022-08-24 12:00:00,94,1373,307,1125,2899,4446
2022-08-24 12:00:00,2022-08-24 13:00:00,120,1284,284,1053,2741,4347
2022-08-24 13:00:00,2022-08-24 14:00:00,162,1057,229,1019,2467,4305
2022-08-24 14:00:00,2022-08-24 15:00:00,178,719,225,916,2038,4454
2022-08-24 15:00:00,2022-08-24 16:00:00,192,370,255,778,1595,4310
2022-08-24 16:00:00,2022-08-24 17:00:00,196,109,259,595,1159,4074
2022-08-24 17:00:00,2022-08-24 18:00:00,203,12,256,563,1034,3850
2022-08-24 18:00:00,2022-08-24 19:00:00,193,0,246,692,1131,3779
2022-08-24 19:00:00,2022-08-24 20:00:00,189,0,331,761,1281,3587
2022-08-24 20:00:00,2022-08-24 21:00:00,197,0,543,800,1540,3341
2022-08-24 21:00:00,2022-08-24 22:00:00,195,0,658,711,1564,3108
2022-08-24 22:00:00,2022-08-24 23:00:00,168,0,545,628,1341,3043
2022-08-24 23:00:00,2022-08-25 00:00:00,178,0,515,671,1364,2930
2022-08-25 00:00:00,2022-08-25 01:00:00,159,0,549,684,1392,2944
2022-08-25 01:00:00,2022-08-25 02:00:00,157,0,552,637,1346,2986
2022-08-25 02:00:00,2022-08-25 03:00:00,169,0,628,624,1421,3152
2022-08-25 03:00:00,2022-08-25 04:00:00,171,18,735,628,1552,3585
2022-08-25 04:00:00,2022-08-25 05:00:00,182,136,803,588,1709,4096
2022-08-25 05:00:00,2022-08-25 06:00:00,186,380,928,532,2026,4310
2022-08-25 06:00:00,2022-08-25 07:00:00,206,676,1012,607,2501,4447
2022-08-25 07:00:00,2022-08-25 08:00:00,164,965,1050,815,2994,4556
2022-08-25 08:00:00,2022-08-25 09:00:00,166,1120,987,1087,3360,4557
2022-08-25 09:00:00,2022-08-25 10:00:00,180,1202,909,1122,3413,4503
2022-08-25 10:00:00,2022-08-25 11:00:00,220,1277,950,1135,3582,4514
2022-08-25 11:00:00,2022-08-25 12:00:00,223,1309,944,1309,3785,4456
2022-08-25 12:00:00,2022-08-25 13:00:00,205,1242,923,1499,3869,4342
2022-08-25 13:00:00,2022-08-25 14:00:00,223,1029,913,1543,3708,4324
2022-08-25 14:00:00,2022-08-25 15:00:00,230,721,1028,1385,3364,4446
2022-08-25 15:00:00,2022-08-25 16:00:00,238,381,1149,1116,2884,4300
2022-08-25 16:00:00,2022-08-25 17:00:00,242,107,1099,954,2402,4075
2022-08-25 17:00:00,2022-08-25 18:00:00,261,8,1129,910,2308,3885
2022-08-25 18:00:00,2022-08-25 19:00:00,261,0,1166,944,2371,3806
2022-08-25 19:00:00,2022-08-25 20:00:00,260,0,1176,982,2418,3591
2022-08-25 20:00:00,2022-08-25 21:00:00,259,0,1148,988,2395,3354
2022-08-25 21:00:00,2022-08-25 22:00:00,239,0,1116,910,2265,3195
2022-08-25 22:00:00,2022-08-25 23:00:00,213,0,956,855,2024,3082
2022-08-25 23:00:00,2022-08-26 00:00:00,267,0,896,772,1935,3009
2022-08-26 00:00:00,2022-08-26 01:00:00,256,0,786,654,1696,2958
2022-08-26 01:00:00,2022-08-26 02:00:00,235,0,714,549,1498,2973
2022-08-26 02:00:00,2022-08-26 03:00:00,229,0,594,493,1316,3189
2022-08-26 03:00:00,2022-08-26 04:00:00,253,13,456,477,1199,3590
2022-08-26 04:00:00,2022-08-26 05:00:00,252,103,393,449,1197,4116
2022-08-26 05:00:00,2022-08-26 06:00:00,245,249,459,399,1352,4356
2022-08-26 06:00:00,2022-08-26 07:00:00,203,312,341,297,1153,4230
2022-08-26 07:00:00,2022-08-26 08:00:00,204,455,277,274,1210,4144
2022-08-26 08:00:00,2022-08-26 09:00:00,230,484,215,245,1174,4133
2022-08-26 09:00:00,2022-08-26 10:00:00,235,520,185,238,1178,4107
2022-08-26 10:00:00,2022-08-26 11:00:00,233,525,151,260,1169,4064
2022-08-26 11:00:00,2022-08-26 12:00:00,233,544,391,343,1511,3828
2022-08-26 12:00:00,2022-08-26 13:00:00,218,399,696,293,1606,3799
2022-08-26 13:00:00,2022-08-26 14:00:00,236,301,778,231,1546,3851
2022-08-26 14:00:00,2022-08-26 15:00:00,233,224,722,165,1344,4098
2022-08-26 15:00:00,2022-08-26 16:00:00,228,149,467,109,953,4012
2022-08-26 16:00:00,2022-08-26 17:00:00,226,50,406,155,837,3751
2022-08-26 17:00:00,2022-08-26 18:00:00,226,6,419,197,848,3609
2022-08-26 18:00:00,2022-08-26 19:00:00,221,0,457,194,872,3491
2022-08-26 19:00:00,2022-08-26 20:00:00,222,0,456,219,897,3287
2022-08-26 20:00:00,2022-08-26 21:00:00,222,0,431,239,892,3073
2022-08-26 21:00:00,2022-08-26 22:00:00,222,0,436,236,894,2884
2022-08-26 22:00:00,2022-08-26 23:00:00,222,0,413,243,878,2738
2022-08-26 23:00:00,2022-08-27 00:00:00,223,0,438,269,930,2671
2022-08-27 00:00:00,2022-08-27 01:00:00,223,0,591,306,1120,2608
2022-08-27 01:00:00,2022-08-27 02:00:00,224,0,772,306,1302,2591
2022-08-27 02:00:00,2022-08-27 03:00:00,224,0,872,324,1420,2604
2022-08-27 03:00:00,2022-08-27 04:00:00,224,2,845,364,1435,2681
2022-08-27 04:00:00,2022-08-27 05:00:00,225,44,764,340,1373,2853
2022-08-27 05:00:00,2022-08-27 06:00:00,224,126,761,318,1429,3132
2022-08-27 06:00:00,2022-08-27 07:00:00,222,212,763,342,1539,3362
2022-08-27 07:00:00,2022-08-27 08:00:00,227,320,768,330,1645,3420
2022-08-27 08:00:00,2022-08-27 09:00:00,226,494,745,290,1755,3432
2022-08-27 09:00:00,2022-08-27 10:00:00,224,578,749,247,1798,3384
2022-08-27 10:00:00,2022-08-27 11:00:00,227,630,760,270,1887,3349
2022-08-27 11:00:00,2022-08-27 12:00:00,231,640,787,339,1997,3260
2022-08-27 12:00:00,2022-08-27 13:00:00,235,628,820,377,2060,3198
2022-08-27 13:00:00,2022-08-27 14:00:00,201,539,822,405,1967,3215
2022-08-27 14:00:00,2022-08-27 15:00:00,185,390,773,410,1758,3414
2022-08-27 15:00:00,2022-08-27 16:00:00,193,227,761,406,1587,3456
2022-08-27 16:00:00,2022-08-27 17:00:00,200,74,764,344,1382,3338
2022-08-27 17:00:00,2022-08-27 18:00:00,201,7,769,251,1228,3291
2022-08-27 18:00:00,2022-08-27 19:00:00,200,0,778,229,1207,3232
2022-08-27 19:00:00,2022-08-27 20:00:00,191,0,750,235,1176,3038
2022-08-27 20:00:00,2022-08-27 21:00:00,192,0,847,264,1303,2857
2022-08-27 21:00:00,2022-08-27 22:00:00,192,0,840,269,1301,2697
2022-08-27 22:00:00,2022-08-27 23:00:00,192,0,847,292,1331,2565
2022-08-27 23:00:00,2022-08-28 00:00:00,192,0,879,320,1391,2497
2022-08-28 00:00:00,2022-08-28 01:00:00,192,0,956,303,1451,2459
2022-08-28 01:00:00,2022-08-28 02:00:00,192,0,991,288,1471,2444
2022-08-28 02:00:00,2022-08-28 03:00:00,192,0,958,301,1451,2468
2022-08-28 03:00:00,2022-08-28 04:00:00,192,7,902,335,1436,2510
2022-08-28 04:00:00,2022-08-28 05:00:00,192,76,952,327,1547,2700
2022-08-28 05:00:00,2022-08-28 06:00:00,192,188,938,299,1617,2929
2022-08-28 06:00:00,2022-08-28 07:00:00,191,267,932,327,1717,3147
2022-08-28 07:00:00,2022-08-28 08:00:00,193,356,945,319,1813,3304
2022-08-28 08:00:00,2022-08-28 09:00:00,192,484,921,329,1926,3358
2022-08-28 09:00:00,2022-08-28 10:00:00,192,542,976,337,2047,3448
2022-08-28 10:00:00,2022-08-28 11:00:00,180,525,1186,375,2266,3545
2022-08-28 11:00:00,2022-08-28 12:00:00,141,553,1354,498,2546,3566
2022-08-28 12:00:00,2022-08-28 13:00:00,161,464,1325,595,2545,3472
2022-08-28 13:00:00,2022-08-28 14:00:00,181,382,1261,580,2404,3410
2022-08-28 14:00:00,2022-08-28 15:00:00,192,293,1280,639,2404,3579
2022-08-28 15:00:00,2022-08-28 16:00:00,194,162,1318,612,2286,3506
2022-08-28 16:00:00,2022-08-28 17:00:00,202,60,1288,556,2106,3369
2022-08-28 17:00:00,2022-08-28 18:00:00,198,5,1188,552,1943,3299
2022-08-28 18:00:00,2022-08-28 19:00:00,199,0,1351,527,2077,3167
2022-08-28 19:00:00,2022-08-28 20:00:00,194,0,1405,629,2228,2891
2022-08-28 20:00:00,2022-08-28 21:00:00,221,0,1454,682,2357,2689
2022-08-28 21:00:00,2022-08-28 22:00:00,228,0,1148,729,2105,2587
2022-08-28 22:00:00,2022-08-28 23:00:00,215,0,1206,689,2110,2529
2022-08-28 23:00:00,2022-08-29 00:00:00,228,0,1196,722,2146,2454
2022-08-29 00:00:00,2022-08-29 01:00:00,195,0,1050,625,1870,2678
2022-08-29 01:00:00,2022-08-29 02:00:00,163,0,1110,823,2096,2501
2022-08-29 02:00:00,2022-08-29 03:00:00,18,0,1182,821,2021,2721
2022-08-29 03:00:00,2022-08-29 04:00:00,4,5,1098,815,1922,3220
2022-08-29 04:00:00,2022-08-29 05:00:00,4,60,961,788,1813,3693
2022-08-29 05:00:00,2022-08-29 06:00:00,4,202,909,762,1877,3843
2022-08-29 06:00:00,2022-08-29 07:00:00,4,424,899,893,2220,3821
2022-08-29 07:00:00,2022-08-29 08:00:00,4,572,836,946,2358,3802
2022-08-29 08:00:00,2022-08-29 09:00:00,4,662,733,925,2324,3667
2022-08-29 09:00:00,2022-08-29 10:00:00,4,734,659,1012,2409,3611
2022-08-29 10:00:00,2022-08-29 11:00:00,4,790,620,1047,2461,3689
2022-08-29 11:00:00,2022-08-29 12:00:00,8,778,608,1067,2461,3620
2022-08-29 12:00:00,2022-08-29 13:00:00,13,706,571,1016,2306,3563
2022-08-29 13:00:00,2022-08-29 14:00:00,14,593,630,854,2091,3574
2022-08-29 14:00:00,2022-08-29 15:00:00,14,423,664,685,1786,3866
2022-08-29 15:00:00,2022-08-29 16:00:00,15,213,611,528,1367,3906
2022-08-29 16:00:00,2022-08-29 17:00:00,15,57,671,360,1103,3788
2022-08-29 17:00:00,2022-08-29 18:00:00,15,4,697,302,1018,3636
2022-08-29 18:00:00,2022-08-29 19:00:00,15,0,631,281,927,3507
2022-08-29 19:00:00,2022-08-29 20:00:00,14,0,548,268,830,3256
2022-08-29 20:00:00,2022-08-29 21:00:00,13,0,417,254,684,3004
2022-08-29 21:00:00,2022-08-29 22:00:00,4,0,386,249,639,2840
2022-08-29 22:00:00,2022-08-29 23:00:00,3,0,429,290,722,2852
2022-08-29 23:00:00,2022-08-30 00:00:00,3,0,393,317,713,2734
2022-08-30 00:00:00,2022-08-30 01:00:00,4,0,342,305,651,2708
2022-08-30 01:00:00,2022-08-30 02:00:00,4,0,312,287,603,2765
2022-08-30 02:00:00,2022-08-30 03:00:00,10,0,252,271,533,2929
2022-08-30 03:00:00,2022-08-30 04:00:00,30,11,267,273,581,3369
2022-08-30 04:00:00,2022-08-30 05:00:00,30,101,308,230,669,3809
2022-08-30 05:00:00,2022-08-30 06:00:00,30,306,258,177,771,3953
2022-08-30 06:00:00,2022-08-30 07:00:00,30,736,276,213,1255,4125
2022-08-30 07:00:00,2022-08-30 08:00:00,29,1072,274,296,1671,4324
2022-08-30 08:00:00,2022-08-30 09:00:00,11,1217,302,320,1850,4332
2022-08-30 09:00:00,2022-08-30 10:00:00,9,1295,247,295,1846,4304
2022-08-30 10:00:00,2022-08-30 11:00:00,13,1235,191,289,1728,4316
2022-08-30 11:00:00,2022-08-30 12:00:00,27,1269,175,284,1755,4250
2022-08-30 12:00:00,2022-08-30 13:00:00,35,1214,230,305,1784,4132
2022-08-30 13:00:00,2022-08-30 14:00:00,42,1008,324,341,1715,4083
2022-08-30 14:00:00,2022-08-30 15:00:00,43,725,442,399,1609,4270
2022-08-30 15:00:00,2022-08-30 16:00:00,43,369,577,454,1443,4166
2022-08-30 16:00:00,2022-08-30 17:00:00,42,88,645,417,1192,3958
2022-08-30 17:00:00,2022-08-30 18:00:00,42,5,661,464,1172,3853
2022-08-30 18:00:00,2022-08-30 19:00:00,42,0,586,511,1139,3689
2022-08-30 19:00:00,2022-08-30 20:00:00,41,0,550,501,1092,3416
2022-08-30 20:00:00,2022-08-30 21:00:00,38,0,366,490,894,3194
2022-08-30 21:00:00,2022-08-30 22:00:00,9,0,299,456,764,3053
2022-08-30 22:00:00,2022-08-30 23:00:00,4,0,195,401,600,2940
2022-08-30 23:00:00,2022-08-31 00:00:00,4,0,138,391,533,2892
2022-08-31 00:00:00,2022-08-31 01:00:00,4,0,106,392,502,2887
2022-08-31 01:00:00,2022-08-31 02:00:00,4,0,87,441,532,2925
2022-08-31 02:00:00,2022-08-31 03:00:00,4,0,96,520,620,3120
2022-08-31 03:00:00,2022-08-31 04:00:00,4,12,147,532,695,3540
2022-08-31 04:00:00,2022-08-31 05:00:00,4,135,185,495,819,3997
2022-08-31 05:00:00,2022-08-31 06:00:00,4,468,160,351,983,4207
2022-08-31 06:00:00,2022-08-31 07:00:00,4,851,145,455,1455,4273
2022-08-31 07:00:00,2022-08-31 08:00:00,4,1113,148,627,1892,4409
2022-08-31 08:00:00,2022-08-31 09:00:00,6,1190,272,569,2037,4409
2022-08-31 09:00:00,2022-08-31 10:00:00,6,1196,286,476,1964,4371
2022-08-31 10:00:00,2022-08-31 11:00:00,13,1218,268,415,1914,4395
2022-08-31 11:00:00,2022-08-31 12:00:00,12,1169,239,387,1807,4366
2022-08-31 12:00:00,2022-08-31 13:00:00,7,1049,211,392,1659,4200
2022-08-31 13:00:00,2022-08-31 14:00:00,10,877,254,420,1561,4147
2022-08-31 14:00:00,2022-08-31 15:00:00,32,667,393,447,1539,4284
2022-08-31 15:00:00,2022-08-31 16:00:00,45,353,516,456,1370,4195
2022-08-31 16:00:00,2022-08-31 17:00:00,47,87,551,381,1066,3987
2022-08-31 17:00:00,2022-08-31 18:00:00,47,5,481,361,894,3853
2022-08-31 18:00:00,2022-08-31 19:00:00,47,0,341,388,776,3710
2022-08-31 19:00:00,2022-08-31 20:00:00,47,0,314,341,702,3461
2022-08-31 20:00:00,2022-08-31 21:00:00,46,0,269,282,597,3230
2022-08-31 21:00:00,2022-08-31 22:00:00,37,0,151,243,431,3069
2022-08-31 22:00:00,2022-08-31 23:00:00,37,0,67,215,319,2973
2022-08-31 23:00:00,2022-09-01 00:00:00,37,0,53,176,266,2907
2022-09-01 00:00:00,2022-09-01 01:00:00,38,0,82,180,300,2897
2022-09-01 01:00:00,2022-09-01 02:00:00,37,0,93,236,366,2941
2022-09-01 02:00:00,2022-09-01 03:00:00,37,0,112,263,412,3120
2022-09-01 03:00:00,2022-09-01 04:00:00,37,10,158,275,480,3566
2022-09-01 04:00:00,2022-09-01 05:00:00,37,128,153,247,565,4022
2022-09-01 05:00:00,2022-09-01 06:00:00,37,453,215,175,880,4242
2022-09-01 06:00:00,2022-09-01 07:00:00,37,865,237,99,1238,4288
2022-09-01 07:00:00,2022-09-01 08:00:00,35,1156,127,107,1425,4404
2022-09-01 08:00:00,2022-09-01 09:00:00,35,1322,95,111,1563,4473
2022-09-01 09:00:00,2022-09-01 10:00:00,36,1439,64,109,1648,4439
2022-09-01 10:00:00,2022-09-01 11:00:00,32,1461,52,103,1648,4470
2022-09-01 11:00:00,2022-09-01 12:00:00,35,1423,61,109,1628,4374
2022-09-01 12:00:00,2022-09-01 13:00:00,40,1273,55,122,1490,4246
2022-09-01 13:00:00,2022-09-01 14:00:00,67,1095,43,150,1355,4183
2022-09-01 14:00:00,2022-09-01 15:00:00,109,752,64,154,1079,4275
2022-09-01 15:00:00,2022-09-01 16:00:00,47,361,106,140,654,4160
2022-09-01 16:00:00,2022-09-01 17:00:00,101,78,147,139,465,3989
2022-09-01 17:00:00,2022-09-01 18:00:00,48,4,163,175,390,3878
2022-09-01 18:00:00,2022-09-01 19:00:00,44,0,159,167,370,3731
2022-09-01 19:00:00,2022-09-01 20:00:00,34,0,149,142,325,3487
2022-09-01 20:00:00,2022-09-01 21:00:00,33,0,82,130,245,3273
2022-09-01 21:00:00,2022-09-01 22:00:00,33,0,66,101,200,3127
2022-09-01 22:00:00,2022-09-01 23:00:00,33,0,58,86,177,3032
2022-09-01 23:00:00,2022-09-02 00:00:00,32,0,63,81,176,2998
2022-09-02 00:00:00,2022-09-02 01:00:00,34,0,68,76,178,2971
2022-09-02 01:00:00,2022-09-02 02:00:00,33,0,65,71,169,2990
2022-09-02 02:00:00,2022-09-02 03:00:00,18,0,71,60,149,3156
2022-09-02 03:00:00,2022-09-02 04:00:00,19,9,56,59,143,3580
2022-09-02 04:00:00,2022-09-02 05:00:00,20,125,54,63,262,4020
2022-09-02 05:00:00,2022-09-02 06:00:00,15,430,104,64,613,4262
2022-09-02 06:00:00,2022-09-02 07:00:00,16,833,159,59,1067,4324
2022-09-02 07:00:00,2022-09-02 08:00:00,13,1131,193,88,1425,4417
2022-09-02 08:00:00,2022-09-02 09:00:00,13,1227,209,129,1578,4391
2022-09-02 09:00:00,2022-09-02 10:00:00,13,1287,177,197,1674,4348
2022-09-02 10:00:00,2022-09-02 11:00:00,13,1296,150,302,1761,4321
2022-09-02 11:00:00,2022-09-02 12:00:00,13,1228,112,413,1766,4086
2022-09-02 12:00:00,2022-09-02 13:00:00,13,1130,108,533,1784,3924
2022-09-02 13:00:00,2022-09-02 14:00:00,17,962,178,674,1831,3897
2022-09-02 14:00:00,2022-09-02 15:00:00,17,635,354,802,1808,3993
2022-09-02 15:00:00,2022-09-02 16:00:00,17,328,633,907,1885,3929
2022-09-02 16:00:00,2022-09-02 17:00:00,18,72,938,833,1861,3699
2022-09-02 17:00:00,2022-09-02 18:00:00,18,3,1228,815,2064,3553
2022-09-02 18:00:00,2022-09-02 19:00:00,17,0,1333,897,2247,3451
2022-09-02 19:00:00,2022-09-02 20:00:00,15,0,1388,1016,2419,3293
2022-09-02 20:00:00,2022-09-02 21:00:00,7,0,1508,1119,2634,3142
2022-09-02 21:00:00,2022-09-02 22:00:00,7,0,1582,1103,2692,2987
2022-09-02 22:00:00,2022-09-02 23:00:00,7,0,1561,1054,2622,2865
2022-09-02 23:00:00,2022-09-03 00:00:00,7,0,1527,1031,2565,2774
2022-09-03 00:00:00,2022-09-03 01:00:00,7,0,1437,1011,2455,2724
2022-09-03 01:00:00,2022-09-03 02:00:00,7,0,1324,949,2280,2704
2022-09-03 02:00:00,2022-09-03 03:00:00,7,0,1335,896,2238,2734
2022-09-03 03:00:00,2022-09-03 04:00:00,7,7,1399,926,2339,2839
2022-09-03 04:00:00,2022-09-03 05:00:00,7,95,1373,856,2331,3068
2022-09-03 05:00:00,2022-09-03 06:00:00,7,346,1343,709,2405,3326
2022-09-03 06:00:00,2022-09-03 07:00:00,7,703,1230,763,2703,3474
2022-09-03 07:00:00,2022-09-03 08:00:00,7,1024,1188,958,3177,3608
2022-09-03 08:00:00,2022-09-03 09:00:00,7,1069,1075,1121,3272,3890
2022-09-03 09:00:00,2022-09-03 10:00:00,7,1037,975,1333,3352,3873
2022-09-03 10:00:00,2022-09-03 11:00:00,7,1070,1111,1492,3680,3771
2022-09-03 11:00:00,2022-09-03 12:00:00,7,1033,1287,1556,3883,3635
2022-09-03 12:00:00,2022-09-03 13:00:00,7,1039,1302,1544,3892,3524
2022-09-03 13:00:00,2022-09-03 14:00:00,27,908,1345,1465,3745,3468
2022-09-03 14:00:00,2022-09-03 15:00:00,111,630,1413,1504,3658,3607
2022-09-03 15:00:00,2022-09-03 16:00:00,160,302,1410,1419,3291,3565
2022-09-03 16:00:00,2022-09-03 17:00:00,220,61,1505,1149,2935,3399
2022-09-03 17:00:00,2022-09-03 18:00:00,276,2,1580,1074,2932,3332
2022-09-03 18:00:00,2022-09-03 19:00:00,283,0,1711,1181,3175,3239
2022-09-03 19:00:00,2022-09-03 20:00:00,169,0,1811,1254,3234,3129
2022-09-03 20:00:00,2022-09-03 21:00:00,130,0,1794,1234,3158,3032
2022-09-03 21:00:00,2022-09-03 22:00:00,126,0,1750,1212,3088,2882
2022-09-03 22:00:00,2022-09-03 23:00:00,122,0,1747,1142,3011,2722
2022-09-03 23:00:00,2022-09-04 00:00:00,124,0,1806,1147,3077,2639
2022-09-04 00:00:00,2022-09-04 01:00:00,124,0,1685,1104,2913,2596
2022-09-04 01:00:00,2022-09-04 02:00:00,124,0,1613,1086,2823,2585
2022-09-04 02:00:00,2022-09-04 03:00:00,124,0,1537,1116,2777,2622
2022-09-04 03:00:00,2022-09-04 04:00:00,124,7,1431,1153,2715,2678
2022-09-04 04:00:00,2022-09-04 05:00:00,125,105,1424,1092,2746,2873
2022-09-04 05:00:00,2022-09-04 06:00:00,213,367,1360,1043,2983,3130
2022-09-04 06:00:00,2022-09-04 07:00:00,299,748,1295,1170,3512,3313
2022-09-04 07:00:00,2022-09-04 08:00:00,167,1068,1118,1275,3628,3434
2022-09-04 08:00:00,2022-09-04 09:00:00,162,1283,1091,1314,3850,3498
2022-09-04 09:00:00,2022-09-04 10:00:00,161,1401,1026,1443,4031,3639
2022-09-04 10:00:00,2022-09-04 11:00:00,163,1403,1066,1481,4113,3758
2022-09-04 11:00:00,2022-09-04 12:00:00,161,1270,1140,1457,4028,3698
2022-09-04 12:00:00,2022-09-04 13:00:00,162,1059,1146,1477,3844,3492
2022-09-04 13:00:00,2022-09-04 14:00:00,171,806,1130,1440,3547,3529
2022-09-04 14:00:00,2022-09-04 15:00:00,232,479,1108,1357,3176,3762
2022-09-04 15:00:00,2022-09-04 16:00:00,336,223,1145,1218,2922,3755
2022-09-04 16:00:00,2022-09-04 17:00:00,364,51,1247,1014,2676,3549
2022-09-04 17:00:00,2022-09-04 18:00:00,364,1,1384,1004,2753,3473
2022-09-04 18:00:00,2022-09-04 19:00:00,362,0,1506,1105,2973,3361
2022-09-04 19:00:00,2022-09-04 20:00:00,393,0,1634,1168,3195,3160
2022-09-04 20:00:00,2022-09-04 21:00:00,398,0,1673,1164,3235,3005
2022-09-04 21:00:00,2022-09-04 22:00:00,380,0,1615,1145,3140,2896
2022-09-04 22:00:00,2022-09-04 23:00:00,312,0,1611,1145,3068,2821
2022-09-04 23:00:00,2022-09-05 00:00:00,362,0,1661,1229,3252,2769
2022-09-05 00:00:00,2022-09-05 01:00:00,363,0,1702,1359,3424,2755
2022-09-05 01:00:00,2022-09-05 02:00:00,346,0,1659,1431,3436,2796
2022-09-05 02:00:00,2022-09-05 03:00:00,364,0,1712,1498,3574,3004
2022-09-05 03:00:00,2022-09-05 04:00:00,377,7,1696,1535,3615,3456
2022-09-05 04:00:00,2022-09-05 05:00:00,386,106,1687,1474,3653,3908
2022-09-05 05:00:00,2022-09-05 06:00:00,386,336,1588,1440,3750,4159
2022-09-05 06:00:00,2022-09-05 07:00:00,385,647,1520,1516,4068,4262
2022-09-05 07:00:00,2022-09-05 08:00:00,387,901,1460,1608,4356,4387
2022-09-05 08:00:00,2022-09-05 09:00:00,387,1024,1439,1748,4598,4449
2022-09-05 09:00:00,2022-09-05 10:00:00,385,1090,1469,1998,4942,4427
2022-09-05 10:00:00,2022-09-05 11:00:00,370,1181,1631,2304,5486,4471
2022-09-05 11:00:00,2022-09-05 12:00:00,385,1052,1720,2365,5522,4344
2022-09-05 12:00:00,2022-09-05 13:00:00,392,931,1634,2294,5251,4209
2022-09-05 13:00:00,2022-09-05 14:00:00,400,675,1573,2232,4880,4157
2022-09-05 14:00:00,2022-09-05 15:00:00,256,441,1582,2108,4387,4364
2022-09-05 15:00:00,2022-09-05 16:00:00,292,213,1692,1814,4011,4200
2022-09-05 16:00:00,2022-09-05 17:00:00,217,54,1735,1530,3536,4051
2022-09-05 17:00:00,2022-09-05 18:00:00,216,1,1761,1447,3425,3893
2022-09-05 18:00:00,2022-09-05 19:00:00,355,0,1776,1472,3603,3649
2022-09-05 19:00:00,2022-09-05 20:00:00,386,0,1831,1567,3784,3480
2022-09-05 20:00:00,2022-09-05 21:00:00,175,0,1924,1619,3718,3303
2022-09-05 21:00:00,2022-09-05 22:00:00,150,0,1961,1499,3610,3308
2022-09-05 22:00:00,2022-09-05 23:00:00,150,1,1957,1464,3572,3166
2022-09-05 23:00:00,2022-09-06 00:00:00,158,0,1897,1372,3427,3137
2022-09-06 00:00:00,2022-09-06 01:00:00,158,0,1683,1273,3114,3098
2022-09-06 01:00:00,2022-09-06 02:00:00,158,0,1422,1391,2971,3122
2022-09-06 02:00:00,2022-09-06 03:00:00,162,0,1312,1329,2803,3287
2022-09-06 03:00:00,2022-09-06 04:00:00,183,8,1283,1157,2631,3756
2022-09-06 04:00:00,2022-09-06 05:00:00,175,107,970,1134,2386,4229
2022-09-06 05:00:00,2022-09-06 06:00:00,185,334,861,1381,2761,4397
2022-09-06 06:00:00,2022-09-06 07:00:00,250,614,1164,2196,4224,4412
2022-09-06 07:00:00,2022-09-06 08:00:00,276,857,1620,2497,5250,4376
2022-09-06 08:00:00,2022-09-06 09:00:00,305,1057,1743,2546,5651,4421
2022-09-06 09:00:00,2022-09-06 10:00:00,319,1080,1738,2458,5595,4416
2022-09-06 10:00:00,2022-09-06 11:00:00,313,1167,1637,2384,5501,4415
2022-09-06 11:00:00,2022-09-06 12:00:00,312,1155,1511,2344,5322,4333
2022-09-06 12:00:00,2022-09-06 13:00:00,196,1026,1432,2225,4879,4183
2022-09-06 13:00:00,2022-09-06 14:00:00,323,857,1488,2091,4759,4093
2022-09-06 14:00:00,2022-09-06 15:00:00,267,539,1532,2023,4361,4246
2022-09-06 15:00:00,2022-09-06 16:00:00,371,221,1519,1905,4016,4236
2022-09-06 16:00:00,2022-09-06 17:00:00,241,44,1579,1678,3542,4028
2022-09-06 17:00:00,2022-09-06 18:00:00,224,1,1587,1563,3375,3927
2022-09-06 18:00:00,2022-09-06 19:00:00,371,0,1633,1530,3534,3728
2022-09-06 19:00:00,2022-09-06 20:00:00,382,0,1615,1473,3470,3469
2022-09-06 20:00:00,2022-09-06 21:00:00,363,0,1567,1507,3437,3279
2022-09-06 21:00:00,2022-09-06 22:00:00,335,0,1550,1516,3401,3103
2022-09-06 22:00:00,2022-09-06 23:00:00,338,0,1441,1455,3234,2998
2022-09-06 23:00:00,2022-09-07 00:00:00,363,0,1345,1405,3113,2930
2022-09-07 00:00:00,2022-09-07 01:00:00,379,0,1333,1400,3112,2887
2022-09-07 01:00:00,2022-09-07 02:00:00,380,0,1380,1389,3149,2936
2022-09-07 02:00:00,2022-09-07 03:00:00,380,0,1299,1422,3101,3206
2022-09-07 03:00:00,2022-09-07 04:00:00,380,7,1353,1422,3162,3632
2022-09-07 04:00:00,2022-09-07 05:00:00,380,87,1346,1441,3254,4048
2022-09-07 05:00:00,2022-09-07 06:00:00,380,243,1357,1452,3432,4277
2022-09-07 06:00:00,2022-09-07 07:00:00,360,429,1176,1548,3513,4357
2022-09-07 07:00:00,2022-09-07 08:00:00,355,601,1090,1706,3752,4445
2022-09-07 08:00:00,2022-09-07 09:00:00,389,752,1162,1849,4152,4403
2022-09-07 09:00:00,2022-09-07 10:00:00,382,811,1279,1987,4459,4361
2022-09-07 10:00:00,2022-09-07 11:00:00,354,736,1542,2101,4733,4378
2022-09-07 11:00:00,2022-09-07 12:00:00,374,551,1737,2059,4721,4265
2022-09-07 12:00:00,2022-09-07 13:00:00,376,396,1720,1933,4425,4151
2022-09-07 13:00:00,2022-09-07 14:00:00,376,232,1607,1831,4046,4118
2022-09-07 14:00:00,2022-09-07 15:00:00,373,148,1564,1658,3743,4319
2022-09-07 15:00:00,2022-09-07 16:00:00,372,87,1629,1595,3683,4252
2022-09-07 16:00:00,2022-09-07 17:00:00,370,19,1704,1578,3671,4020
2022-09-07 17:00:00,2022-09-07 18:00:00,369,1,1732,1601,3703,3899
2022-09-07 18:00:00,2022-09-07 19:00:00,374,0,1636,1629,3639,3660
2022-09-07 19:00:00,2022-09-07 20:00:00,387,0,1592,1584,3563,3378
2022-09-07 20:00:00,2022-09-07 21:00:00,219,0,1595,1543,3357,3163
2022-09-07 21:00:00,2022-09-07 22:00:00,328,0,1538,1637,3503,3065
2022-09-07 22:00:00,2022-09-07 23:00:00,176,0,1476,1668,3320,2963
2022-09-07 23:00:00,2022-09-08 00:00:00,156,0,1514,1690,3360,2865
2022-09-08 00:00:00,2022-09-08 01:00:00,156,0,1634,1811,3601,2862
2022-09-08 01:00:00,2022-09-08 02:00:00,195,0,1698,1942,3835,2891
2022-09-08 02:00:00,2022-09-08 03:00:00,190,0,1757,1991,3938,3060
2022-09-08 03:00:00,2022-09-08 04:00:00,459,3,1816,1966,4244,3525
2022-09-08 04:00:00,2022-09-08 05:00:00,575,62,1843,2081,4561,3958
2022-09-08 05:00:00,2022-09-08 06:00:00,547,182,1916,2463,5108,4210
2022-09-08 06:00:00,2022-09-08 07:00:00,550,415,2005,2839,5809,4311
2022-09-08 07:00:00,2022-09-08 08:00:00,382,515,1915,3095,5907,4520
2022-09-08 08:00:00,2022-09-08 09:00:00,449,537,1967,3215,6168,4394
2022-09-08 09:00:00,2022-09-08 10:00:00,331,600,2018,3248,6197,4335
2022-09-08 10:00:00,2022-09-08 11:00:00,335,627,2015,3328,6305,4392
2022-09-08 11:00:00,2022-09-08 12:00:00,281,578,1952,3522,6333,4345
2022-09-08 12:00:00,2022-09-08 13:00:00,393,413,1965,3469,6240,4217
2022-09-08 13:00:00,2022-09-08 14:00:00,407,275,1963,3327,5972,4197
2022-09-08 14:00:00,2022-09-08 15:00:00,412,157,1881,3134,5584,4381
2022-09-08 15:00:00,2022-09-08 16:00:00,411,69,1766,2811,5057,4201
2022-09-08 16:00:00,2022-09-08 17:00:00,411,15,1963,2600,4989,3988
2022-09-08 17:00:00,2022-09-08 18:00:00,413,0,2030,2575,5018,3879
2022-09-08 18:00:00,2022-09-08 19:00:00,394,0,2042,2661,5097,3670
2022-09-08 19:00:00,2022-09-08 20:00:00,198,0,1989,2943,5130,3572
2022-09-08 20:00:00,2022-09-08 21:00:00,172,0,1913,2814,4899,3433
2022-09-08 21:00:00,2022-09-08 22:00:00,173,0,1875,2506,4554,3203
2022-09-08 22:00:00,2022-09-08 23:00:00,172,0,1709,2381,4262,3124
2022-09-08 23:00:00,2022-09-09 00:00:00,142,0,1510,2276,3928,3091
2022-09-09 00:00:00,2022-09-09 01:00:00,240,0,1073,2086,3399,3058
2022-09-09 01:00:00,2022-09-09 02:00:00,256,0,824,1869,2949,3049
2022-09-09 02:00:00,2022-09-09 03:00:00,374,0,688,1638,2700,3220
2022-09-09 03:00:00,2022-09-09 04:00:00,392,1,595,1511,2499,3706
2022-09-09 04:00:00,2022-09-09 05:00:00,399,17,559,1391,2366,4123
2022-09-09 05:00:00,2022-09-09 06:00:00,398,85,579,1291,2353,4349
2022-09-09 06:00:00,2022-09-09 07:00:00,401,193,546,1242,2382,4415
2022-09-09 07:00:00,2022-09-09 08:00:00,398,285,543,1064,2290,4438
2022-09-09 08:00:00,2022-09-09 09:00:00,386,395,541,906,2228,4413
2022-09-09 09:00:00,2022-09-09 10:00:00,390,526,529,705,2150,4287
2022-09-09 10:00:00,2022-09-09 11:00:00,390,643,394,523,1950,4217
2022-09-09 11:00:00,2022-09-09 12:00:00,409,666,396,455,1926,4063
2022-09-09 12:00:00,2022-09-09 13:00:00,407,710,438,396,1951,3922
2022-09-09 13:00:00,2022-09-09 14:00:00,415,597,360,367,1739,3903
2022-09-09 14:00:00,2022-09-09 15:00:00,415,359,344,324,1442,4057
2022-09-09 15:00:00,2022-09-09 16:00:00,415,164,376,347,1302,3958
2022-09-09 16:00:00,2022-09-09 17:00:00,417,29,396,360,1202,3737
2022-09-09 17:00:00,2022-09-09 18:00:00,415,1,380,368,1164,3593
2022-09-09 18:00:00,2022-09-09 19:00:00,415,0,353,437,1205,3388
2022-09-09 19:00:00,2022-09-09 20:00:00,410,0,335,474,1219,3192
2022-09-09 20:00:00,2022-09-09 21:00:00,378,0,253,462,1093,3007
2022-09-09 21:00:00,2022-09-09 22:00:00,363,0,322,440,1125,2889
2022-09-09 22:00:00,2022-09-09 23:00:00,394,0,384,340,1118,2809
2022-09-09 23:00:00,2022-09-10 00:00:00,394,0,470,302,1166,2745
2022-09-10 00:00:00,2022-09-10 01:00:00,394,0,515,328,1237,2706
2022-09-10 01:00:00,2022-09-10 02:00:00,394,0,409,345,1148,2677
2022-09-10 02:00:00,2022-09-10 03:00:00,403,0,333,318,1054,2701
2022-09-10 03:00:00,2022-09-10 04:00:00,406,2,362,272,1042,2792
2022-09-10 04:00:00,2022-09-10 05:00:00,406,59,250,279,994,2983
2022-09-10 05:00:00,2022-09-10 06:00:00,405,201,252,251,1109,3244
2022-09-10 06:00:00,2022-09-10 07:00:00,405,341,206,230,1182,3397
2022-09-10 07:00:00,2022-09-10 08:00:00,404,504,186,267,1361,3532
2022-09-10 08:00:00,2022-09-10 09:00:00,406,683,181,278,1548,3567
2022-09-10 09:00:00,2022-09-10 10:00:00,407,755,133,291,1586,3569
2022-09-10 10:00:00,2022-09-10 11:00:00,392,860,126,314,1692,3584
2022-09-10 11:00:00,2022-09-10 12:00:00,374,856,123,337,1690,3537
2022-09-10 12:00:00,2022-09-10 13:00:00,380,730,121,321,1552,3434
2022-09-10 13:00:00,2022-09-10 14:00:00,402,610,116,317,1445,3463
2022-09-10 14:00:00,2022-09-10 15:00:00,409,393,133,330,1265,3623
2022-09-10 15:00:00,2022-09-10 16:00:00,409,176,165,330,1080,3604
2022-09-10 16:00:00,2022-09-10 17:00:00,413,32,249,332,1026,3391
2022-09-10 17:00:00,2022-09-10 18:00:00,412,0,279,331,1022,3313
2022-09-10 18:00:00,2022-09-10 19:00:00,414,0,209,310,933,3178
2022-09-10 19:00:00,2022-09-10 20:00:00,415,0,171,251,837,3008
2022-09-10 20:00:00,2022-09-10 21:00:00,403,0,130,210,743,2840
2022-09-10 21:00:00,2022-09-10 22:00:00,400,0,75,175,650,2731
2022-09-10 22:00:00,2022-09-10 23:00:00,396,0,59,173,628,2652
2022-09-10 23:00:00,2022-09-11 00:00:00,391,0,36,173,600,2606
2022-09-11 00:00:00,2022-09-11 01:00:00,388,0,46,180,614,2565
2022-09-11 01:00:00,2022-09-11 02:00:00,391,0,70,198,659,2552
2022-09-11 02:00:00,2022-09-11 03:00:00,392,0,88,209,689,2584
2022-09-11 03:00:00,2022-09-11 04:00:00,399,2,147,199,747,2658
2022-09-11 04:00:00,2022-09-11 05:00:00,403,67,175,188,833,2818
2022-09-11 05:00:00,2022-09-11 06:00:00,405,295,156,179,1035,3093
2022-09-11 06:00:00,2022-09-11 07:00:00,395,630,110,146,1281,3301
2022-09-11 07:00:00,2022-09-11 08:00:00,379,892,136,160,1567,3384
2022-09-11 08:00:00,2022-09-11 09:00:00,377,1026,100,174,1677,3467
2022-09-11 09:00:00,2022-09-11 10:00:00,368,1042,99,156,1665,3476
2022-09-11 10:00:00,2022-09-11 11:00:00,368,984,94,150,1596,3552
2022-09-11 11:00:00,2022-09-11 12:00:00,371,881,100,159,1511,3590
2022-09-11 12:00:00,2022-09-11 13:00:00,380,807,96,143,1426,3509
2022-09-11 13:00:00,2022-09-11 14:00:00,397,624,96,145,1262,3518
2022-09-11 14:00:00,2022-09-11 15:00:00,410,443,63,151,1067,3708
2022-09-11 15:00:00,2022-09-11 16:00:00,421,204,42,151,818,3709
2022-09-11 16:00:00,2022-09-11 17:00:00,422,29,65,114,630,3540
2022-09-11 17:00:00,2022-09-11 18:00:00,424,1,71,97,593,3477
2022-09-11 18:00:00,2022-09-11 19:00:00,419,0,92,82,593,3316
2022-09-11 19:00:00,2022-09-11 20:00:00,413,0,108,63,584,3144
2022-09-11 20:00:00,2022-09-11 21:00:00,400,0,61,56,517,2987
2022-09-11 21:00:00,2022-09-11 22:00:00,371,0,37,52,460,2881
2022-09-11 22:00:00,2022-09-11 23:00:00,352,0,22,50,424,2784
2022-09-11 23:00:00,2022-09-12 00:00:00,351,0,18,56,425,2735
2022-09-12 00:00:00,2022-09-12 01:00:00,352,0,55,71,478,2717
2022-09-12 01:00:00,2022-09-12 02:00:00,371,0,105,134,610,2756
2022-09-12 02:00:00,2022-09-12 03:00:00,391,0,123,236,750,2983
2022-09-12 03:00:00,2022-09-12 04:00:00,406,3,194,340,943,3478
2022-09-12 04:00:00,2022-09-12 05:00:00,408,83,256,418,1165,3926
2022-09-12 05:00:00,2022-09-12 06:00:00,398,265,306,463,1432,4147
2022-09-12 06:00:00,2022-09-12 07:00:00,377,504,375,414,1670,4225
2022-09-12 07:00:00,2022-09-12 08:00:00,354,718,476,423,1971,4355
2022-09-12 08:00:00,2022-09-12 09:00:00,339,783,539,602,2263,4374
2022-09-12 09:00:00,2022-09-12 10:00:00,322,821,643,851,2637,4327
2022-09-12 10:00:00,2022-09-12 11:00:00,318,753,725,1141,2937,4352
2022-09-12 11:00:00,2022-09-12 12:00:00,319,669,806,1270,3064,4318
2022-09-12 12:00:00,2022-09-12 13:00:00,320,491,826,1342,2979,4197
2022-09-12 13:00:00,2022-09-12 14:00:00,331,350,865,1348,2894,4144
2022-09-12 14:00:00,2022-09-12 15:00:00,371,195,990,1425,2981,4337
2022-09-12 15:00:00,2022-09-12 16:00:00,374,81,1040,1462,2957,4258
2022-09-12 16:00:00,2022-09-12 17:00:00,373,11,1178,1640,3202,4047
2022-09-12 17:00:00,2022-09-12 18:00:00,374,0,1282,1926,3582,3901
2022-09-12 18:00:00,2022-09-12 19:00:00,374,0,1384,2240,3998,3685
2022-09-12 19:00:00,2022-09-12 20:00:00,370,0,1516,2436,4322,3397
2022-09-12 20:00:00,2022-09-12 21:00:00,310,0,1425,2084,3819,3154
2022-09-12 21:00:00,2022-09-12 22:00:00,334,0,1227,1477,3038,3020
2022-09-12 22:00:00,2022-09-12 23:00:00,348,0,1344,1269,2961,2883
2022-09-12 23:00:00,2022-09-13 00:00:00,347,0,1720,1290,3357,2874
2022-09-13 00:00:00,2022-09-13 01:00:00,338,0,1926,1620,3884,2842
2022-09-13 01:00:00,2022-09-13 02:00:00,348,0,1983,1693,4024,2840
2022-09-13 02:00:00,2022-09-13 03:00:00,346,0,1942,1686,3974,3043
2022-09-13 03:00:00,2022-09-13 04:00:00,356,1,1869,1701,3927,3556
2022-09-13 04:00:00,2022-09-13 05:00:00,368,51,1776,1730,3925,3975
2022-09-13 05:00:00,2022-09-13 06:00:00,368,241,1761,1674,4044,4173
2022-09-13 06:00:00,2022-09-13 07:00:00,368,545,1728,1933,4574,4229
2022-09-13 07:00:00,2022-09-13 08:00:00,378,721,1736,2449,5284,4353
2022-09-13 08:00:00,2022-09-13 09:00:00,363,865,1663,2790,5681,4350
2022-09-13 09:00:00,2022-09-13 10:00:00,352,1007,1812,3062,6233,4305
2022-09-13 10:00:00,2022-09-13 11:00:00,319,1031,1774,3195,6319,4366
2022-09-13 11:00:00,2022-09-13 12:00:00,188,896,1808,3306,6198,4316
2022-09-13 12:00:00,2022-09-13 13:00:00,150,732,1917,3387,6186,4208
2022-09-13 13:00:00,2022-09-13 14:00:00,305,507,1975,3325,6112,4164
2022-09-13 14:00:00,2022-09-13 15:00:00,249,299,1987,3248,5783,4361
2022-09-13 15:00:00,2022-09-13 16:00:00,337,114,2061,3136,5648,4219
2022-09-13 16:00:00,2022-09-13 17:00:00,369,12,2070,3099,5550,3964
2022-09-13 17:00:00,2022-09-13 18:00:00,385,0,2069,3096,5550,3836
2022-09-13 18:00:00,2022-09-13 19:00:00,387,0,2065,3173,5625,3604
2022-09-13 19:00:00,2022-09-13 20:00:00,383,0,2035,3163,5581,3384
2022-09-13 20:00:00,2022-09-13 21:00:00,370,0,2044,3096,5510,3172
2022-09-13 21:00:00,2022-09-13 22:00:00,348,0,2046,2884,5278,3012
2022-09-13 22:00:00,2022-09-13 23:00:00,327,0,2029,2745,5101,2959
2022-09-13 23:00:00,2022-09-14 00:00:00,307,0,1987,2536,4830,2878
2022-09-14 00:00:00,2022-09-14 01:00:00,294,0,1985,2360,4639,2825
2022-09-14 01:00:00,2022-09-14 02:00:00,321,0,1963,2199,4483,2835
2022-09-14 02:00:00,2022-09-14 03:00:00,314,0,1900,2014,4228,3055
2022-09-14 03:00:00,2022-09-14 04:00:00,304,1,1785,1814,3904,3550
2022-09-14 04:00:00,2022-09-14 05:00:00,322,52,1651,1656,3681,3973
2022-09-14 05:00:00,2022-09-14 06:00:00,323,191,1449,1670,3633,4162
2022-09-14 06:00:00,2022-09-14 07:00:00,332,402,1375,1671,3780,4173
2022-09-14 07:00:00,2022-09-14 08:00:00,328,548,1287,1760,3923,4236
2022-09-14 08:00:00,2022-09-14 09:00:00,329,678,1359,1837,4203,4226
2022-09-14 09:00:00,2022-09-14 10:00:00,326,743,1335,1986,4390,4211
2022-09-14 10:00:00,2022-09-14 11:00:00,326,826,1241,1960,4353,4281
2022-09-14 11:00:00,2022-09-14 12:00:00,331,720,1152,1917,4120,4181
2022-09-14 12:00:00,2022-09-14 13:00:00,339,664,1170,1912,4085,4085
2022-09-14 13:00:00,2022-09-14 14:00:00,337,400,1092,1871,3700,4127
2022-09-14 14:00:00,2022-09-14 15:00:00,345,287,1306,1726,3664,4294
2022-09-14 15:00:00,2022-09-14 16:00:00,340,118,1440,1606,3504,4150
2022-09-14 16:00:00,2022-09-14 17:00:00,343,16,1493,1466,3318,3924
2022-09-14 17:00:00,2022-09-14 18:00:00,338,0,1524,1466,3328,3833
2022-09-14 18:00:00,2022-09-14 19:00:00,322,0,1673,1494,3489,3586
2022-09-14 19:00:00,2022-09-14 20:00:00,327,0,1820,1552,3699,3390
2022-09-14 20:00:00,2022-09-14 21:00:00,254,0,1762,1585,3601,3198
2022-09-14 21:00:00,2022-09-14 22:00:00,301,0,1645,1628,3574,2979
2022-09-14 22:00:00,2022-09-14 23:00:00,298,0,1676,1721,3695,2894
2022-09-14 23:00:00,2022-09-15 00:00:00,296,0,1783,1775,3854,2845
2022-09-15 00:00:00,2022-09-15 01:00:00,299,0,1822,1803,3924,2851
2022-09-15 01:00:00,2022-09-15 02:00:00,308,0,1907,1947,4162,2891
2022-09-15 02:00:00,2022-09-15 03:00:00,256,0,1597,2027,3880,3053
2022-09-15 03:00:00,2022-09-15 04:00:00,356,1,1600,2094,4051,3536
2022-09-15 04:00:00,2022-09-15 05:00:00,420,61,1615,2133,4229,3984
2022-09-15 05:00:00,2022-09-15 06:00:00,498,316,1645,2273,4732,4136
2022-09-15 06:00:00,2022-09-15 07:00:00,518,644,1647,2727,5536,4202
2022-09-15 07:00:00,2022-09-15 08:00:00,620,854,1630,3009,6113,4321
2022-09-15 08:00:00,2022-09-15 09:00:00,503,1052,1557,3115,6227,4401
2022-09-15 09:00:00,2022-09-15 10:00:00,432,1103,1565,3144,6244,4348
2022-09-15 10:00:00,2022-09-15 11:00:00,513,1169,1565,3240,6487,4318
2022-09-15 11:00:00,2022-09-15 12:00:00,508,1141,1527,3305,6481,4254
2022-09-15 12:00:00,2022-09-15 13:00:00,514,1064,1560,3398,6536,4178
2022-09-15 13:00:00,2022-09-15 14:00:00,460,827,1587,3451,6325,4121
2022-09-15 14:00:00,2022-09-15 15:00:00,347,516,1557,3285,5705,4372
2022-09-15 15:00:00,2022-09-15 16:00:00,314,172,1611,2951,5048,4288
2022-09-15 16:00:00,2022-09-15 17:00:00,336,18,1616,2728,4698,4029
2022-09-15 17:00:00,2022-09-15 18:00:00,358,0,1592,2917,4867,3824
2022-09-15 18:00:00,2022-09-15 19:00:00,495,0,1659,2896,5050,3652
2022-09-15 19:00:00,2022-09-15 20:00:00,387,0,1605,2870,4862,3450
2022-09-15 20:00:00,2022-09-15 21:00:00,375,0,1607,2860,4842,3228
2022-09-15 21:00:00,2022-09-15 22:00:00,400,0,1641,2899,4940,3110
2022-09-15 22:00:00,2022-09-15 23:00:00,459,0,1659,2746,4864,3019
2022-09-15 23:00:00,2022-09-16 00:00:00,410,0,1581,2654,4645,2909
2022-09-16 00:00:00,2022-09-16 01:00:00,312,0,1617,2471,4400,2883
2022-09-16 01:00:00,2022-09-16 02:00:00,330,0,1663,2184,4177,2896
2022-09-16 02:00:00,2022-09-16 03:00:00,413,0,1635,2087,4135,3072
2022-09-16 03:00:00,2022-09-16 04:00:00,444,1,1587,1855,3887,3555
2022-09-16 04:00:00,2022-09-16 05:00:00,482,43,1465,1591,3581,3937
2022-09-16 05:00:00,2022-09-16 06:00:00,586,200,1388,1362,3536,4126
2022-09-16 06:00:00,2022-09-16 07:00:00,603,422,1428,1158,3611,4194
2022-09-16 07:00:00,2022-09-16 08:00:00,405,711,1353,1094,3563,4318
2022-09-16 08:00:00,2022-09-16 09:00:00,298,952,1360,1076,3686,4354
2022-09-16 09:00:00,2022-09-16 10:00:00,333,1088,1326,1060,3807,4363
2022-09-16 10:00:00,2022-09-16 11:00:00,308,1116,1272,1083,3779,4299
2022-09-16 11:00:00,2022-09-16 12:00:00,297,1114,1220,1128,3759,4171
2022-09-16 12:00:00,2022-09-16 13:00:00,295,1028,1199,1168,3690,4009
2022-09-16 13:00:00,2022-09-16 14:00:00,315,789,1129,1060,3293,4018
2022-09-16 14:00:00,2022-09-16 15:00:00,366,489,1066,922,2843,4087
2022-09-16 15:00:00,2022-09-16 16:00:00,655,189,908,737,2489,4001
2022-09-16 16:00:00,2022-09-16 17:00:00,595,16,855,720,2186,3776
2022-09-16 17:00:00,2022-09-16 18:00:00,547,1,805,873,2226,3611
2022-09-16 18:00:00,2022-09-16 19:00:00,452,0,792,1060,2304,3401
2022-09-16 19:00:00,2022-09-16 20:00:00,353,0,869,1194,2416,3208
2022-09-16 20:00:00,2022-09-16 21:00:00,311,0,1190,1191,2692,3052
2022-09-16 21:00:00,2022-09-16 22:00:00,303,0,1258,1143,2704,2942
2022-09-16 22:00:00,2022-09-16 23:00:00,315,0,1225,1108,2648,2797
2022-09-16 23:00:00,2022-09-17 00:00:00,305,0,1168,1068,2541,2758
2022-09-17 00:00:00,2022-09-17 01:00:00,295,0,1135,984,2414,2664
2022-09-17 01:00:00,2022-09-17 02:00:00,303,0,1245,910,2458,2695
2022-09-17 02:00:00,2022-09-17 03:00:00,297,0,1141,838,2276,2726
2022-09-17 03:00:00,2022-09-17 04:00:00,290,1,1120,776,2187,2805
2022-09-17 04:00:00,2022-09-17 05:00:00,295,53,1169,756,2273,3049
2022-09-17 05:00:00,2022-09-17 06:00:00,346,223,1155,667,2391,3342
2022-09-17 06:00:00,2022-09-17 07:00:00,327,472,1082,632,2513,3479
2022-09-17 07:00:00,2022-09-17 08:00:00,288,824,982,649,2743,3579
2022-09-17 08:00:00,2022-09-17 09:00:00,294,1003,904,722,2923,3662
2022-09-17 09:00:00,2022-09-17 10:00:00,291,1036,896,938,3161,3712
2022-09-17 10:00:00,2022-09-17 11:00:00,296,930,1040,1162,3428,3924
2022-09-17 11:00:00,2022-09-17 12:00:00,325,861,1020,1238,3444,3797
2022-09-17 12:00:00,2022-09-17 13:00:00,321,702,962,1278,3263,3706
2022-09-17 13:00:00,2022-09-17 14:00:00,320,570,906,1417,3213,3712
2022-09-17 14:00:00,2022-09-17 15:00:00,343,359,962,1454,3118,3764
2022-09-17 15:00:00,2022-09-17 16:00:00,346,127,1137,1381,2991,3669
2022-09-17 16:00:00,2022-09-17 17:00:00,333,13,1272,1370,2988,3484
2022-09-17 17:00:00,2022-09-17 18:00:00,322,1,1319,1432,3074,3392
2022-09-17 18:00:00,2022-09-17 19:00:00,337,0,1275,1459,3071,3200
2022-09-17 19:00:00,2022-09-17 20:00:00,300,0,1399,1542,3241,3045
2022-09-17 20:00:00,2022-09-17 21:00:00,293,0,1348,1623,3264,2952
2022-09-17 21:00:00,2022-09-17 22:00:00,311,0,1370,1598,3279,2897
2022-09-17 22:00:00,2022-09-17 23:00:00,318,0,1219,1669,3206,2826
2022-09-17 23:00:00,2022-09-18 00:00:00,309,0,1066,1736,3111,2747
2022-09-18 00:00:00,2022-09-18 01:00:00,316,1,1072,1760,3149,2667
2022-09-18 01:00:00,2022-09-18 02:00:00,327,1,1162,1830,3320,2646
2022-09-18 02:00:00,2022-09-18 03:00:00,319,1,927,1874,3121,2651
2022-09-18 03:00:00,2022-09-18 04:00:00,369,1,1072,1669,3111,2780
2022-09-18 04:00:00,2022-09-18 05:00:00,332,40,1209,1483,3064,2894
2022-09-18 05:00:00,2022-09-18 06:00:00,324,195,1388,1376,3283,3207
2022-09-18 06:00:00,2022-09-18 07:00:00,356,416,1428,1329,3529,3401
2022-09-18 07:00:00,2022-09-18 08:00:00,305,590,1475,1390,3760,3531
2022-09-18 08:00:00,2022-09-18 09:00:00,358,663,1301,1181,3503,3569
2022-09-18 09:00:00,2022-09-18 10:00:00,385,738,1150,923,3196,3626
2022-09-18 10:00:00,2022-09-18 11:00:00,299,823,1091,874,3087,3646
2022-09-18 11:00:00,2022-09-18 12:00:00,307,884,1147,949,3287,3685
2022-09-18 12:00:00,2022-09-18 13:00:00,295,913,981,1065,3254,3708
2022-09-18 13:00:00,2022-09-18 14:00:00,349,688,1045,1067,3149,3711
2022-09-18 14:00:00,2022-09-18 15:00:00,359,417,1029,956,2761,3936
2022-09-18 15:00:00,2022-09-18 16:00:00,500,137,1025,690,2352,3845
2022-09-18 16:00:00,2022-09-18 17:00:00,485,12,1099,744,2340,3649
2022-09-18 17:00:00,2022-09-18 18:00:00,476,1,914,939,2330,3553
2022-09-18 18:00:00,2022-09-18 19:00:00,397,1,951,994,2343,3383
2022-09-18 19:00:00,2022-09-18 20:00:00,520,1,846,937,2304,3227
2022-09-18 20:00:00,2022-09-18 21:00:00,511,1,662,889,2063,3025
2022-09-18 21:00:00,2022-09-18 22:00:00,352,1,686,892,1931,2934
2022-09-18 22:00:00,2022-09-18 23:00:00,345,1,694,866,1906,2826
2022-09-18 23:00:00,2022-09-19 00:00:00,277,1,790,876,1944,2790
2022-09-19 00:00:00,2022-09-19 01:00:00,287,1,887,831,2006,2763
2022-09-19 01:00:00,2022-09-19 02:00:00,306,1,844,861,2012,2840
2022-09-19 02:00:00,2022-09-19 03:00:00,298,1,851,827,1977,3027
2022-09-19 03:00:00,2022-09-19 04:00:00,551,1,966,781,2299,3511
2022-09-19 04:00:00,2022-09-19 05:00:00,603,45,935,699,2282,3955
2022-09-19 05:00:00,2022-09-19 06:00:00,552,291,982,531,2356,4131
2022-09-19 06:00:00,2022-09-19 07:00:00,549,676,847,466,2538,4231
2022-09-19 07:00:00,2022-09-19 08:00:00,537,969,935,555,2996,4301
2022-09-19 08:00:00,2022-09-19 09:00:00,567,1153,742,559,3021,4253
2022-09-19 09:00:00,2022-09-19 10:00:00,516,1230,791,592,3129,4210
2022-09-19 10:00:00,2022-09-19 11:00:00,520,1161,956,673,3310,4266
2022-09-19 11:00:00,2022-09-19 12:00:00,492,1128,1023,790,3433,4136
2022-09-19 12:00:00,2022-09-19 13:00:00,403,1019,1153,897,3472,4001
2022-09-19 13:00:00,2022-09-19 14:00:00,494,839,1297,944,3574,4005
2022-09-19 14:00:00,2022-09-19 15:00:00,547,521,1435,919,3422,4163
2022-09-19 15:00:00,2022-09-19 16:00:00,500,157,1561,701,2919,4114
2022-09-19 16:00:00,2022-09-19 17:00:00,509,10,1442,525,2486,3901
2022-09-19 17:00:00,2022-09-19 18:00:00,538,1,1382,541,2462,3764
2022-09-19 18:00:00,2022-09-19 19:00:00,605,1,1346,556,2508,3549
2022-09-19 19:00:00,2022-09-19 20:00:00,577,1,1199,543,2320,3352
2022-09-19 20:00:00,2022-09-19 21:00:00,616,1,992,458,2067,3120
2022-09-19 21:00:00,2022-09-19 22:00:00,591,1,870,419,1881,2992
2022-09-19 22:00:00,2022-09-19 23:00:00,578,1,773,414,1766,2913
2022-09-19 23:00:00,2022-09-20 00:00:00,591,1,691,418,1701,2848
2022-09-20 00:00:00,2022-09-20 01:00:00,510,1,1010,402,1923,2814
2022-09-20 01:00:00,2022-09-20 02:00:00,424,1,1009,384,1818,2834
2022-09-20 02:00:00,2022-09-20 03:00:00,490,1,849,356,1696,3050
2022-09-20 03:00:00,2022-09-20 04:00:00,563,1,790,403,1757,3555
2022-09-20 04:00:00,2022-09-20 05:00:00,579,48,711,424,1762,4003
2022-09-20 05:00:00,2022-09-20 06:00:00,575,310,653,371,1909,4154
2022-09-20 06:00:00,2022-09-20 07:00:00,587,683,479,268,2017,4195
2022-09-20 07:00:00,2022-09-20 08:00:00,508,1026,319,300,2153,4294
2022-09-20 08:00:00,2022-09-20 09:00:00,448,1227,185,301,2161,4281
2022-09-20 09:00:00,2022-09-20 10:00:00,384,1304,143,272,2103,4237
2022-09-20 10:00:00,2022-09-20 11:00:00,347,1218,148,257,1970,4259
2022-09-20 11:00:00,2022-09-20 12:00:00,469,1194,158,229,2050,4129
2022-09-20 12:00:00,2022-09-20 13:00:00,589,1117,187,213,2106,3984
2022-09-20 13:00:00,2022-09-20 14:00:00,588,865,207,210,1870,3957
2022-09-20 14:00:00,2022-09-20 15:00:00,620,512,251,209,1592,4155
2022-09-20 15:00:00,2022-09-20 16:00:00,626,154,286,173,1239,4023
2022-09-20 16:00:00,2022-09-20 17:00:00,601,8,314,183,1106,3903
2022-09-20 17:00:00,2022-09-20 18:00:00,627,1,337,186,1151,3801
2022-09-20 18:00:00,2022-09-20 19:00:00,612,0,310,152,1074,3579
2022-09-20 19:00:00,2022-09-20 20:00:00,655,1,258,123,1037,3346
2022-09-20 20:00:00,2022-09-20 21:00:00,618,1,183,98,900,3153
2022-09-20 21:00:00,2022-09-20 22:00:00,621,1,148,86,856,3044
2022-09-20 22:00:00,2022-09-20 23:00:00,592,1,110,72,775,2965
2022-09-20 23:00:00,2022-09-21 00:00:00,601,1,76,68,746,2912
2022-09-21 00:00:00,2022-09-21 01:00:00,585,1,39,81,706,2870
2022-09-21 01:00:00,2022-09-21 02:00:00,589,1,24,117,731,2910
2022-09-21 02:00:00,2022-09-21 03:00:00,596,1,44,135,776,3092
2022-09-21 03:00:00,2022-09-21 04:00:00,629,1,48,150,828,3624
2022-09-21 04:00:00,2022-09-21 05:00:00,631,45,70,140,886,4030
2022-09-21 05:00:00,2022-09-21 06:00:00,640,311,79,106,1136,4180
2022-09-21 06:00:00,2022-09-21 07:00:00,627,705,67,73,1472,4202
2022-09-21 07:00:00,2022-09-21 08:00:00,630,1018,40,69,1757,4337
2022-09-21 08:00:00,2022-09-21 09:00:00,611,1200,23,89,1923,4340
2022-09-21 09:00:00,2022-09-21 10:00:00,606,1226,14,136,1982,4291
2022-09-21 10:00:00,2022-09-21 11:00:00,531,1235,14,240,2020,4270
2022-09-21 11:00:00,2022-09-21 12:00:00,423,1181,19,265,1888,4208
2022-09-21 12:00:00,2022-09-21 13:00:00,519,1013,25,246,1803,4086
2022-09-21 13:00:00,2022-09-21 14:00:00,621,828,51,245,1745,4049
2022-09-21 14:00:00,2022-09-21 15:00:00,638,473,96,187,1394,4201
2022-09-21 15:00:00,2022-09-21 16:00:00,629,141,116,140,1026,4079
2022-09-21 16:00:00,2022-09-21 17:00:00,622,8,77,108,815,3946
2022-09-21 17:00:00,2022-09-21 18:00:00,685,1,77,108,871,3820
2022-09-21 18:00:00,2022-09-21 19:00:00,640,1,93,101,835,3605
2022-09-21 19:00:00,2022-09-21 20:00:00,646,1,71,107,825,3394
2022-09-21 20:00:00,2022-09-21 21:00:00,648,1,30,117,796,3176
2022-09-21 21:00:00,2022-09-21 22:00:00,621,1,34,143,799,3037
2022-09-21 22:00:00,2022-09-21 23:00:00,623,1,41,187,852,2955
2022-09-21 23:00:00,2022-09-22 00:00:00,601,1,39,233,874,2890
2022-09-22 00:00:00,2022-09-22 01:00:00,577,1,48,264,890,2866
2022-09-22 01:00:00,2022-09-22 02:00:00,600,1,71,297,969,2890
2022-09-22 02:00:00,2022-09-22 03:00:00,659,1,88,314,1062,3082
2022-09-22 03:00:00,2022-09-22 04:00:00,633,1,94,331,1059,3630
2022-09-22 04:00:00,2022-09-22 05:00:00,624,27,100,359,1110,4049
2022-09-22 05:00:00,2022-09-22 06:00:00,624,186,109,359,1278,4189
2022-09-22 06:00:00,2022-09-22 07:00:00,638,472,113,309,1532,4210
2022-09-22 07:00:00,2022-09-22 08:00:00,579,688,162,308,1737,4351
2022-09-22 08:00:00,2022-09-22 09:00:00,605,865,206,367,2043,4286
2022-09-22 09:00:00,2022-09-22 10:00:00,630,955,264,428,2277,4269
2022-09-22 10:00:00,2022-09-22 11:00:00,634,974,282,451,2341,4304
2022-09-22 11:00:00,2022-09-22 12:00:00,601,879,285,435,2200,4153
2022-09-22 12:00:00,2022-09-22 13:00:00,616,746,298,386,2046,4021
2022-09-22 13:00:00,2022-09-22 14:00:00,567,559,392,352,1870,4008
2022-09-22 14:00:00,2022-09-22 15:00:00,589,319,410,355,1673,4184
2022-09-22 15:00:00,2022-09-22 16:00:00,633,103,373,348,1457,4075
2022-09-22 16:00:00,2022-09-22 17:00:00,659,5,395,405,1464,3940
2022-09-22 17:00:00,2022-09-22 18:00:00,626,1,408,480,1515,3782
2022-09-22 18:00:00,2022-09-22 19:00:00,627,1,485,591,1704,3568
2022-09-22 19:00:00,2022-09-22 20:00:00,642,1,494,635,1772,3341
2022-09-22 20:00:00,2022-09-22 21:00:00,636,1,536,667,1840,3141
2022-09-22 21:00:00,2022-09-22 22:00:00,627,1,464,673,1765,2992
2022-09-22 22:00:00,2022-09-22 23:00:00,622,1,483,712,1818,2913
2022-09-22 23:00:00,2022-09-23 00:00:00,609,1,528,782,1920,2851
2022-09-23 00:00:00,2022-09-23 01:00:00,599,1,625,845,2070,2830
2022-09-23 01:00:00,2022-09-23 02:00:00,605,1,623,843,2072,2849
2022-09-23 02:00:00,2022-09-23 03:00:00,619,1,628,837,2085,3045
2022-09-23 03:00:00,2022-09-23 04:00:00,603,1,584,802,1990,3520
2022-09-23 04:00:00,2022-09-23 05:00:00,604,25,555,764,1948,3957
2022-09-23 05:00:00,2022-09-23 06:00:00,687,163,573,705,2128,4157
2022-09-23 06:00:00,2022-09-23 07:00:00,728,402,503,547,2180,4207
2022-09-23 07:00:00,2022-09-23 08:00:00,731,602,503,420,2256,4250
2022-09-23 08:00:00,2022-09-23 09:00:00,746,709,550,414,2419,4219
2022-09-23 09:00:00,2022-09-23 10:00:00,753,694,597,459,2503,4129
2022-09-23 10:00:00,2022-09-23 11:00:00,682,675,573,523,2453,4094
2022-09-23 11:00:00,2022-09-23 12:00:00,657,607,584,535,2383,3929
2022-09-23 12:00:00,2022-09-23 13:00:00,644,478,548,494,2164,3815
2022-09-23 13:00:00,2022-09-23 14:00:00,702,279,540,451,1972,3838
2022-09-23 14:00:00,2022-09-23 15:00:00,759,152,551,433,1895,4015
2022-09-23 15:00:00,2022-09-23 16:00:00,785,43,465,447,1740,3925
2022-09-23 16:00:00,2022-09-23 17:00:00,783,1,388,455,1627,3776
2022-09-23 17:00:00,2022-09-23 18:00:00,779,1,406,447,1633,3564
2022-09-23 18:00:00,2022-09-23 19:00:00,781,1,479,401,1662,3381
2022-09-23 19:00:00,2022-09-23 20:00:00,777,1,526,395,1699,3195
2022-09-23 20:00:00,2022-09-23 21:00:00,782,1,477,355,1615,3020
2022-09-23 21:00:00,2022-09-23 22:00:00,769,1,438,271,1479,2873
2022-09-23 22:00:00,2022-09-23 23:00:00,766,1,389,249,1405,2763
2022-09-23 23:00:00,2022-09-24 00:00:00,762,1,302,223,1288,2722
2022-09-24 00:00:00,2022-09-24 01:00:00,745,1,268,209,1223,2683
2022-09-24 01:00:00,2022-09-24 02:00:00,749,1,214,191,1155,2668
2022-09-24 02:00:00,2022-09-24 03:00:00,729,1,185,169,1084,2705
2022-09-24 03:00:00,2022-09-24 04:00:00,664,1,185,172,1022,2855
2022-09-24 04:00:00,2022-09-24 05:00:00,675,24,238,190,1127,3040
2022-09-24 05:00:00,2022-09-24 06:00:00,749,195,275,183,1402,3317
2022-09-24 06:00:00,2022-09-24 07:00:00,756,484,275,136,1651,3459
2022-09-24 07:00:00,2022-09-24 08:00:00,754,779,247,135,1915,3528
2022-09-24 08:00:00,2022-09-24 09:00:00,759,1000,207,133,2099,3501
2022-09-24 09:00:00,2022-09-24 10:00:00,755,1053,161,113,2082,3453
2022-09-24 10:00:00,2022-09-24 11:00:00,672,1046,177,112,2007,3473
2022-09-24 11:00:00,2022-09-24 12:00:00,694,924,257,119,1994,3406
2022-09-24 12:00:00,2022-09-24 13:00:00,613,777,315,133,1838,3368
2022-09-24 13:00:00,2022-09-24 14:00:00,375,521,289,133,1318,3432
2022-09-24 14:00:00,2022-09-24 15:00:00,374,277,240,123,1014,3671
2022-09-24 15:00:00,2022-09-24 16:00:00,374,90,214,136,814,3661
2022-09-24 16:00:00,2022-09-24 17:00:00,375,4,212,165,756,3527
2022-09-24 17:00:00,2022-09-24 18:00:00,339,1,214,204,758,3384
2022-09-24 18:00:00,2022-09-24 19:00:00,238,1,231,236,706,3190
2022-09-24 19:00:00,2022-09-24 20:00:00,264,1,302,219,786,3023
2022-09-24 20:00:00,2022-09-24 21:00:00,261,1,329,193,784,2880
2022-09-24 21:00:00,2022-09-24 22:00:00,253,1,343,163,760,2773
2022-09-24 22:00:00,2022-09-24 23:00:00,252,1,330,139,722,2708
2022-09-24 23:00:00,2022-09-25 00:00:00,252,1,294,116,663,2676
2022-09-25 00:00:00,2022-09-25 01:00:00,252,1,257,105,615,2657
2022-09-25 01:00:00,2022-09-25 02:00:00,250,1,234,76,561,2675
2022-09-25 02:00:00,2022-09-25 03:00:00,252,1,174,77,504,2664
2022-09-25 03:00:00,2022-09-25 04:00:00,254,1,118,77,450,2751
2022-09-25 04:00:00,2022-09-25 05:00:00,252,21,250,65,588,2930
2022-09-25 05:00:00,2022-09-25 06:00:00,252,175,333,59,819,3176
2022-09-25 06:00:00,2022-09-25 07:00:00,248,426,422,58,1154,3317
2022-09-25 07:00:00,2022-09-25 08:00:00,240,702,366,59,1367,3444
2022-09-25 08:00:00,2022-09-25 09:00:00,249,754,381,65,1449,3457
2022-09-25 09:00:00,2022-09-25 10:00:00,248,830,327,101,1506,3445
2022-09-25 10:00:00,2022-09-25 11:00:00,261,781,251,185,1478,3443
2022-09-25 11:00:00,2022-09-25 12:00:00,274,780,163,241,1458,3443
2022-09-25 12:00:00,2022-09-25 13:00:00,341,723,123,302,1489,3425
2022-09-25 13:00:00,2022-09-25 14:00:00,369,514,170,394,1447,3486
2022-09-25 14:00:00,2022-09-25 15:00:00,369,230,261,467,1327,3752
2022-09-25 15:00:00,2022-09-25 16:00:00,369,37,354,449,1209,3673
2022-09-25 16:00:00,2022-09-25 17:00:00,368,1,442,352,1163,3584
2022-09-25 17:00:00,2022-09-25 18:00:00,367,0,421,373,1161,3422
2022-09-25 18:00:00,2022-09-25 19:00:00,364,0,595,512,1471,3232
2022-09-25 19:00:00,2022-09-25 20:00:00,362,1,857,591,1811,3023
2022-09-25 20:00:00,2022-09-25 21:00:00,360,1,1182,699,2242,2950
2022-09-25 21:00:00,2022-09-25 22:00:00,190,1,1003,794,1988,2981
2022-09-25 22:00:00,2022-09-25 23:00:00,91,1,1207,805,2104,3151
2022-09-25 23:00:00,2022-09-26 00:00:00,64,1,1153,746,1964,3124
2022-09-26 00:00:00,2022-09-26 01:00:00,91,1,1343,871,2306,3202
2022-09-26 01:00:00,2022-09-26 02:00:00,42,2,1476,911,2431,3261
2022-09-26 02:00:00,2022-09-26 03:00:00,15,0,1610,1341,2966,3360
2022-09-26 03:00:00,2022-09-26 04:00:00,15,0,1663,1580,3258,3772
2022-09-26 04:00:00,2022-09-26 05:00:00,95,5,1914,1762,3776,4277
2022-09-26 05:00:00,2022-09-26 06:00:00,177,59,1899,1764,3899,4603
2022-09-26 06:00:00,2022-09-26 07:00:00,306,169,1928,2160,4563,4401
2022-09-26 07:00:00,2022-09-26 08:00:00,352,271,1928,2276,4827,4470
2022-09-26 08:00:00,2022-09-26 09:00:00,354,309,1882,2482,5027,4529
2022-09-26 09:00:00,2022-09-26 10:00:00,171,292,1958,2542,4963,4637
2022-09-26 10:00:00,2022-09-26 11:00:00,149,315,1981,2482,4927,4761
2022-09-26 11:00:00,2022-09-26 12:00:00,152,244,1944,2667,5007,4640
2022-09-26 12:00:00,2022-09-26 13:00:00,150,182,1670,2802,4804,4421
2022-09-26 13:00:00,2022-09-26 14:00:00,187,108,1548,2790,4633,4291
2022-09-26 14:00:00,2022-09-26 15:00:00,256,64,1574,2517,4411,4397
2022-09-26 15:00:00,2022-09-26 16:00:00,370,22,1471,2229,4092,4274
2022-09-26 16:00:00,2022-09-26 17:00:00,361,1,1465,1794,3621,4077
2022-09-26 17:00:00,2022-09-26 18:00:00,328,1,1442,1422,3193,3782
2022-09-26 18:00:00,2022-09-26 19:00:00,196,1,1458,1182,2837,3549
2022-09-26 19:00:00,2022-09-26 20:00:00,157,1,1507,1001,2666,3352
2022-09-26 20:00:00,2022-09-26 21:00:00,276,1,1517,785,2579,3104
2022-09-26 21:00:00,2022-09-26 22:00:00,331,1,1476,594,2402,2970
2022-09-26 22:00:00,2022-09-26 23:00:00,146,1,1371,477,1995,2925
2022-09-26 23:00:00,2022-09-27 00:00:00,343,1,1297,372,2013,2883
2022-09-27 00:00:00,2022-09-27 01:00:00,455,1,1205,298,1959,2896
2022-09-27 01:00:00,2022-09-27 02:00:00,429,1,1149,266,1845,2916
2022-09-27 02:00:00,2022-09-27 03:00:00,506,1,1084,260,1851,3104
2022-09-27 03:00:00,2022-09-27 04:00:00,565,1,1212,271,2049,3616
2022-09-27 04:00:00,2022-09-27 05:00:00,645,7,1147,298,2097,4091
2022-09-27 05:00:00,2022-09-27 06:00:00,670,54,1186,315,2225,4267
2022-09-27 06:00:00,2022-09-27 07:00:00,650,119,1094,302,2165,4311
2022-09-27 07:00:00,2022-09-27 08:00:00,645,209,992,298,2144,4434
2022-09-27 08:00:00,2022-09-27 09:00:00,667,294,882,319,2162,4404
2022-09-27 09:00:00,2022-09-27 10:00:00,715,349,768,356,2188,4355
2022-09-27 10:00:00,2022-09-27 11:00:00,692,357,634,348,2031,4370
2022-09-27 11:00:00,2022-09-27 12:00:00,695,302,628,314,1939,4321
2022-09-27 12:00:00,2022-09-27 13:00:00,706,244,683,313,1946,4190
2022-09-27 13:00:00,2022-09-27 14:00:00,703,179,651,370,1903,4173
2022-09-27 14:00:00,2022-09-27 15:00:00,695,103,685,391,1874,4348
2022-09-27 15:00:00,2022-09-27 16:00:00,722,30,714,396,1862,4158
2022-09-27 16:00:00,2022-09-27 17:00:00,715,1,638,389,1743,4077
2022-09-27 17:00:00,2022-09-27 18:00:00,715,1,500,363,1579,3867
2022-09-27 18:00:00,2022-09-27 19:00:00,724,1,356,291,1372,3553
2022-09-27 19:00:00,2022-09-27 20:00:00,715,1,339,270,1325,3386
2022-09-27 20:00:00,2022-09-27 21:00:00,706,1,381,275,1363,3195
2022-09-27 21:00:00,2022-09-27 22:00:00,663,1,421,237,1322,3051
2022-09-27 22:00:00,2022-09-27 23:00:00,654,1,416,251,1322,2947
2022-09-27 23:00:00,2022-09-28 00:00:00,649,1,486,265,1401,2967
2022-09-28 00:00:00,2022-09-28 01:00:00,650,1,526,281,1458,2938
2022-09-28 01:00:00,2022-09-28 02:00:00,662,1,386,276,1325,2915
2022-09-28 02:00:00,2022-09-28 03:00:00,659,1,326,281,1267,3089
2022-09-28 03:00:00,2022-09-28 04:00:00,671,1,253,310,1235,3616
2022-09-28 04:00:00,2022-09-28 05:00:00,669,11,305,359,1344,4119
2022-09-28 05:00:00,2022-09-28 06:00:00,679,120,216,361,1376,4271
2022-09-28 06:00:00,2022-09-28 07:00:00,651,307,110,331,1399,4338
2022-09-28 07:00:00,2022-09-28 08:00:00,633,476,100,359,1568,4430
2022-09-28 08:00:00,2022-09-28 09:00:00,627,664,75,471,1837,4492
2022-09-28 09:00:00,2022-09-28 10:00:00,649,664,77,467,1857,4434
2022-09-28 10:00:00,2022-09-28 11:00:00,636,630,69,438,1773,4426
2022-09-28 11:00:00,2022-09-28 12:00:00,580,580,48,401,1609,4254
2022-09-28 12:00:00,2022-09-28 13:00:00,589,472,32,419,1512,4127
2022-09-28 13:00:00,2022-09-28 14:00:00,719,331,25,326,1401,4140
2022-09-28 14:00:00,2022-09-28 15:00:00,676,166,17,296,1155,4332
2022-09-28 15:00:00,2022-09-28 16:00:00,677,40,29,297,1043,4181
2022-09-28 16:00:00,2022-09-28 17:00:00,670,1,65,331,1067,4055
2022-09-28 17:00:00,2022-09-28 18:00:00,741,1,184,424,1350,3837
2022-09-28 18:00:00,2022-09-28 19:00:00,706,1,255,637,1599,3654
2022-09-28 19:00:00,2022-09-28 20:00:00,653,3,397,840,1893,3424
2022-09-28 20:00:00,2022-09-28 21:00:00,663,1,443,1056,2163,3219
2022-09-28 21:00:00,2022-09-28 22:00:00,665,2,596,1183,2446,3029
2022-09-28 22:00:00,2022-09-28 23:00:00,669,4,674,1224,2571,2975
2022-09-28 23:00:00,2022-09-29 00:00:00,667,4,664,1233,2568,2941
2022-09-29 00:00:00,2022-09-29 01:00:00,669,3,643,1280,2595,2874
2022-09-29 01:00:00,2022-09-29 02:00:00,666,0,711,1436,2813,2898
2022-09-29 02:00:00,2022-09-29 03:00:00,687,0,934,1540,3161,3130
2022-09-29 03:00:00,2022-09-29 04:00:00,664,1,1329,1582,3576,3639
2022-09-29 04:00:00,2022-09-29 05:00:00,686,8,1419,1598,3711,4076
2022-09-29 05:00:00,2022-09-29 06:00:00,654,92,1429,1633,3808,4254
2022-09-29 06:00:00,2022-09-29 07:00:00,627,267,1451,1747,4092,4295
2022-09-29 07:00:00,2022-09-29 08:00:00,626,488,1412,1992,4518,4416
2022-09-29 08:00:00,2022-09-29 09:00:00,625,613,1263,2084,4585,4355
2022-09-29 09:00:00,2022-09-29 10:00:00,624,637,1106,2108,4475,4356
2022-09-29 10:00:00,2022-09-29 11:00:00,634,658,982,2050,4324,4288
2022-09-29 11:00:00,2022-09-29 12:00:00,631,609,981,1980,4201,4301
2022-09-29 12:00:00,2022-09-29 13:00:00,582,507,1014,1878,3981,4210
2022-09-29 13:00:00,2022-09-29 14:00:00,499,361,961,1800,3621,4110
2022-09-29 14:00:00,2022-09-29 15:00:00,427,195,1048,1619,3289,4282
2022-09-29 15:00:00,2022-09-29 16:00:00,633,36,1127,1468,3264,4159
2022-09-29 16:00:00,2022-09-29 17:00:00,627,1,1207,1423,3258,4095
2022-09-29 17:00:00,2022-09-29 18:00:00,618,1,1289,1395,3303,3898
2022-09-29 18:00:00,2022-09-29 19:00:00,549,1,1194,1279,3023,3699
2022-09-29 19:00:00,2022-09-29 20:00:00,643,1,1236,1103,2983,3443
2022-09-29 20:00:00,2022-09-29 21:00:00,632,1,1108,938,2679,3225
2022-09-29 21:00:00,2022-09-29 22:00:00,601,1,821,796,2219,3065
2022-09-29 22:00:00,2022-09-29 23:00:00,579,1,544,726,1850,2965
2022-09-29 23:00:00,2022-09-30 00:00:00,562,1,368,616,1547,2912
2022-09-30 00:00:00,2022-09-30 01:00:00,580,1,331,511,1423,2865
2022-09-30 01:00:00,2022-09-30 02:00:00,602,1,358,406,1367,2874
2022-09-30 02:00:00,2022-09-30 03:00:00,624,1,352,349,1326,3088
2022-09-30 03:00:00,2022-09-30 04:00:00,624,1,338,324,1287,3553
2022-09-30 04:00:00,2022-09-30 05:00:00,633,8,387,388,1416,3991
2022-09-30 05:00:00,2022-09-30 06:00:00,640,111,354,347,1452,4206
2022-09-30 06:00:00,2022-09-30 07:00:00,632,272,439,309,1652,4231
2022-09-30 07:00:00,2022-09-30 08:00:00,626,398,549,295,1868,4332
2022-09-30 08:00:00,2022-09-30 09:00:00,631,543,456,350,1980,4328
2022-09-30 09:00:00,2022-09-30 10:00:00,636,619,429,410,2094,4219
2022-09-30 10:00:00,2022-09-30 11:00:00,520,743,492,513,2268,4161
2022-09-30 11:00:00,2022-09-30 12:00:00,364,790,650,678,2482,4078
2022-09-30 12:00:00,2022-09-30 13:00:00,419,684,758,795,2656,3875
2022-09-30 13:00:00,2022-09-30 14:00:00,393,570,888,896,2747,3979
2022-09-30 14:00:00,2022-09-30 15:00:00,481,290,1147,940,2858,4064
2022-09-30 15:00:00,2022-09-30 16:00:00,553,51,1323,871,2798,3968
2022-09-30 16:00:00,2022-09-30 17:00:00,404,1,1456,991,2852,3802
2022-09-30 17:00:00,2022-09-30 18:00:00,359,1,1527,1300,3187,3634
2022-09-30 18:00:00,2022-09-30 19:00:00,322,1,1674,1620,3617,3563
2022-09-30 19:00:00,2022-09-30 20:00:00,167,1,1668,1936,3772,3303
2022-09-30 20:00:00,2022-09-30 21:00:00,117,0,1652,2091,3860,3248
2022-09-30 21:00:00,2022-09-30 22:00:00,22,0,1637,2455,4114,3085
2022-09-30 22:00:00,2022-09-30 23:00:00,22,0,1639,2594,4255,3007
2022-09-30 23:00:00,2022-10-01 00:00:00,21,0,1739,2642,4402,2989
2022-10-01 00:00:00,2022-10-01 01:00:00,19,0,1778,2624,4421,3019
2022-10-01 01:00:00,2022-10-01 02:00:00,17,0,1858,2572,4447,3033
2022-10-01 02:00:00,2022-10-01 03:00:00,16,0,1882,2495,4393,2989
2022-10-01 03:00:00,2022-10-01 04:00:00,16,0,1866,2495,4377,3088
2022-10-01 04:00:00,2022-10-01 05:00:00,18,4,1828,2513,4363,3339
2022-10-01 05:00:00,2022-10-01 06:00:00,24,38,1798,2587,4447,3558
2022-10-01 06:00:00,2022-10-01 07:00:00,25,84,1411,2473,3993,3661
2022-10-01 07:00:00,2022-10-01 08:00:00,24,137,1189,2099,3449,3725
2022-10-01 08:00:00,2022-10-01 09:00:00,24,160,1191,1689,3064,3745
2022-10-01 09:00:00,2022-10-01 10:00:00,23,206,1250,1234,2713,3711
2022-10-01 10:00:00,2022-10-01 11:00:00,23,287,1468,913,2691,3787
2022-10-01 11:00:00,2022-10-01 12:00:00,25,379,1555,730,2689,3824
2022-10-01 12:00:00,2022-10-01 13:00:00,26,414,1473,786,2699,3743
2022-10-01 13:00:00,2022-10-01 14:00:00,27,359,1425,874,2685,3841
2022-10-01 14:00:00,2022-10-01 15:00:00,29,214,1355,993,2591,3945
2022-10-01 15:00:00,2022-10-01 16:00:00,30,45,1339,1007,2421,3846
2022-10-01 16:00:00,2022-10-01 17:00:00,29,1,1465,1158,2653,3682
2022-10-01 17:00:00,2022-10-01 18:00:00,29,0,1552,1242,2823,3471
2022-10-01 18:00:00,2022-10-01 19:00:00,28,0,1643,1341,3012,3315
2022-10-01 19:00:00,2022-10-01 20:00:00,28,0,1712,1433,3173,3132
2022-10-01 20:00:00,2022-10-01 21:00:00,26,0,1776,1407,3209,3013
2022-10-01 21:00:00,2022-10-01 22:00:00,19,0,1789,1378,3186,2947
2022-10-01 22:00:00,2022-10-01 23:00:00,18,0,1675,1304,2997,2822
2022-10-01 23:00:00,2022-10-02 00:00:00,18,0,1702,1266,2986,2805
2022-10-02 00:00:00,2022-10-02 01:00:00,18,0,1637,1283,2938,2745
2022-10-02 01:00:00,2022-10-02 02:00:00,18,0,1445,1304,2767,2775
2022-10-02 02:00:00,2022-10-02 03:00:00,18,0,1538,1287,2843,2780
2022-10-02 03:00:00,2022-10-02 04:00:00,17,0,1643,1312,2972,2893
2022-10-02 04:00:00,2022-10-02 05:00:00,18,13,1700,1330,3061,3073
2022-10-02 05:00:00,2022-10-02 06:00:00,20,174,1666,1291,3151,3265
2022-10-02 06:00:00,2022-10-02 07:00:00,20,506,1732,1318,3576,3383
2022-10-02 07:00:00,2022-10-02 08:00:00,20,836,1789,1647,4292,3517
2022-10-02 08:00:00,2022-10-02 09:00:00,20,964,1815,1934,4733,3580
2022-10-02 09:00:00,2022-10-02 10:00:00,20,1075,1737,2232,5064,3642
2022-10-02 10:00:00,2022-10-02 11:00:00,20,1091,1699,2518,5328,3597
2022-10-02 11:00:00,2022-10-02 12:00:00,20,966,1773,2680,5439,3577
2022-10-02 12:00:00,2022-10-02 13:00:00,21,870,1722,2734,5347,3637
2022-10-02 13:00:00,2022-10-02 14:00:00,27,608,1781,2564,4980,3604
2022-10-02 14:00:00,2022-10-02 15:00:00,31,281,1749,2323,4384,3751
2022-10-02 15:00:00,2022-10-02 16:00:00,33,46,1827,2023,3929,3759
2022-10-02 16:00:00,2022-10-02 17:00:00,34,1,1913,1893,3841,3646
2022-10-02 17:00:00,2022-10-02 18:00:00,34,0,1970,1908,3912,3441
2022-10-02 18:00:00,2022-10-02 19:00:00,34,0,1949,1977,3960,3278
2022-10-02 19:00:00,2022-10-02 20:00:00,25,0,1929,2082,4036,3115
2022-10-02 20:00:00,2022-10-02 21:00:00,22,0,1907,2154,4083,2959
2022-10-02 21:00:00,2022-10-02 22:00:00,21,0,1914,2155,4090,2948
2022-10-02 22:00:00,2022-10-02 23:00:00,19,0,1891,2111,4021,2860
2022-10-02 23:00:00,2022-10-03 00:00:00,19,0,1892,2060,3971,2840
2022-10-03 00:00:00,2022-10-03 01:00:00,32,0,1860,1961,3853,2808
2022-10-03 01:00:00,2022-10-03 02:00:00,97,0,1837,1890,3824,2776
2022-10-03 02:00:00,2022-10-03 03:00:00,146,0,1839,1765,3750,2953
2022-10-03 03:00:00,2022-10-03 04:00:00,194,0,1795,1654,3643,3519
2022-10-03 04:00:00,2022-10-03 05:00:00,357,9,1631,1595,3592,4029
2022-10-03 05:00:00,2022-10-03 06:00:00,387,157,1421,1577,3542,4256
2022-10-03 06:00:00,2022-10-03 07:00:00,375,461,1334,1588,3758,4243
2022-10-03 07:00:00,2022-10-03 08:00:00,157,762,1255,1794,3968,4285
2022-10-03 08:00:00,2022-10-03 09:00:00,76,985,1173,2068,4302,4344
2022-10-03 09:00:00,2022-10-03 10:00:00,105,1052,1148,2100,4405,4351
2022-10-03 10:00:00,2022-10-03 11:00:00,158,897,1096,2053,4204,4349
2022-10-03 11:00:00,2022-10-03 12:00:00,168,829,1033,2039,4069,4294
2022-10-03 12:00:00,2022-10-03 13:00:00,186,697,994,1870,3747,4051
2022-10-03 13:00:00,2022-10-03 14:00:00,389,520,1108,1747,3764,4050
2022-10-03 14:00:00,2022-10-03 15:00:00,631,235,1192,1390,3448,4267
2022-10-03 15:00:00,2022-10-03 16:00:00,703,22,1104,1045,2874,4174
2022-10-03 16:00:00,2022-10-03 17:00:00,753,0,849,909,2511,4001
2022-10-03 17:00:00,2022-10-03 18:00:00,758,0,845,825,2428,3785
2022-10-03 18:00:00,2022-10-03 19:00:00,781,0,867,754,2402,3584
2022-10-03 19:00:00,2022-10-03 20:00:00,774,0,856,634,2264,3354
2022-10-03 20:00:00,2022-10-03 21:00:00,528,0,814,555,1897,3164
2022-10-03 21:00:00,2022-10-03 22:00:00,422,0,837,480,1739,3026
2022-10-03 22:00:00,2022-10-03 23:00:00,303,0,793,407,1503,2948
2022-10-03 23:00:00,2022-10-04 00:00:00,376,0,624,440,1440,2907
2022-10-04 00:00:00,2022-10-04 01:00:00,383,0,460,467,1310,2894
2022-10-04 01:00:00,2022-10-04 02:00:00,506,0,404,418,1328,2925
2022-10-04 02:00:00,2022-10-04 03:00:00,675,0,426,371,1472,3086
2022-10-04 03:00:00,2022-10-04 04:00:00,725,0,397,413,1535,3661
2022-10-04 04:00:00,2022-10-04 05:00:00,725,8,326,519,1578,4097
2022-10-04 05:00:00,2022-10-04 06:00:00,749,72,339,587,1747,4216
2022-10-04 06:00:00,2022-10-04 07:00:00,779,208,357,627,1971,4242
2022-10-04 07:00:00,2022-10-04 08:00:00,727,432,448,737,2344,4316
2022-10-04 08:00:00,2022-10-04 09:00:00,678,642,687,1131,3138,4365
2022-10-04 09:00:00,2022-10-04 10:00:00,394,738,871,1718,3721,4456
2022-10-04 10:00:00,2022-10-04 11:00:00,241,793,975,1986,3995,4453
2022-10-04 11:00:00,2022-10-04 12:00:00,216,767,1002,1956,3941,4283
2022-10-04 12:00:00,2022-10-04 13:00:00,234,522,1158,1826,3740,3961
2022-10-04 13:00:00,2022-10-04 14:00:00,327,274,1274,1656,3531,3680
2022-10-04 14:00:00,2022-10-04 15:00:00,644,101,1455,1529,3729,3949
2022-10-04 15:00:00,2022-10-04 16:00:00,628,11,1470,1491,3600,3956
2022-10-04 16:00:00,2022-10-04 17:00:00,614,0,1461,1631,3706,3774
2022-10-04 17:00:00,2022-10-04 18:00:00,441,0,1556,1815,3812,3534
2022-10-04 18:00:00,2022-10-04 19:00:00,305,0,1500,1659,3464,3577
2022-10-04 19:00:00,2022-10-04 20:00:00,180,0,1275,1600,3055,3403
2022-10-04 20:00:00,2022-10-04 21:00:00,25,0,1341,1559,2925,3160
2022-10-04 21:00:00,2022-10-04 22:00:00,21,0,1633,1385,3039,3144
2022-10-04 22:00:00,2022-10-04 23:00:00,19,0,1418,1651,3088,2936
2022-10-04 23:00:00,2022-10-05 00:00:00,19,0,1521,1718,3258,2889
2022-10-05 00:00:00,2022-10-05 01:00:00,19,0,1608,1471,3098,2861
2022-10-05 01:00:00,2022-10-05 02:00:00,19,0,1556,1435,3010,2876
2022-10-05 02:00:00,2022-10-05 03:00:00,19,0,1541,1415,2975,3052
2022-10-05 03:00:00,2022-10-05 04:00:00,20,0,1679,1702,3401,3455
2022-10-05 04:00:00,2022-10-05 05:00:00,29,1,1783,1870,3683,3848
2022-10-05 05:00:00,2022-10-05 06:00:00,33,26,1793,2124,3976,4055
2022-10-05 06:00:00,2022-10-05 07:00:00,33,79,1833,2360,4305,4058
2022-10-05 07:00:00,2022-10-05 08:00:00,33,164,1891,2920,5008,4440
2022-10-05 08:00:00,2022-10-05 09:00:00,25,251,1889,3171,5336,4547
2022-10-05 09:00:00,2022-10-05 10:00:00,18,279,1872,3216,5385,4559
2022-10-05 10:00:00,2022-10-05 11:00:00,17,264,1854,3259,5394,4689
2022-10-05 11:00:00,2022-10-05 12:00:00,18,222,1833,3340,5413,4624
2022-10-05 12:00:00,2022-10-05 13:00:00,17,148,1800,3407,5372,4428
2022-10-05 13:00:00,2022-10-05 14:00:00,18,83,1742,3528,5371,4392
2022-10-05 14:00:00,2022-10-05 15:00:00,17,33,1650,3608,5308,4557
2022-10-05 15:00:00,2022-10-05 16:00:00,18,3,1600,3601,5222,4438
2022-10-05 16:00:00,2022-10-05 17:00:00,18,0,1616,3631,5265,4300
2022-10-05 17:00:00,2022-10-05 18:00:00,17,0,1738,3676,5431,4082
2022-10-05 18:00:00,2022-10-05 19:00:00,17,0,1671,3415,5103,3891
2022-10-05 19:00:00,2022-10-05 20:00:00,17,0,1860,2832,4709,3511
2022-10-05 20:00:00,2022-10-05 21:00:00,16,0,1888,2680,4584,3441
2022-10-05 21:00:00,2022-10-05 22:00:00,13,0,1816,2736,4565,3136
2022-10-05 22:00:00,2022-10-05 23:00:00,13,0,1623,2219,3855,3191
2022-10-05 23:00:00,2022-10-06 00:00:00,13,0,839,2277,3129,2992
2022-10-06 00:00:00,2022-10-06 01:00:00,13,0,753,2504,3270,2970
2022-10-06 01:00:00,2022-10-06 02:00:00,13,0,731,2750,3494,3001
2022-10-06 02:00:00,2022-10-06 03:00:00,18,0,1525,3152,4695,3279
2022-10-06 03:00:00,2022-10-06 04:00:00,23,0,1953,3201,5177,3761
2022-10-06 04:00:00,2022-10-06 05:00:00,25,7,1899,3088,5019,4164
2022-10-06 05:00:00,2022-10-06 06:00:00,25,140,1867,3134,5166,4283
2022-10-06 06:00:00,2022-10-06 07:00:00,21,415,1920,3353,5709,4284
2022-10-06 07:00:00,2022-10-06 08:00:00,21,736,1846,3580,6183,4418
2022-10-06 08:00:00,2022-10-06 09:00:00,21,939,1793,3727,6480,4534
2022-10-06 09:00:00,2022-10-06 10:00:00,24,1026,1714,3792,6556,4539
2022-10-06 10:00:00,2022-10-06 11:00:00,18,990,1705,3827,6540,4560
2022-10-06 11:00:00,2022-10-06 12:00:00,17,788,1763,3710,6278,4517
2022-10-06 12:00:00,2022-10-06 13:00:00,18,634,1749,3811,6212,4305
2022-10-06 13:00:00,2022-10-06 14:00:00,20,411,1739,3681,5851,4273
2022-10-06 14:00:00,2022-10-06 15:00:00,20,160,1776,3271,5227,4504
2022-10-06 15:00:00,2022-10-06 16:00:00,21,19,1806,3099,4945,4466
2022-10-06 16:00:00,2022-10-06 17:00:00,21,0,1686,3379,5086,4185
2022-10-06 17:00:00,2022-10-06 18:00:00,22,0,1701,3055,4778,4031
2022-10-06 18:00:00,2022-10-06 19:00:00,21,0,1706,2872,4599,3765
2022-10-06 19:00:00,2022-10-06 20:00:00,20,0,1764,2978,4762,3488
2022-10-06 20:00:00,2022-10-06 21:00:00,20,0,1789,2827,4636,3281
2022-10-06 21:00:00,2022-10-06 22:00:00,19,0,1769,2716,4504,3152
2022-10-06 22:00:00,2022-10-06 23:00:00,18,0,1745,2381,4144,3188
2022-10-06 23:00:00,2022-10-07 00:00:00,15,0,1743,2324,4082,3191
2022-10-07 00:00:00,2022-10-07 01:00:00,15,0,1503,2257,3775,3108
2022-10-07 01:00:00,2022-10-07 02:00:00,14,0,1554,2319,3887,3114
2022-10-07 02:00:00,2022-10-07 03:00:00,16,0,1620,2564,4200,3317
2022-10-07 03:00:00,2022-10-07 04:00:00,22,0,1777,2879,4678,3768
2022-10-07 04:00:00,2022-10-07 05:00:00,24,5,1773,3061,4863,4170
2022-10-07 05:00:00,2022-10-07 06:00:00,28,92,1824,3085,5029,4245
2022-10-07 06:00:00,2022-10-07 07:00:00,27,277,1889,3034,5227,4418
2022-10-07 07:00:00,2022-10-07 08:00:00,27,473,1914,3144,5558,4471
2022-10-07 08:00:00,2022-10-07 09:00:00,27,610,1914,3328,5879,4430
2022-10-07 09:00:00,2022-10-07 10:00:00,20,693,1833,3467,6013,4329
2022-10-07 10:00:00,2022-10-07 11:00:00,18,754,1776,3551,6099,4250
2022-10-07 11:00:00,2022-10-07 12:00:00,17,676,1763,3563,6019,4086
2022-10-07 12:00:00,2022-10-07 13:00:00,17,526,1644,3619,5806,3972
2022-10-07 13:00:00,2022-10-07 14:00:00,17,307,1610,3529,5463,4014
2022-10-07 14:00:00,2022-10-07 15:00:00,17,119,1647,3424,5207,4221
2022-10-07 15:00:00,2022-10-07 16:00:00,17,12,1732,3315,5076,4195
2022-10-07 16:00:00,2022-10-07 17:00:00,18,0,1678,3234,4930,4023
2022-10-07 17:00:00,2022-10-07 18:00:00,18,0,1764,3160,4942,3741
2022-10-07 18:00:00,2022-10-07 19:00:00,15,0,1664,2877,4556,3498
2022-10-07 19:00:00,2022-10-07 20:00:00,15,0,1610,2517,4142,3275
2022-10-07 20:00:00,2022-10-07 21:00:00,15,0,1653,2130,3798,3087
2022-10-07 21:00:00,2022-10-07 22:00:00,16,0,1724,1767,3507,2994
2022-10-07 22:00:00,2022-10-07 23:00:00,16,0,1546,1535,3097,2835
2022-10-07 23:00:00,2022-10-08 00:00:00,16,0,1615,1320,2951,2748
2022-10-08 00:00:00,2022-10-08 01:00:00,16,0,1544,1186,2746,2691
2022-10-08 01:00:00,2022-10-08 02:00:00,16,0,1431,1134,2581,2677
2022-10-08 02:00:00,2022-10-08 03:00:00,17,0,1327,1126,2470,2715
2022-10-08 03:00:00,2022-10-08 04:00:00,21,0,1199,1054,2274,2970
2022-10-08 04:00:00,2022-10-08 05:00:00,27,3,1116,1208,2354,3090
2022-10-08 05:00:00,2022-10-08 06:00:00,27,103,1124,1151,2405,3330
2022-10-08 06:00:00,2022-10-08 07:00:00,28,337,1284,848,2497,3469
2022-10-08 07:00:00,2022-10-08 08:00:00,26,687,1367,826,2906,3540
2022-10-08 08:00:00,2022-10-08 09:00:00,27,855,1290,1021,3193,3489
2022-10-08 09:00:00,2022-10-08 10:00:00,19,917,1271,1412,3619,3489
2022-10-08 10:00:00,2022-10-08 11:00:00,16,914,1433,1745,4108,3511
2022-10-08 11:00:00,2022-10-08 12:00:00,16,874,1445,1938,4273,3538
2022-10-08 12:00:00,2022-10-08 13:00:00,16,796,1427,2199,4438,3572
2022-10-08 13:00:00,2022-10-08 14:00:00,17,471,1553,2296,4337,3595
2022-10-08 14:00:00,2022-10-08 15:00:00,15,186,1670,1998,3869,3810
2022-10-08 15:00:00,2022-10-08 16:00:00,14,19,1674,1873,3580,3785
2022-10-08 16:00:00,2022-10-08 17:00:00,14,0,1741,1803,3558,3712
2022-10-08 17:00:00,2022-10-08 18:00:00,18,0,1814,1649,3481,3510
2022-10-08 18:00:00,2022-10-08 19:00:00,44,0,1765,1519,3328,3337
2022-10-08 19:00:00,2022-10-08 20:00:00,69,0,1654,1359,3082,3167
2022-10-08 20:00:00,2022-10-08 21:00:00,83,0,1491,1271,2845,3027
2022-10-08 21:00:00,2022-10-08 22:00:00,141,0,1351,1121,2613,2832
2022-10-08 22:00:00,2022-10-08 23:00:00,179,0,1222,1022,2423,2725
2022-10-08 23:00:00,2022-10-09 00:00:00,144,0,1148,911,2203,2656
2022-10-09 00:00:00,2022-10-09 01:00:00,171,0,1019,784,1974,2607
2022-10-09 01:00:00,2022-10-09 02:00:00,230,0,821,647,1698,2611
2022-10-09 02:00:00,2022-10-09 03:00:00,234,0,682,554,1470,2653
2022-10-09 03:00:00,2022-10-09 04:00:00,276,0,505,494,1275,2792
2022-10-09 04:00:00,2022-10-09 05:00:00,302,3,402,463,1170,2981
2022-10-09 05:00:00,2022-10-09 06:00:00,247,79,387,528,1241,3168
2022-10-09 06:00:00,2022-10-09 07:00:00,242,290,396,533,1461,3212
2022-10-09 07:00:00,2022-10-09 08:00:00,274,458,406,499,1637,3136
2022-10-09 08:00:00,2022-10-09 09:00:00,201,588,411,696,1896,3012
2022-10-09 09:00:00,2022-10-09 10:00:00,188,635,503,1006,2332,3058
2022-10-09 10:00:00,2022-10-09 11:00:00,205,580,621,1193,2599,3273
2022-10-09 11:00:00,2022-10-09 12:00:00,207,536,761,1209,2713,3292
2022-10-09 12:00:00,2022-10-09 13:00:00,170,378,875,1262,2685,3203
2022-10-09 13:00:00,2022-10-09 14:00:00,275,261,917,1095,2548,3360
2022-10-09 14:00:00,2022-10-09 15:00:00,306,126,853,929,2214,3752
2022-10-09 15:00:00,2022-10-09 16:00:00,370,10,776,835,1991,3824
2022-10-09 16:00:00,2022-10-09 17:00:00,233,0,912,1028,2173,3748
2022-10-09 17:00:00,2022-10-09 18:00:00,235,0,1073,1270,2578,3530
2022-10-09 18:00:00,2022-10-09 19:00:00,163,0,1312,1394,2869,3604
2022-10-09 19:00:00,2022-10-09 20:00:00,131,0,1320,1457,2908,3472
2022-10-09 20:00:00,2022-10-09 21:00:00,128,0,1385,1465,2978,3336
2022-10-09 21:00:00,2022-10-09 22:00:00,130,0,1252,1432,2814,3174
2022-10-09 22:00:00,2022-10-09 23:00:00,131,0,1053,1394,2578,3129
2022-10-09 23:00:00,2022-10-10 00:00:00,128,0,1015,1272,2415,3120
2022-10-10 00:00:00,2022-10-10 01:00:00,128,0,1159,1386,2673,3036
2022-10-10 01:00:00,2022-10-10 02:00:00,131,0,1200,1420,2751,3044
2022-10-10 02:00:00,2022-10-10 03:00:00,132,0,1205,1663,3000,3243
2022-10-10 03:00:00,2022-10-10 04:00:00,141,0,1606,1740,3487,3746
2022-10-10 04:00:00,2022-10-10 05:00:00,183,5,1811,1712,3711,4110
2022-10-10 05:00:00,2022-10-10 06:00:00,211,133,1793,1583,3720,4084
2022-10-10 06:00:00,2022-10-10 07:00:00,189,451,1765,1491,3896,4142
2022-10-10 07:00:00,2022-10-10 08:00:00,181,767,1601,1469,4018,4252
2022-10-10 08:00:00,2022-10-10 09:00:00,280,1014,1556,1495,4345,4237
2022-10-10 09:00:00,2022-10-10 10:00:00,347,1049,1439,1548,4383,4284
2022-10-10 10:00:00,2022-10-10 11:00:00,232,896,1375,1536,4039,4279
2022-10-10 11:00:00,2022-10-10 12:00:00,202,640,1194,1420,3456,4157
2022-10-10 12:00:00,2022-10-10 13:00:00,84,365,1255,1220,2924,4022
2022-10-10 13:00:00,2022-10-10 14:00:00,33,149,1326,1095,2603,4005
2022-10-10 14:00:00,2022-10-10 15:00:00,33,51,1476,927,2487,4353
2022-10-10 15:00:00,2022-10-10 16:00:00,45,12,1548,1139,2744,4298
2022-10-10 16:00:00,2022-10-10 17:00:00,119,0,1484,1377,2980,4202
2022-10-10 17:00:00,2022-10-10 18:00:00,199,0,1642,1610,3451,3901
2022-10-10 18:00:00,2022-10-10 19:00:00,234,0,1791,1872,3897,3734
2022-10-10 19:00:00,2022-10-10 20:00:00,230,0,1912,1931,4073,3605
2022-10-10 20:00:00,2022-10-10 21:00:00,168,0,1875,2038,4081,3355
2022-10-10 21:00:00,2022-10-10 22:00:00,188,0,1678,1762,3628,3356
2022-10-10 22:00:00,2022-10-10 23:00:00,219,0,1817,2112,4148,3229
2022-10-10 23:00:00,2022-10-11 00:00:00,227,0,1795,2199,4221,3150
2022-10-11 00:00:00,2022-10-11 01:00:00,226,0,1812,2166,4204,3000
2022-10-11 01:00:00,2022-10-11 02:00:00,225,0,1817,2068,4110,2996
2022-10-11 02:00:00,2022-10-11 03:00:00,226,0,1767,1964,3957,3202
2022-10-11 03:00:00,2022-10-11 04:00:00,330,0,1762,1964,4056,3672
2022-10-11 04:00:00,2022-10-11 05:00:00,367,3,1693,1880,3943,4196
2022-10-11 05:00:00,2022-10-11 06:00:00,365,117,1729,1690,3901,4300
2022-10-11 06:00:00,2022-10-11 07:00:00,370,371,1648,1666,4055,4274
2022-10-11 07:00:00,2022-10-11 08:00:00,376,684,1553,1816,4429,4289
2022-10-11 08:00:00,2022-10-11 09:00:00,378,1157,1503,2165,5203,4558
2022-10-11 09:00:00,2022-10-11 10:00:00,378,1085,1461,2165,5089,4240
2022-10-11 10:00:00,2022-10-11 11:00:00,298,776,1413,1973,4460,3842
2022-10-11 11:00:00,2022-10-11 12:00:00,248,717,1217,2100,4282,4313
2022-10-11 12:00:00,2022-10-11 13:00:00,203,516,1158,1927,3804,4045
2022-10-11 13:00:00,2022-10-11 14:00:00,371,328,1085,1611,3395,3991
2022-10-11 14:00:00,2022-10-11 15:00:00,405,116,1038,1255,2814,4284
2022-10-11 15:00:00,2022-10-11 16:00:00,447,10,924,921,2302,4253
2022-10-11 16:00:00,2022-10-11 17:00:00,441,0,714,832,1987,4088
2022-10-11 17:00:00,2022-10-11 18:00:00,506,0,711,741,1958,3830
2022-10-11 18:00:00,2022-10-11 19:00:00,393,0,647,664,1704,3656
2022-10-11 19:00:00,2022-10-11 20:00:00,433,0,650,563,1646,3425
2022-10-11 20:00:00,2022-10-11 21:00:00,393,0,574,476,1443,3208
2022-10-11 21:00:00,2022-10-11 22:00:00,574,0,511,485,1570,3078
2022-10-11 22:00:00,2022-10-11 23:00:00,666,0,482,528,1676,2990
2022-10-11 23:00:00,2022-10-12 00:00:00,568,0,428,562,1558,2976
2022-10-12 00:00:00,2022-10-12 01:00:00,555,0,434,565,1554,2963
2022-10-12 01:00:00,2022-10-12 02:00:00,638,0,474,572,1684,3000
2022-10-12 02:00:00,2022-10-12 03:00:00,699,0,458,478,1635,3185
2022-10-12 03:00:00,2022-10-12 04:00:00,710,0,273,458,1441,3751
2022-10-12 04:00:00,2022-10-12 05:00:00,741,2,249,464,1456,4171
2022-10-12 05:00:00,2022-10-12 06:00:00,746,65,205,482,1498,4310
2022-10-12 06:00:00,2022-10-12 07:00:00,727,235,205,433,1600,4284
2022-10-12 07:00:00,2022-10-12 08:00:00,719,596,207,365,1887,4454
2022-10-12 08:00:00,2022-10-12 09:00:00,726,797,220,427,2170,4438
2022-10-12 09:00:00,2022-10-12 10:00:00,739,870,340,560,2509,4388
2022-10-12 10:00:00,2022-10-12 11:00:00,681,887,636,775,2979,4477
2022-10-12 11:00:00,2022-10-12 12:00:00,460,985,838,931,3214,4550
2022-10-12 12:00:00,2022-10-12 13:00:00,441,715,806,956,2918,4345
2022-10-12 13:00:00,2022-10-12 14:00:00,730,357,755,843,2685,4109
2022-10-12 14:00:00,2022-10-12 15:00:00,766,137,660,728,2291,4302
2022-10-12 15:00:00,2022-10-12 16:00:00,763,11,658,751,2183,4227
2022-10-12 16:00:00,2022-10-12 17:00:00,761,3,812,874,2450,4071
2022-10-12 17:00:00,2022-10-12 18:00:00,760,3,892,1042,2697,3855
2022-10-12 18:00:00,2022-10-12 19:00:00,495,4,1034,1167,2700,3666
2022-10-12 19:00:00,2022-10-12 20:00:00,595,4,1124,1152,2875,3457
2022-10-12 20:00:00,2022-10-12 21:00:00,761,4,1096,1159,3020,3236
2022-10-12 21:00:00,2022-10-12 22:00:00,665,4,895,1125,2689,3093
2022-10-12 22:00:00,2022-10-12 23:00:00,666,4,819,1052,2541,3018
2022-10-12 23:00:00,2022-10-13 00:00:00,692,4,683,1011,2390,2984
2022-10-13 00:00:00,2022-10-13 01:00:00,717,4,738,963,2422,2918
2022-10-13 01:00:00,2022-10-13 02:00:00,627,4,715,901,2247,2973
2022-10-13 02:00:00,2022-10-13 03:00:00,743,4,670,848,2265,3181
2022-10-13 03:00:00,2022-10-13 04:00:00,611,4,636,792,2043,3713
2022-10-13 04:00:00,2022-10-13 05:00:00,704,6,672,732,2114,4189
2022-10-13 05:00:00,2022-10-13 06:00:00,715,55,658,693,2121,4308
2022-10-13 06:00:00,2022-10-13 07:00:00,711,165,627,629,2132,4323
2022-10-13 07:00:00,2022-10-13 08:00:00,686,309,501,570,2066,4459
2022-10-13 08:00:00,2022-10-13 09:00:00,682,492,464,509,2147,4489
2022-10-13 09:00:00,2022-10-13 10:00:00,662,503,522,504,2191,4433
2022-10-13 10:00:00,2022-10-13 11:00:00,621,369,464,461,1915,4404
2022-10-13 11:00:00,2022-10-13 12:00:00,622,276,442,397,1737,4285
2022-10-13 12:00:00,2022-10-13 13:00:00,629,204,336,388,1557,4180
2022-10-13 13:00:00,2022-10-13 14:00:00,630,125,219,325,1299,4183
2022-10-13 14:00:00,2022-10-13 15:00:00,632,48,230,342,1252,4263
2022-10-13 15:00:00,2022-10-13 16:00:00,631,7,245,359,1242,4230
2022-10-13 16:00:00,2022-10-13 17:00:00,623,3,282,343,1251,4103
2022-10-13 17:00:00,2022-10-13 18:00:00,641,3,399,310,1353,3840
2022-10-13 18:00:00,2022-10-13 19:00:00,627,3,492,309,1431,3651
2022-10-13 19:00:00,2022-10-13 20:00:00,624,3,378,306,1311,3406
2022-10-13 20:00:00,2022-10-13 21:00:00,621,3,232,264,1120,3204
2022-10-13 21:00:00,2022-10-13 22:00:00,652,4,182,187,1025,3112
2022-10-13 22:00:00,2022-10-13 23:00:00,663,4,111,153,931,3049
2022-10-13 23:00:00,2022-10-14 00:00:00,658,4,63,161,886,3002
2022-10-14 00:00:00,2022-10-14 01:00:00,590,4,42,192,828,2953
2022-10-14 01:00:00,2022-10-14 02:00:00,519,3,37,178,737,2951
2022-10-14 02:00:00,2022-10-14 03:00:00,621,3,50,175,849,3138
2022-10-14 03:00:00,2022-10-14 04:00:00,654,3,89,193,939,3599
2022-10-14 04:00:00,2022-10-14 05:00:00,673,4,145,238,1060,4149
2022-10-14 05:00:00,2022-10-14 06:00:00,657,48,220,297,1222,4324
2022-10-14 06:00:00,2022-10-14 07:00:00,638,233,246,291,1408,4381
2022-10-14 07:00:00,2022-10-14 08:00:00,658,381,222,262,1523,4374
2022-10-14 08:00:00,2022-10-14 09:00:00,678,783,189,266,1916,4446
2022-10-14 09:00:00,2022-10-14 10:00:00,676,952,238,411,2277,4393
2022-10-14 10:00:00,2022-10-14 11:00:00,626,1015,221,597,2459,4374
2022-10-14 11:00:00,2022-10-14 12:00:00,635,906,224,601,2366,4180
2022-10-14 12:00:00,2022-10-14 13:00:00,637,673,364,546,2220,4084
2022-10-14 13:00:00,2022-10-14 14:00:00,487,457,500,436,1880,4034
2022-10-14 14:00:00,2022-10-14 15:00:00,505,148,544,413,1610,4130
2022-10-14 15:00:00,2022-10-14 16:00:00,603,9,597,533,1742,4018
2022-10-14 16:00:00,2022-10-14 17:00:00,585,3,634,684,1906,3842
2022-10-14 17:00:00,2022-10-14 18:00:00,582,3,667,830,2082,3582
2022-10-14 18:00:00,2022-10-14 19:00:00,586,3,693,872,2154,3332
2022-10-14 19:00:00,2022-10-14 20:00:00,563,3,732,901,2199,3140
2022-10-14 20:00:00,2022-10-14 21:00:00,524,3,768,948,2243,3071
2022-10-14 21:00:00,2022-10-14 22:00:00,278,3,725,936,1942,2903
2022-10-14 22:00:00,2022-10-14 23:00:00,221,3,707,832,1763,2761
2022-10-14 23:00:00,2022-10-15 00:00:00,218,3,765,753,1739,2717
2022-10-15 00:00:00,2022-10-15 01:00:00,203,3,859,692,1757,2732
2022-10-15 01:00:00,2022-10-15 02:00:00,146,3,794,620,1563,2760
2022-10-15 02:00:00,2022-10-15 03:00:00,152,3,646,465,1266,2784
2022-10-15 03:00:00,2022-10-15 04:00:00,204,3,541,293,1041,2896
2022-10-15 04:00:00,2022-10-15 05:00:00,179,4,404,216,803,3151
2022-10-15 05:00:00,2022-10-15 06:00:00,231,61,352,203,847,3299
2022-10-15 06:00:00,2022-10-15 07:00:00,224,328,295,197,1044,3515
2022-10-15 07:00:00,2022-10-15 08:00:00,164,592,224,187,1167,3654
2022-10-15 08:00:00,2022-10-15 09:00:00,159,782,221,237,1399,3704
2022-10-15 09:00:00,2022-10-15 10:00:00,158,913,406,373,1850,3701
2022-10-15 10:00:00,2022-10-15 11:00:00,167,876,618,609,2270,3712
2022-10-15 11:00:00,2022-10-15 12:00:00,150,711,880,949,2690,3688
2022-10-15 12:00:00,2022-10-15 13:00:00,138,407,997,1311,2853,3602
2022-10-15 13:00:00,2022-10-15 14:00:00,155,181,1084,1510,2930,3648
2022-10-15 14:00:00,2022-10-15 15:00:00,142,76,1228,1784,3230,3784
2022-10-15 15:00:00,2022-10-15 16:00:00,148,5,1314,2205,3672,3860
2022-10-15 16:00:00,2022-10-15 17:00:00,147,3,1465,2482,4097,3618
2022-10-15 17:00:00,2022-10-15 18:00:00,138,3,1491,2486,4118,3399
2022-10-15 18:00:00,2022-10-15 19:00:00,126,4,1604,2078,3812,3238
2022-10-15 19:00:00,2022-10-15 20:00:00,133,3,1753,1673,3562,3103
2022-10-15 20:00:00,2022-10-15 21:00:00,131,3,1631,1378,3143,2990
2022-10-15 21:00:00,2022-10-15 22:00:00,91,4,1414,1074,2583,2873
2022-10-15 22:00:00,2022-10-15 23:00:00,94,4,1190,935,2223,2774
2022-10-15 23:00:00,2022-10-16 00:00:00,80,4,1082,942,2108,2688
2022-10-16 00:00:00,2022-10-16 01:00:00,79,4,1061,1101,2245,2608
2022-10-16 01:00:00,2022-10-16 02:00:00,79,4,1155,1258,2496,2684
2022-10-16 02:00:00,2022-10-16 03:00:00,79,3,1274,1261,2617,2846
2022-10-16 03:00:00,2022-10-16 04:00:00,85,3,1685,1708,3481,2896
2022-10-16 04:00:00,2022-10-16 05:00:00,105,4,1861,2129,4099,3076
2022-10-16 05:00:00,2022-10-16 06:00:00,117,71,1865,2422,4475,3239
2022-10-16 06:00:00,2022-10-16 07:00:00,121,340,1939,2758,5158,3514
2022-10-16 07:00:00,2022-10-16 08:00:00,102,630,1843,3139,5714,3643
2022-10-16 08:00:00,2022-10-16 09:00:00,98,821,1796,3510,6225,3759
2022-10-16 09:00:00,2022-10-16 10:00:00,99,899,1769,3575,6342,3980
2022-10-16 10:00:00,2022-10-16 11:00:00,100,1152,1799,3658,6709,4000
2022-10-16 11:00:00,2022-10-16 12:00:00,99,1036,1691,3737,6563,3908
2022-10-16 12:00:00,2022-10-16 13:00:00,102,837,1739,3754,6432,3781
2022-10-16 13:00:00,2022-10-16 14:00:00,104,508,1788,3492,5892,3857
2022-10-16 14:00:00,2022-10-16 15:00:00,108,153,1751,2854,4866,4051
2022-10-16 15:00:00,2022-10-16 16:00:00,109,8,1846,3094,5057,3922
2022-10-16 16:00:00,2022-10-16 17:00:00,130,3,1735,2750,4618,3623
2022-10-16 17:00:00,2022-10-16 18:00:00,179,3,1554,2277,4013,3443
2022-10-16 18:00:00,2022-10-16 19:00:00,125,3,1259,1918,3305,3271
2022-10-16 19:00:00,2022-10-16 20:00:00,180,3,976,1637,2796,3149
2022-10-16 20:00:00,2022-10-16 21:00:00,129,3,679,1362,2173,3000
2022-10-16 21:00:00,2022-10-16 22:00:00,121,3,518,1059,1701,2917
2022-10-16 22:00:00,2022-10-16 23:00:00,122,3,406,739,1270,2894
2022-10-16 23:00:00,2022-10-17 00:00:00,120,3,220,448,791,2839
2022-10-17 00:00:00,2022-10-17 01:00:00,119,3,174,333,629,2848
2022-10-17 01:00:00,2022-10-17 02:00:00,121,4,212,412,749,2933
2022-10-17 02:00:00,2022-10-17 03:00:00,136,4,407,535,1082,3094
2022-10-17 03:00:00,2022-10-17 04:00:00,150,3,569,792,1514,3560
2022-10-17 04:00:00,2022-10-17 05:00:00,188,4,818,1033,2043,4057
2022-10-17 05:00:00,2022-10-17 06:00:00,164,31,1089,1154,2438,4278
2022-10-17 06:00:00,2022-10-17 07:00:00,111,128,1397,1373,3009,4431
2022-10-17 07:00:00,2022-10-17 08:00:00,133,224,1469,1509,3335,4428
2022-10-17 08:00:00,2022-10-17 09:00:00,129,261,1540,1684,3614,4464
2022-10-17 09:00:00,2022-10-17 10:00:00,128,370,1562,1713,3773,4415
2022-10-17 10:00:00,2022-10-17 11:00:00,124,367,1543,1936,3970,4420
2022-10-17 11:00:00,2022-10-17 12:00:00,117,180,1519,2019,3835,4317
2022-10-17 12:00:00,2022-10-17 13:00:00,176,116,1464,1744,3500,4161
2022-10-17 13:00:00,2022-10-17 14:00:00,218,75,1500,1579,3372,4069
2022-10-17 14:00:00,2022-10-17 15:00:00,221,24,1385,1652,3282,4311
2022-10-17 15:00:00,2022-10-17 16:00:00,220,5,1553,1777,3555,4290
2022-10-17 16:00:00,2022-10-17 17:00:00,182,3,1547,1860,3592,4031
2022-10-17 17:00:00,2022-10-17 18:00:00,154,3,1563,1812,3532,3768
2022-10-17 18:00:00,2022-10-17 19:00:00,147,3,1598,1747,3495,3539
2022-10-17 19:00:00,2022-10-17 20:00:00,147,3,1570,1619,3339,3333
2022-10-17 20:00:00,2022-10-17 21:00:00,140,3,1585,1503,3231,3179
2022-10-17 21:00:00,2022-10-17 22:00:00,234,4,1480,1437,3155,3045
2022-10-17 22:00:00,2022-10-17 23:00:00,265,3,1506,1560,3334,3024
2022-10-17 23:00:00,2022-10-18 00:00:00,214,3,1425,1775,3417,2966
2022-10-18 00:00:00,2022-10-18 01:00:00,140,3,1393,1842,3378,2924
2022-10-18 01:00:00,2022-10-18 02:00:00,137,4,1406,1901,3448,2936
2022-10-18 02:00:00,2022-10-18 03:00:00,142,4,1419,1876,3441,3106
2022-10-18 03:00:00,2022-10-18 04:00:00,299,3,1386,1925,3613,3540
2022-10-18 04:00:00,2022-10-18 05:00:00,369,4,1355,1914,3642,3988
2022-10-18 05:00:00,2022-10-18 06:00:00,383,41,1378,1895,3697,4135
2022-10-18 06:00:00,2022-10-18 07:00:00,384,217,1432,1807,3840,4253
2022-10-18 07:00:00,2022-10-18 08:00:00,302,391,1475,1840,4008,4264
2022-10-18 08:00:00,2022-10-18 09:00:00,213,494,1313,2042,4062,4236
2022-10-18 09:00:00,2022-10-18 10:00:00,94,611,1282,1913,3900,4368
2022-10-18 10:00:00,2022-10-18 11:00:00,90,594,1387,2312,4383,4340
2022-10-18 11:00:00,2022-10-18 12:00:00,90,512,1428,2124,4154,4298
2022-10-18 12:00:00,2022-10-18 13:00:00,94,417,1562,2010,4083,4140
2022-10-18 13:00:00,2022-10-18 14:00:00,101,253,1531,2139,4024,3980
2022-10-18 14:00:00,2022-10-18 15:00:00,227,60,1611,1908,3806,4157
2022-10-18 15:00:00,2022-10-18 16:00:00,383,1,1626,1486,3496,4197
2022-10-18 16:00:00,2022-10-18 17:00:00,402,0,1689,1168,3259,3901
2022-10-18 17:00:00,2022-10-18 18:00:00,402,0,1611,1055,3068,3718
2022-10-18 18:00:00,2022-10-18 19:00:00,221,0,1475,969,2665,3528
2022-10-18 19:00:00,2022-10-18 20:00:00,121,0,1548,846,2515,3361
2022-10-18 20:00:00,2022-10-18 21:00:00,116,0,1487,723,2326,3149
2022-10-18 21:00:00,2022-10-18 22:00:00,113,0,1486,644,2243,3086
2022-10-18 22:00:00,2022-10-18 23:00:00,103,0,1260,536,1899,3035
2022-10-18 23:00:00,2022-10-19 00:00:00,107,0,1015,465,1587,2988
2022-10-19 00:00:00,2022-10-19 01:00:00,112,0,866,386,1364,2883
2022-10-19 01:00:00,2022-10-19 02:00:00,115,0,695,346,1156,2889
2022-10-19 02:00:00,2022-10-19 03:00:00,158,0,475,327,960,3074
2022-10-19 03:00:00,2022-10-19 04:00:00,191,0,418,261,870,3541
2022-10-19 04:00:00,2022-10-19 05:00:00,173,1,367,197,738,4057
2022-10-19 05:00:00,2022-10-19 06:00:00,157,64,321,183,725,4244
2022-10-19 06:00:00,2022-10-19 07:00:00,188,347,203,172,910,4203
2022-10-19 07:00:00,2022-10-19 08:00:00,208,706,168,169,1251,4224
2022-10-19 08:00:00,2022-10-19 09:00:00,194,967,161,178,1500,4197
2022-10-19 09:00:00,2022-10-19 10:00:00,190,1092,147,157,1586,4129
2022-10-19 10:00:00,2022-10-19 11:00:00,144,1105,85,146,1480,4122
2022-10-19 11:00:00,2022-10-19 12:00:00,126,1009,50,136,1321,4038
2022-10-19 12:00:00,2022-10-19 13:00:00,151,789,64,130,1134,3923
2022-10-19 13:00:00,2022-10-19 14:00:00,172,450,59,120,801,3935
2022-10-19 14:00:00,2022-10-19 15:00:00,204,115,39,103,461,4192
2022-10-19 15:00:00,2022-10-19 16:00:00,206,3,51,123,383,4292
2022-10-19 16:00:00,2022-10-19 17:00:00,205,0,71,174,450,4108
2022-10-19 17:00:00,2022-10-19 18:00:00,234,0,93,266,593,3890
2022-10-19 18:00:00,2022-10-19 19:00:00,257,0,204,367,828,3721
2022-10-19 19:00:00,2022-10-19 20:00:00,240,0,267,520,1027,3576
2022-10-19 20:00:00,2022-10-19 21:00:00,310,0,328,617,1255,3472
2022-10-19 21:00:00,2022-10-19 22:00:00,352,0,382,712,1446,3294
2022-10-19 22:00:00,2022-10-19 23:00:00,328,0,470,814,1612,3288
2022-10-19 23:00:00,2022-10-20 00:00:00,303,0,556,912,1771,3248
2022-10-20 00:00:00,2022-10-20 01:00:00,338,0,605,880,1823,3187
2022-10-20 01:00:00,2022-10-20 02:00:00,288,0,662,780,1730,3190
2022-10-20 02:00:00,2022-10-20 03:00:00,370,0,748,771,1889,3325
2022-10-20 03:00:00,2022-10-20 04:00:00,401,0,809,871,2081,3754
2022-10-20 04:00:00,2022-10-20 05:00:00,334,1,817,892,2044,4352
2022-10-20 05:00:00,2022-10-20 06:00:00,294,63,863,942,2162,4405
2022-10-20 06:00:00,2022-10-20 07:00:00,311,348,1026,888,2573,4350
2022-10-20 07:00:00,2022-10-20 08:00:00,325,677,1158,802,2962,4361
2022-10-20 08:00:00,2022-10-20 09:00:00,340,827,1198,963,3328,4290
2022-10-20 09:00:00,2022-10-20 10:00:00,307,867,1227,1338,3739,4236
2022-10-20 10:00:00,2022-10-20 11:00:00,260,874,1301,1772,4207,4249
2022-10-20 11:00:00,2022-10-20 12:00:00,236,816,1401,2047,4500,4326
2022-10-20 12:00:00,2022-10-20 13:00:00,240,609,1509,2016,4374,4286
2022-10-20 13:00:00,2022-10-20 14:00:00,240,335,1624,2163,4362,4285
2022-10-20 14:00:00,2022-10-20 15:00:00,264,66,1775,2238,4343,4492
2022-10-20 15:00:00,2022-10-20 16:00:00,349,1,1920,2383,4653,4244
2022-10-20 16:00:00,2022-10-20 17:00:00,346,0,1926,2289,4561,4054
2022-10-20 17:00:00,2022-10-20 18:00:00,271,0,1898,2177,4346,3834
2022-10-20 18:00:00,2022-10-20 19:00:00,317,0,1872,1984,4173,3613
2022-10-20 19:00:00,2022-10-20 20:00:00,339,0,1851,1732,3922,3431
2022-10-20 20:00:00,2022-10-20 21:00:00,282,0,1753,1550,3585,3254
2022-10-20 21:00:00,2022-10-20 22:00:00,228,0,1542,1315,3085,3138
2022-10-20 22:00:00,2022-10-20 23:00:00,243,0,1442,1085,2770,3069
2022-10-20 23:00:00,2022-10-21 00:00:00,240,0,1263,903,2406,3037
2022-10-21 00:00:00,2022-10-21 01:00:00,263,0,1040,771,2074,3011
2022-10-21 01:00:00,2022-10-21 02:00:00,327,0,847,616,1790,2945
2022-10-21 02:00:00,2022-10-21 03:00:00,429,0,635,595,1659,3111
2022-10-21 03:00:00,2022-10-21 04:00:00,464,0,650,530,1644,3464
2022-10-21 04:00:00,2022-10-21 05:00:00,458,0,527,491,1476,3978
2022-10-21 05:00:00,2022-10-21 06:00:00,485,10,462,395,1352,4214
2022-10-21 06:00:00,2022-10-21 07:00:00,498,70,488,357,1413,4312
2022-10-21 07:00:00,2022-10-21 08:00:00,528,151,484,320,1483,4428
2022-10-21 08:00:00,2022-10-21 09:00:00,504,189,234,303,1230,4348
2022-10-21 09:00:00,2022-10-21 10:00:00,494,202,266,300,1262,4216
2022-10-21 10:00:00,2022-10-21 11:00:00,504,187,277,328,1296,4189
2022-10-21 11:00:00,2022-10-21 12:00:00,492,134,162,376,1164,4099
2022-10-21 12:00:00,2022-10-21 13:00:00,627,89,152,405,1273,4022
2022-10-21 13:00:00,2022-10-21 14:00:00,688,49,165,449,1351,4070
2022-10-21 14:00:00,2022-10-21 15:00:00,697,10,233,483,1423,4266
2022-10-21 15:00:00,2022-10-21 16:00:00,693,0,271,469,1433,4212
2022-10-21 16:00:00,2022-10-21 17:00:00,674,0,256,465,1395,3933
2022-10-21 17:00:00,2022-10-21 18:00:00,652,0,233,447,1332,3676
2022-10-21 18:00:00,2022-10-21 19:00:00,427,0,158,361,946,3501
2022-10-21 19:00:00,2022-10-21 20:00:00,482,0,116,325,923,3317
2022-10-21 20:00:00,2022-10-21 21:00:00,500,0,85,316,901,3149
2022-10-21 21:00:00,2022-10-21 22:00:00,388,0,43,264,695,3025
2022-10-21 22:00:00,2022-10-21 23:00:00,383,0,33,209,625,2943
2022-10-21 23:00:00,2022-10-22 00:00:00,318,0,30,169,517,2849
2022-10-22 00:00:00,2022-10-22 01:00:00,234,0,25,164,423,2797
2022-10-22 01:00:00,2022-10-22 02:00:00,287,0,49,169,505,2753
2022-10-22 02:00:00,2022-10-22 03:00:00,306,0,67,170,543,2782
2022-10-22 03:00:00,2022-10-22 04:00:00,321,0,83,145,549,2918
2022-10-22 04:00:00,2022-10-22 05:00:00,304,0,116,149,569,3195
2022-10-22 05:00:00,2022-10-22 06:00:00,290,11,115,166,582,3381
2022-10-22 06:00:00,2022-10-22 07:00:00,302,59,125,150,636,3533
2022-10-22 07:00:00,2022-10-22 08:00:00,263,135,104,124,626,3663
2022-10-22 08:00:00,2022-10-22 09:00:00,246,206,149,131,732,3692
2022-10-22 09:00:00,2022-10-22 10:00:00,193,257,195,152,797,3659
2022-10-22 10:00:00,2022-10-22 11:00:00,217,280,220,183,900,3648
2022-10-22 11:00:00,2022-10-22 12:00:00,174,265,196,230,865,3612
2022-10-22 12:00:00,2022-10-22 13:00:00,197,195,224,281,897,3564
2022-10-22 13:00:00,2022-10-22 14:00:00,233,88,274,311,906,3629
2022-10-22 14:00:00,2022-10-22 15:00:00,243,19,356,297,915,3865
2022-10-22 15:00:00,2022-10-22 16:00:00,252,1,350,345,948,3928
2022-10-22 16:00:00,2022-10-22 17:00:00,249,0,378,432,1059,3664
2022-10-22 17:00:00,2022-10-22 18:00:00,251,0,461,454,1166,3400
2022-10-22 18:00:00,2022-10-22 19:00:00,181,0,536,554,1271,3215
2022-10-22 19:00:00,2022-10-22 20:00:00,194,0,443,669,1306,3066
2022-10-22 20:00:00,2022-10-22 21:00:00,215,0,565,763,1543,2924
2022-10-22 21:00:00,2022-10-22 22:00:00,240,0,555,747,1542,2846
2022-10-22 22:00:00,2022-10-22 23:00:00,258,0,477,685,1420,2798
2022-10-22 23:00:00,2022-10-23 00:00:00,217,0,511,659,1387,2724
2022-10-23 00:00:00,2022-10-23 01:00:00,201,0,591,713,1505,2666
2022-10-23 01:00:00,2022-10-23 02:00:00,235,0,616,638,1489,2656
2022-10-23 02:00:00,2022-10-23 03:00:00,286,0,466,534,1286,2680
2022-10-23 03:00:00,2022-10-23 04:00:00,241,0,365,522,1128,2775
2022-10-23 04:00:00,2022-10-23 05:00:00,229,0,309,464,1002,3027
2022-10-23 05:00:00,2022-10-23 06:00:00,231,21,238,384,874,3256
2022-10-23 06:00:00,2022-10-23 07:00:00,307,105,193,310,915,3450
2022-10-23 07:00:00,2022-10-23 08:00:00,282,215,193,273,963,3584
2022-10-23 08:00:00,2022-10-23 09:00:00,252,354,208,229,1043,3599
2022-10-23 09:00:00,2022-10-23 10:00:00,197,492,181,194,1064,3604
2022-10-23 10:00:00,2022-10-23 11:00:00,208,567,169,206,1150,3576
2022-10-23 11:00:00,2022-10-23 12:00:00,220,496,216,194,1126,3578
2022-10-23 12:00:00,2022-10-23 13:00:00,224,356,220,146,946,3594
2022-10-23 13:00:00,2022-10-23 14:00:00,263,167,259,164,853,3675
2022-10-23 14:00:00,2022-10-23 15:00:00,157,31,487,348,1023,4031
2022-10-23 15:00:00,2022-10-23 16:00:00,150,0,734,604,1488,4162
2022-10-23 16:00:00,2022-10-23 17:00:00,162,0,898,781,1841,3884
2022-10-23 17:00:00,2022-10-23 18:00:00,179,0,1082,1017,2278,3640
2022-10-23 18:00:00,2022-10-23 19:00:00,184,0,1165,1242,2591,3478
2022-10-23 19:00:00,2022-10-23 20:00:00,176,0,1263,1500,2939,3253
2022-10-23 20:00:00,2022-10-23 21:00:00,151,0,1356,1500,3007,3081
2022-10-23 21:00:00,2022-10-23 22:00:00,152,0,1387,1502,3041,3009
2022-10-23 22:00:00,2022-10-23 23:00:00,136,0,1244,1654,3034,2963
2022-10-23 23:00:00,2022-10-24 00:00:00,153,0,1181,1699,3033,2973
2022-10-24 00:00:00,2022-10-24 01:00:00,162,0,1047,1748,2957,2959
2022-10-24 01:00:00,2022-10-24 02:00:00,141,0,1130,1710,2981,2983
2022-10-24 02:00:00,2022-10-24 03:00:00,141,0,1143,1611,2895,3186
2022-10-24 03:00:00,2022-10-24 04:00:00,200,0,1119,1309,2628,3695
2022-10-24 04:00:00,2022-10-24 05:00:00,192,0,1223,1116,2531,4223
2022-10-24 05:00:00,2022-10-24 06:00:00,188,21,1224,1109,2542,4408
2022-10-24 06:00:00,2022-10-24 07:00:00,284,128,1267,1133,2812,4462
2022-10-24 07:00:00,2022-10-24 08:00:00,264,220,1434,1145,3063,4546
2022-10-24 08:00:00,2022-10-24 09:00:00,108,327,1602,1311,3348,4483
2022-10-24 09:00:00,2022-10-24 10:00:00,172,392,1538,1511,3613,4393
2022-10-24 10:00:00,2022-10-24 11:00:00,312,443,1600,1678,4033,4423
2022-10-24 11:00:00,2022-10-24 12:00:00,221,387,1590,1827,4025,4273
2022-10-24 12:00:00,2022-10-24 13:00:00,207,224,1615,2108,4154,4265
2022-10-24 13:00:00,2022-10-24 14:00:00,218,131,1652,2303,4304,4266
2022-10-24 14:00:00,2022-10-24 15:00:00,217,22,1538,2428,4205,4730
2022-10-24 15:00:00,2022-10-24 16:00:00,274,0,1703,2367,4344,4667
2022-10-24 16:00:00,2022-10-24 17:00:00,189,0,1701,2529,4419,4266
2022-10-24 17:00:00,2022-10-24 18:00:00,145,0,1763,2602,4510,4109
2022-10-24 18:00:00,2022-10-24 19:00:00,139,0,1876,2362,4377,3965
2022-10-24 19:00:00,2022-10-24 20:00:00,136,0,1698,2282,4116,3710
2022-10-24 20:00:00,2022-10-24 21:00:00,138,0,1715,2477,4330,3481
2022-10-24 21:00:00,2022-10-24 22:00:00,194,0,1680,2645,4519,3257
2022-10-24 22:00:00,2022-10-24 23:00:00,143,0,1595,2514,4252,3127
2022-10-24 23:00:00,2022-10-25 00:00:00,125,0,1572,2153,3850,3131
2022-10-25 00:00:00,2022-10-25 01:00:00,142,0,1441,1972,3555,3051
2022-10-25 01:00:00,2022-10-25 02:00:00,128,0,1431,1775,3334,3056
2022-10-25 02:00:00,2022-10-25 03:00:00,112,0,1451,1737,3300,3168
2022-10-25 03:00:00,2022-10-25 04:00:00,105,0,1512,1716,3333,3677
2022-10-25 04:00:00,2022-10-25 05:00:00,143,0,1465,1655,3263,4255
2022-10-25 05:00:00,2022-10-25 06:00:00,189,16,1519,1621,3345,4365
2022-10-25 06:00:00,2022-10-25 07:00:00,221,113,1430,1551,3315,4436
2022-10-25 07:00:00,2022-10-25 08:00:00,255,244,1476,1664,3639,4271
2022-10-25 08:00:00,2022-10-25 09:00:00,254,320,1505,1810,3889,4377
2022-10-25 09:00:00,2022-10-25 10:00:00,295,347,1477,1861,3980,4360
2022-10-25 10:00:00,2022-10-25 11:00:00,190,423,1377,1932,3922,4366
2022-10-25 11:00:00,2022-10-25 12:00:00,144,379,1274,1941,3738,4301
2022-10-25 12:00:00,2022-10-25 13:00:00,188,277,1183,1857,3505,4183
2022-10-25 13:00:00,2022-10-25 14:00:00,221,165,1113,1605,3104,4177
2022-10-25 14:00:00,2022-10-25 15:00:00,190,30,1155,1382,2757,4375
2022-10-25 15:00:00,2022-10-25 16:00:00,312,0,1221,1158,2691,4350
2022-10-25 16:00:00,2022-10-25 17:00:00,272,0,1112,1035,2419,4059
2022-10-25 17:00:00,2022-10-25 18:00:00,205,0,981,954,2140,3840
2022-10-25 18:00:00,2022-10-25 19:00:00,237,0,896,899,2032,3666
2022-10-25 19:00:00,2022-10-25 20:00:00,242,0,814,800,1856,3429
2022-10-25 20:00:00,2022-10-25 21:00:00,214,0,637,742,1593,3224
2022-10-25 21:00:00,2022-10-25 22:00:00,265,0,491,668,1424,3097
2022-10-25 22:00:00,2022-10-25 23:00:00,255,0,500,598,1353,3029
2022-10-25 23:00:00,2022-10-26 00:00:00,229,0,384,512,1125,2974
2022-10-26 00:00:00,2022-10-26 01:00:00,241,0,322,471,1034,2955
2022-10-26 01:00:00,2022-10-26 02:00:00,234,0,295,378,907,2962
2022-10-26 02:00:00,2022-10-26 03:00:00,239,0,212,310,761,3168
2022-10-26 03:00:00,2022-10-26 04:00:00,273,0,226,295,794,3695
2022-10-26 04:00:00,2022-10-26 05:00:00,303,0,239,289,831,4250
2022-10-26 05:00:00,2022-10-26 06:00:00,308,19,280,293,900,4386
2022-10-26 06:00:00,2022-10-26 07:00:00,232,132,290,287,941,4404
2022-10-26 07:00:00,2022-10-26 08:00:00,238,259,331,264,1092,4463
2022-10-26 08:00:00,2022-10-26 09:00:00,199,365,358,275,1197,4432
2022-10-26 09:00:00,2022-10-26 10:00:00,171,417,428,344,1360,4379
2022-10-26 10:00:00,2022-10-26 11:00:00,170,409,489,389,1457,4402
2022-10-26 11:00:00,2022-10-26 12:00:00,153,330,537,390,1410,4302
2022-10-26 12:00:00,2022-10-26 13:00:00,173,226,631,408,1438,4154
2022-10-26 13:00:00,2022-10-26 14:00:00,208,142,739,496,1585,4171
2022-10-26 14:00:00,2022-10-26 15:00:00,249,32,771,703,1755,4419
2022-10-26 15:00:00,2022-10-26 16:00:00,97,0,847,948,1892,4430
2022-10-26 16:00:00,2022-10-26 17:00:00,61,0,932,1215,2208,4127
2022-10-26 17:00:00,2022-10-26 18:00:00,126,0,1201,1331,2658,3899
2022-10-26 18:00:00,2022-10-26 19:00:00,203,0,1385,1359,2947,3679
2022-10-26 19:00:00,2022-10-26 20:00:00,164,0,1443,1386,2993,3445
2022-10-26 20:00:00,2022-10-26 21:00:00,186,0,1391,1332,2909,3308
2022-10-26 21:00:00,2022-10-26 22:00:00,165,0,1323,1330,2818,3190
2022-10-26 22:00:00,2022-10-26 23:00:00,167,0,1251,1258,2676,3019
2022-10-26 23:00:00,2022-10-27 00:00:00,163,0,1199,1117,2479,2963
2022-10-27 00:00:00,2022-10-27 01:00:00,161,0,1033,1063,2257,2888
2022-10-27 01:00:00,2022-10-27 02:00:00,144,0,909,1125,2178,2934
2022-10-27 02:00:00,2022-10-27 03:00:00,144,0,861,1105,2110,3149
2022-10-27 03:00:00,2022-10-27 04:00:00,219,0,814,1034,2067,3664
2022-10-27 04:00:00,2022-10-27 05:00:00,322,0,849,994,2165,4199
2022-10-27 05:00:00,2022-10-27 06:00:00,300,17,822,960,2099,4355
2022-10-27 06:00:00,2022-10-27 07:00:00,246,115,739,912,2012,4382
2022-10-27 07:00:00,2022-10-27 08:00:00,289,276,600,796,1961,4407
2022-10-27 08:00:00,2022-10-27 09:00:00,312,395,489,699,1895,4401
2022-10-27 09:00:00,2022-10-27 10:00:00,209,444,518,697,1868,4385
2022-10-27 10:00:00,2022-10-27 11:00:00,199,450,552,684,1885,4420
2022-10-27 11:00:00,2022-10-27 12:00:00,230,366,549,621,1766,4307
2022-10-27 12:00:00,2022-10-27 13:00:00,239,211,709,555,1714,4202
2022-10-27 13:00:00,2022-10-27 14:00:00,221,92,759,507,1579,4215
2022-10-27 14:00:00,2022-10-27 15:00:00,252,15,915,632,1814,4449
2022-10-27 15:00:00,2022-10-27 16:00:00,221,0,1211,861,2293,4418
2022-10-27 16:00:00,2022-10-27 17:00:00,279,0,1320,993,2592,4110
2022-10-27 17:00:00,2022-10-27 18:00:00,225,0,1310,1060,2595,3931
2022-10-27 18:00:00,2022-10-27 19:00:00,186,0,1335,862,2383,3817
2022-10-27 19:00:00,2022-10-27 20:00:00,137,0,1568,867,2572,3596
2022-10-27 20:00:00,2022-10-27 21:00:00,162,0,1615,1162,2939,3236
2022-10-27 21:00:00,2022-10-27 22:00:00,191,0,1377,1295,2863,3177
2022-10-27 22:00:00,2022-10-27 23:00:00,191,0,1295,1482,2968,3066
2022-10-27 23:00:00,2022-10-28 00:00:00,266,0,1314,1459,3039,2957
2022-10-28 00:00:00,2022-10-28 01:00:00,175,0,1310,1358,2843,2912
2022-10-28 01:00:00,2022-10-28 02:00:00,259,0,1066,1182,2507,2920
2022-10-28 02:00:00,2022-10-28 03:00:00,232,0,869,1024,2125,3129
2022-10-28 03:00:00,2022-10-28 04:00:00,278,0,714,915,1907,3651
2022-10-28 04:00:00,2022-10-28 05:00:00,291,0,611,785,1687,4225
2022-10-28 05:00:00,2022-10-28 06:00:00,299,14,476,612,1401,4373
2022-10-28 06:00:00,2022-10-28 07:00:00,319,108,493,509,1429,4339
2022-10-28 07:00:00,2022-10-28 08:00:00,312,260,392,421,1385,4363
2022-10-28 08:00:00,2022-10-28 09:00:00,281,448,351,316,1396,4361
2022-10-28 09:00:00,2022-10-28 10:00:00,272,590,286,262,1410,4195
2022-10-28 10:00:00,2022-10-28 11:00:00,250,596,236,246,1328,4108
2022-10-28 11:00:00,2022-10-28 12:00:00,260,472,347,263,1342,3968
2022-10-28 12:00:00,2022-10-28 13:00:00,314,316,496,328,1454,3900
2022-10-28 13:00:00,2022-10-28 14:00:00,245,136,531,428,1340,3923
2022-10-28 14:00:00,2022-10-28 15:00:00,232,21,654,623,1530,4149
2022-10-28 15:00:00,2022-10-28 16:00:00,228,0,708,949,1885,4238
2022-10-28 16:00:00,2022-10-28 17:00:00,187,0,1189,1034,2410,3973
2022-10-28 17:00:00,2022-10-28 18:00:00,166,0,1318,996,2480,3775
2022-10-28 18:00:00,2022-10-28 19:00:00,261,0,1168,1250,2679,3599
2022-10-28 19:00:00,2022-10-28 20:00:00,169,0,1435,1710,3314,3368
2022-10-28 20:00:00,2022-10-28 21:00:00,144,0,1412,1705,3261,3277
2022-10-28 21:00:00,2022-10-28 22:00:00,163,0,1265,1776,3204,3151
2022-10-28 22:00:00,2022-10-28 23:00:00,149,0,1425,1813,3387,2987
2022-10-28 23:00:00,2022-10-29 00:00:00,219,0,1479,1736,3434,2849
2022-10-29 00:00:00,2022-10-29 01:00:00,224,0,1457,1923,3604,2621
2022-10-29 01:00:00,2022-10-29 02:00:00,253,0,1387,1722,3362,2667
2022-10-29 02:00:00,2022-10-29 03:00:00,192,0,1310,1416,2918,2708
2022-10-29 03:00:00,2022-10-29 04:00:00,203,0,1214,1250,2667,2815
2022-10-29 04:00:00,2022-10-29 05:00:00,229,0,1061,1270,2560,3042
2022-10-29 05:00:00,2022-10-29 06:00:00,253,11,1012,1259,2535,3301
2022-10-29 06:00:00,2022-10-29 07:00:00,249,105,972,1286,2612,3442
2022-10-29 07:00:00,2022-10-29 08:00:00,189,265,889,1278,2621,3510
2022-10-29 08:00:00,2022-10-29 09:00:00,227,460,832,1368,2887,3529
2022-10-29 09:00:00,2022-10-29 10:00:00,240,613,649,1461,2963,3488
2022-10-29 10:00:00,2022-10-29 11:00:00,199,659,563,1404,2825,3476
2022-10-29 11:00:00,2022-10-29 12:00:00,204,471,490,1244,2409,3447
2022-10-29 12:00:00,2022-10-29 13:00:00,261,242,460,940,1903,3438
2022-10-29 13:00:00,2022-10-29 14:00:00,276,93,413,696,1478,3547
2022-10-29 14:00:00,2022-10-29 15:00:00,290,14,391,564,1259,3787
2022-10-29 15:00:00,2022-10-29 16:00:00,292,0,377,519,1188,3862
2022-10-29 16:00:00,2022-10-29 17:00:00,292,0,316,493,1101,3605
2022-10-29 17:00:00,2022-10-29 18:00:00,261,0,329,405,995,3411
2022-10-29 18:00:00,2022-10-29 19:00:00,266,0,345,322,933,3257
2022-10-29 19:00:00,2022-10-29 20:00:00,242,0,321,258,821,3118
2022-10-29 20:00:00,2022-10-29 21:00:00,250,0,264,221,735,2994
2022-10-29 21:00:00,2022-10-29 22:00:00,267,0,203,199,669,2887
2022-10-29 22:00:00,2022-10-29 23:00:00,237,0,233,255,725,2756
2022-10-29 23:00:00,2022-10-30 00:00:00,212,0,274,327,813,2655
2022-10-30 00:00:00,2022-10-30 01:00:00,206,3,371,406,986,2584
2022-10-30 01:00:00,2022-10-30 02:00:00,162,0,470,529,1161,2556
2022-10-30 02:00:00,2022-10-30 03:00:00,191,0,476,642,1309,2549
2022-10-30 03:00:00,2022-10-30 04:00:00,177,0,501,695,1373,2607
2022-10-30 04:00:00,2022-10-30 05:00:00,212,0,460,711,1383,2806
2022-10-30 05:00:00,2022-10-30 06:00:00,291,9,437,660,1397,3042
2022-10-30 06:00:00,2022-10-30 07:00:00,273,105,407,577,1362,3266
2022-10-30 07:00:00,2022-10-30 08:00:00,238,242,426,473,1379,3362
2022-10-30 08:00:00,2022-10-30 09:00:00,211,340,461,419,1431,3436
2022-10-30 09:00:00,2022-10-30 10:00:00,222,394,443,413,1472,3424
2022-10-30 10:00:00,2022-10-30 11:00:00,229,397,379,430,1435,3451
2022-10-30 11:00:00,2022-10-30 12:00:00,229,389,266,406,1290,3439
2022-10-30 12:00:00,2022-10-30 13:00:00,246,282,213,351,1092,3427
2022-10-30 13:00:00,2022-10-30 14:00:00,280,103,133,276,792,3474
2022-10-30 14:00:00,2022-10-30 15:00:00,277,12,125,233,647,3700
2022-10-30 15:00:00,2022-10-30 16:00:00,303,0,105,217,625,4110
2022-10-30 16:00:00,2022-10-30 17:00:00,263,0,174,198,635,3915
2022-10-30 17:00:00,2022-10-30 18:00:00,290,0,144,257,691,3629
2022-10-30 18:00:00,2022-10-30 19:00:00,295,0,185,343,823,3420
2022-10-30 19:00:00,2022-10-30 20:00:00,272,0,202,431,905,3232
2022-10-30 20:00:00,2022-10-30 21:00:00,265,0,220,338,823,3078
2022-10-30 21:00:00,2022-10-30 22:00:00,249,2,270,304,825,3008
2022-10-30 22:00:00,2022-10-30 23:00:00,237,1,241,318,797,2920
2022-10-30 23:00:00,2022-10-31 00:00:00,290,0,213,357,860,2844
2022-10-31 00:00:00,2022-10-31 01:00:00,277,0,270,422,969,2775
2022-10-31 01:00:00,2022-10-31 02:00:00,225,0,266,482,973,2795
2022-10-31 02:00:00,2022-10-31 03:00:00,244,0,213,463,920,2835
2022-10-31 03:00:00,2022-10-31 04:00:00,244,0,154,409,807,3081
2022-10-31 04:00:00,2022-10-31 05:00:00,233,0,149,417,799,3676
2022-10-31 05:00:00,2022-10-31 06:00:00,262,5,191,431,889,4113
2022-10-31 06:00:00,2022-10-31 07:00:00,274,79,169,444,966,4289
2022-10-31 07:00:00,2022-10-31 08:00:00,250,210,207,380,1047,4361
2022-10-31 08:00:00,2022-10-31 09:00:00,239,318,221,340,1118,4407
2022-10-31 09:00:00,2022-10-31 10:00:00,242,408,194,357,1201,4383
2022-10-31 10:00:00,2022-10-31 11:00:00,260,426,234,409,1329,4327
2022-10-31 11:00:00,2022-10-31 12:00:00,281,352,215,437,1285,4307
2022-10-31 12:00:00,2022-10-31 13:00:00,278,283,170,350,1081,4235
2022-10-31 13:00:00,2022-10-31 14:00:00,269,141,142,260,812,4112
2022-10-31 14:00:00,2022-10-31 15:00:00,306,24,117,274,721,4195
2022-10-31 15:00:00,2022-10-31 16:00:00,303,1,137,301,742,4572
2022-10-31 16:00:00,2022-10-31 17:00:00,266,0,136,339,741,4343
2022-10-31 17:00:00,2022-10-31 18:00:00,248,0,241,365,854,4057
2022-10-31 18:00:00,2022-10-31 19:00:00,237,0,393,412,1042,3822
2022-10-31 19:00:00,2022-10-31 20:00:00,232,0,375,499,1106,3639
2022-10-31 20:00:00,2022-10-31 21:00:00,190,0,513,558,1261,3392
2022-10-31 21:00:00,2022-10-31 22:00:00,163,0,829,734,1726,3228
2022-10-31 22:00:00,2022-10-31 23:00:00,184,0,1027,1001,2212,3076
2022-10-31 23:00:00,2022-11-01 00:00:00,160,0,1285,1381,2826,2960
2022-11-01 00:00:00,2022-11-01 01:00:00,163,0,1450,1774,3387,2940
2022-11-01 01:00:00,2022-11-01 02:00:00,175,0,1482,2153,3810,2980
2022-11-01 02:00:00,2022-11-01 03:00:00,156,0,1551,2383,4090,3011
2022-11-01 03:00:00,2022-11-01 04:00:00,153,0,1649,2404,4206,3321
2022-11-01 04:00:00,2022-11-01 05:00:00,167,0,1750,2667,4584,3714
2022-11-01 05:00:00,2022-11-01 06:00:00,185,2,1728,2689,4604,4104
2022-11-01 06:00:00,2022-11-01 07:00:00,200,20,1625,2710,4555,4305
2022-11-01 07:00:00,2022-11-01 08:00:00,199,44,1555,2561,4359,4386
2022-11-01 08:00:00,2022-11-01 09:00:00,165,73,1384,2513,4135,4499
2022-11-01 09:00:00,2022-11-01 10:00:00,154,223,1326,2657,4360,4556
2022-11-01 10:00:00,2022-11-01 11:00:00,159,304,1321,2932,4716,4643
2022-11-01 11:00:00,2022-11-01 12:00:00,164,275,1333,3035,4807,4550
2022-11-01 12:00:00,2022-11-01 13:00:00,167,218,1416,3006,4807,4374
2022-11-01 13:00:00,2022-11-01 14:00:00,162,112,1555,2746,4575,4374
2022-11-01 14:00:00,2022-11-01 15:00:00,217,14,1518,2574,4323,4413
2022-11-01 15:00:00,2022-11-01 16:00:00,310,0,1512,2416,4238,4700
2022-11-01 16:00:00,2022-11-01 17:00:00,181,0,1406,2369,3956,4593
2022-11-01 17:00:00,2022-11-01 18:00:00,151,0,1556,2535,4242,4302
2022-11-01 18:00:00,2022-11-01 19:00:00,152,0,1661,2686,4499,4022
2022-11-01 19:00:00,2022-11-01 20:00:00,189,0,1627,2925,4741,3823
2022-11-01 20:00:00,2022-11-01 21:00:00,190,0,1701,2994,4885,3557
2022-11-01 21:00:00,2022-11-01 22:00:00,172,0,1714,2860,4746,3393
2022-11-01 22:00:00,2022-11-01 23:00:00,138,0,1676,2450,4264,3371
2022-11-01 23:00:00,2022-11-02 00:00:00,131,0,1680,2739,4550,3261
2022-11-02 00:00:00,2022-11-02 01:00:00,137,0,1710,2612,4459,3206
2022-11-02 01:00:00,2022-11-02 02:00:00,156,0,1707,2376,4239,3123
2022-11-02 02:00:00,2022-11-02 03:00:00,158,0,1740,2216,4114,3096
2022-11-02 03:00:00,2022-11-02 04:00:00,226,0,1706,1983,3915,3228
2022-11-02 04:00:00,2022-11-02 05:00:00,196,0,1837,2003,4036,3709
2022-11-02 05:00:00,2022-11-02 06:00:00,269,5,1790,2043,4107,4166
2022-11-02 06:00:00,2022-11-02 07:00:00,276,85,1729,2140,4230,4338
2022-11-02 07:00:00,2022-11-02 08:00:00,201,238,1692,1998,4129,4367
2022-11-02 08:00:00,2022-11-02 09:00:00,219,289,1662,1981,4151,4443
2022-11-02 09:00:00,2022-11-02 10:00:00,187,221,1718,2092,4218,4365
2022-11-02 10:00:00,2022-11-02 11:00:00,174,233,1724,2241,4372,4279
2022-11-02 11:00:00,2022-11-02 12:00:00,158,227,1820,2458,4663,4279
2022-11-02 12:00:00,2022-11-02 13:00:00,164,177,1759,2433,4533,4208
2022-11-02 13:00:00,2022-11-02 14:00:00,150,98,1838,1782,3868,4371
2022-11-02 14:00:00,2022-11-02 15:00:00,196,17,1745,1883,3841,4401
2022-11-02 15:00:00,2022-11-02 16:00:00,226,0,1703,1799,3728,4691
2022-11-02 16:00:00,2022-11-02 17:00:00,237,0,1794,1650,3681,4396
2022-11-02 17:00:00,2022-11-02 18:00:00,137,0,1584,1319,3040,4254
2022-11-02 18:00:00,2022-11-02 19:00:00,136,0,1447,1243,2826,4031
2022-11-02 19:00:00,2022-11-02 20:00:00,142,0,1518,1468,3128,3798
2022-11-02 20:00:00,2022-11-02 21:00:00,138,0,1365,1523,3026,3546
2022-11-02 21:00:00,2022-11-02 22:00:00,130,0,1166,1622,2918,3427
2022-11-02 22:00:00,2022-11-02 23:00:00,136,0,1019,1595,2750,3284
2022-11-02 23:00:00,2022-11-03 00:00:00,125,0,995,2131,3251,3197
2022-11-03 00:00:00,2022-11-03 01:00:00,122,0,1269,2172,3563,3180
2022-11-03 01:00:00,2022-11-03 02:00:00,125,0,1471,2333,3929,3152
2022-11-03 02:00:00,2022-11-03 03:00:00,155,0,1665,2517,4337,3126
2022-11-03 03:00:00,2022-11-03 04:00:00,148,0,1844,2623,4615,3401
2022-11-03 04:00:00,2022-11-03 05:00:00,157,0,1792,2711,4660,3893
2022-11-03 05:00:00,2022-11-03 06:00:00,233,6,1797,2649,4685,4376
2022-11-03 06:00:00,2022-11-03 07:00:00,241,54,1583,2319,4197,4561
2022-11-03 07:00:00,2022-11-03 08:00:00,217,165,1637,2148,4167,4544
2022-11-03 08:00:00,2022-11-03 09:00:00,259,290,1596,2199,4344,4555
2022-11-03 09:00:00,2022-11-03 10:00:00,273,371,1302,1945,3891,4505
2022-11-03 10:00:00,2022-11-03 11:00:00,324,324,1303,1826,3777,4426
2022-11-03 11:00:00,2022-11-03 12:00:00,396,223,1496,1837,3952,4434
2022-11-03 12:00:00,2022-11-03 13:00:00,360,145,1611,1744,3860,4443
2022-11-03 13:00:00,2022-11-03 14:00:00,282,67,1185,1656,3190,4404
2022-11-03 14:00:00,2022-11-03 15:00:00,286,7,1173,1553,3019,4503
2022-11-03 15:00:00,2022-11-03 16:00:00,277,0,1201,1874,3352,4842
2022-11-03 16:00:00,2022-11-03 17:00:00,294,0,1243,1740,3277,4658
2022-11-03 17:00:00,2022-11-03 18:00:00,263,0,1273,1701,3237,4363
2022-11-03 18:00:00,2022-11-03 19:00:00,255,0,1270,1742,3267,4083
2022-11-03 19:00:00,2022-11-03 20:00:00,252,0,1249,1758,3259,3869
2022-11-03 20:00:00,2022-11-03 21:00:00,259,0,1226,1614,3099,3625
2022-11-03 21:00:00,2022-11-03 22:00:00,278,0,1215,1543,3036,3428
2022-11-03 22:00:00,2022-11-03 23:00:00,280,0,1251,1419,2950,3481
2022-11-03 23:00:00,2022-11-04 00:00:00,261,0,1204,1465,2930,3372
2022-11-04 00:00:00,2022-11-04 01:00:00,261,0,1200,1556,3017,3258
2022-11-04 01:00:00,2022-11-04 02:00:00,258,0,1270,1429,2957,3200
2022-11-04 02:00:00,2022-11-04 03:00:00,253,0,1255,1468,2976,3178
2022-11-04 03:00:00,2022-11-04 04:00:00,263,0,1109,1286,2658,3409
2022-11-04 04:00:00,2022-11-04 05:00:00,275,0,1093,1502,2870,3891
2022-11-04 05:00:00,2022-11-04 06:00:00,332,2,1083,1743,3160,4398
2022-11-04 06:00:00,2022-11-04 07:00:00,353,19,1082,1966,3420,4565
2022-11-04 07:00:00,2022-11-04 08:00:00,385,74,888,2122,3469,4568
2022-11-04 08:00:00,2022-11-04 09:00:00,369,167,1043,2093,3672,4637
2022-11-04 09:00:00,2022-11-04 10:00:00,537,203,1010,2275,4025,4577
2022-11-04 10:00:00,2022-11-04 11:00:00,481,268,1067,2449,4265,4470
2022-11-04 11:00:00,2022-11-04 12:00:00,401,288,980,2430,4099,4390
2022-11-04 12:00:00,2022-11-04 13:00:00,358,225,1050,2773,4406,4285
2022-11-04 13:00:00,2022-11-04 14:00:00,404,108,993,2842,4347,4152
2022-11-04 14:00:00,2022-11-04 15:00:00,554,11,1016,2822,4403,4226
2022-11-04 15:00:00,2022-11-04 16:00:00,476,0,877,2875,4228,4517
2022-11-04 16:00:00,2022-11-04 17:00:00,471,0,1229,2826,4526,4439
2022-11-04 17:00:00,2022-11-04 18:00:00,497,0,1292,2703,4492,4146
2022-11-04 18:00:00,2022-11-04 19:00:00,346,0,1233,2643,4222,3903
2022-11-04 19:00:00,2022-11-04 20:00:00,301,0,1258,2515,4074,3723
2022-11-04 20:00:00,2022-11-04 21:00:00,340,0,1232,2237,3809,3510
2022-11-04 21:00:00,2022-11-04 22:00:00,294,0,1128,2120,3542,3347
2022-11-04 22:00:00,2022-11-04 23:00:00,316,0,1189,2003,3508,3354
2022-11-04 23:00:00,2022-11-05 00:00:00,347,0,1171,1949,3467,3233
2022-11-05 00:00:00,2022-11-05 01:00:00,281,0,1150,1848,3279,3144
2022-11-05 01:00:00,2022-11-05 02:00:00,249,0,1094,1432,2775,3186
2022-11-05 02:00:00,2022-11-05 03:00:00,261,0,1081,1260,2602,3081
2022-11-05 03:00:00,2022-11-05 04:00:00,331,0,1066,1268,2665,3003
2022-11-05 04:00:00,2022-11-05 05:00:00,361,0,969,1216,2546,3091
2022-11-05 05:00:00,2022-11-05 06:00:00,402,7,953,1220,2582,3333
2022-11-05 06:00:00,2022-11-05 07:00:00,455,129,972,1143,2699,3541
2022-11-05 07:00:00,2022-11-05 08:00:00,434,384,1016,1052,2886,3607
2022-11-05 08:00:00,2022-11-05 09:00:00,506,624,1111,1079,3320,3525
2022-11-05 09:00:00,2022-11-05 10:00:00,452,642,1021,1165,3280,3601
2022-11-05 10:00:00,2022-11-05 11:00:00,378,622,950,1259,3209,3515
2022-11-05 11:00:00,2022-11-05 12:00:00,395,541,928,1167,3031,3497
2022-11-05 12:00:00,2022-11-05 13:00:00,362,336,948,1084,2730,3489
2022-11-05 13:00:00,2022-11-05 14:00:00,555,125,948,913,2541,3484
2022-11-05 14:00:00,2022-11-05 15:00:00,629,6,944,994,2573,3677
2022-11-05 15:00:00,2022-11-05 16:00:00,614,0,1073,1094,2781,4085
2022-11-05 16:00:00,2022-11-05 17:00:00,421,0,1097,1217,2735,4003
2022-11-05 17:00:00,2022-11-05 18:00:00,314,0,1240,1224,2778,3844
2022-11-05 18:00:00,2022-11-05 19:00:00,243,0,1208,1002,2453,3836
2022-11-05 19:00:00,2022-11-05 20:00:00,298,0,1060,1118,2476,3697
2022-11-05 20:00:00,2022-11-05 21:00:00,247,0,1431,1186,2864,3518
2022-11-05 21:00:00,2022-11-05 22:00:00,242,0,1270,1240,2752,3400
2022-11-05 22:00:00,2022-11-05 23:00:00,266,0,1441,1671,3378,3227
2022-11-05 23:00:00,2022-11-06 00:00:00,261,0,1449,1827,3537,3182
2022-11-06 00:00:00,2022-11-06 01:00:00,267,0,1517,2138,3922,3049
2022-11-06 01:00:00,2022-11-06 02:00:00,246,0,1559,2321,4126,3034
2022-11-06 02:00:00,2022-11-06 03:00:00,254,0,1575,2174,4003,3060
2022-11-06 03:00:00,2022-11-06 04:00:00,250,0,1536,2118,3904,3059
2022-11-06 04:00:00,2022-11-06 05:00:00,259,0,1367,2068,3694,3129
2022-11-06 05:00:00,2022-11-06 06:00:00,251,1,1160,1746,3158,3318
2022-11-06 06:00:00,2022-11-06 07:00:00,364,35,994,1205,2598,3615
2022-11-06 07:00:00,2022-11-06 08:00:00,326,137,825,1108,2396,3773
2022-11-06 08:00:00,2022-11-06 09:00:00,272,199,823,1278,2572,3835
2022-11-06 09:00:00,2022-11-06 10:00:00,281,210,1068,1016,2575,3870
2022-11-06 10:00:00,2022-11-06 11:00:00,410,193,1359,1216,3178,3815
2022-11-06 11:00:00,2022-11-06 12:00:00,492,147,1707,1090,3436,3828
2022-11-06 12:00:00,2022-11-06 13:00:00,452,87,1669,1233,3441,3813
2022-11-06 13:00:00,2022-11-06 14:00:00,522,27,1499,1323,3371,3776
2022-11-06 14:00:00,2022-11-06 15:00:00,337,1,1506,1552,3396,3934
2022-11-06 15:00:00,2022-11-06 16:00:00,281,0,1640,1901,3822,4162
2022-11-06 16:00:00,2022-11-06 17:00:00,279,0,1738,2093,4110,4198
2022-11-06 17:00:00,2022-11-06 18:00:00,286,0,1630,1808,3724,3955
2022-11-06 18:00:00,2022-11-06 19:00:00,312,0,1724,2375,4411,3752
2022-11-06 19:00:00,2022-11-06 20:00:00,423,0,1795,2683,4901,3523
2022-11-06 20:00:00,2022-11-06 21:00:00,336,0,1844,2579,4759,3329
2022-11-06 21:00:00,2022-11-06 22:00:00,375,0,1883,2914,5172,3133
2022-11-06 22:00:00,2022-11-06 23:00:00,273,0,1688,2821,4782,3125
2022-11-06 23:00:00,2022-11-07 00:00:00,269,0,1619,2725,4613,3067
2022-11-07 00:00:00,2022-11-07 01:00:00,232,0,1541,3005,4778,3015
2022-11-07 01:00:00,2022-11-07 02:00:00,243,0,1601,3314,5158,2986
2022-11-07 02:00:00,2022-11-07 03:00:00,254,0,1793,3354,5401,3000
2022-11-07 03:00:00,2022-11-07 04:00:00,256,0,1838,2831,4925,3270
2022-11-07 04:00:00,2022-11-07 05:00:00,240,0,1636,2365,4241,3887
2022-11-07 05:00:00,2022-11-07 06:00:00,308,2,1636,2408,4354,4345
2022-11-07 06:00:00,2022-11-07 07:00:00,320,50,1652,2113,4135,4543
2022-11-07 07:00:00,2022-11-07 08:00:00,281,145,1714,2309,4449,4574
2022-11-07 08:00:00,2022-11-07 09:00:00,259,258,1737,2331,4585,4608
2022-11-07 09:00:00,2022-11-07 10:00:00,261,335,1816,2378,4790,4590
2022-11-07 10:00:00,2022-11-07 11:00:00,272,380,1807,2318,4777,4526
2022-11-07 11:00:00,2022-11-07 12:00:00,312,321,1756,2251,4640,4582
2022-11-07 12:00:00,2022-11-07 13:00:00,360,197,1740,2053,4350,4398
2022-11-07 13:00:00,2022-11-07 14:00:00,316,84,1658,1752,3810,4259
2022-11-07 14:00:00,2022-11-07 15:00:00,357,6,1541,1546,3450,4417
2022-11-07 15:00:00,2022-11-07 16:00:00,474,0,1523,1513,3510,4726
2022-11-07 16:00:00,2022-11-07 17:00:00,486,0,1459,1369,3314,4512
2022-11-07 17:00:00,2022-11-07 18:00:00,362,0,1462,1350,3174,4201
2022-11-07 18:00:00,2022-11-07 19:00:00,342,0,1466,1190,2998,3997
2022-11-07 19:00:00,2022-11-07 20:00:00,346,0,1560,1239,3145,3789
2022-11-07 20:00:00,2022-11-07 21:00:00,315,0,1528,1323,3166,3490
2022-11-07 21:00:00,2022-11-07 22:00:00,298,0,1482,1430,3210,3256
2022-11-07 22:00:00,2022-11-07 23:00:00,338,0,1353,1400,3091,3110
2022-11-07 23:00:00,2022-11-08 00:00:00,328,0,1455,1281,3064,3072
2022-11-08 00:00:00,2022-11-08 01:00:00,343,0,1603,1345,3291,2918
2022-11-08 01:00:00,2022-11-08 02:00:00,297,0,1537,1472,3306,2905
2022-11-08 02:00:00,2022-11-08 03:00:00,289,0,1468,1470,3227,3070
2022-11-08 03:00:00,2022-11-08 04:00:00,306,0,1515,1681,3502,3114
2022-11-08 04:00:00,2022-11-08 05:00:00,279,0,1572,1678,3529,3679
2022-11-08 05:00:00,2022-11-08 06:00:00,279,2,1692,1703,3676,4188
2022-11-08 06:00:00,2022-11-08 07:00:00,345,58,1753,1689,3845,4459
2022-11-08 07:00:00,2022-11-08 08:00:00,412,157,1712,1613,3894,4444
2022-11-08 08:00:00,2022-11-08 09:00:00,424,310,1645,1825,4204,4504
2022-11-08 09:00:00,2022-11-08 10:00:00,432,382,1626,1913,4353,4441
2022-11-08 10:00:00,2022-11-08 11:00:00,446,387,1524,1998,4355,4346
2022-11-08 11:00:00,2022-11-08 12:00:00,464,303,1543,2225,4535,4390
2022-11-08 12:00:00,2022-11-08 13:00:00,450,163,1603,2291,4507,4312
2022-11-08 13:00:00,2022-11-08 14:00:00,332,53,1698,2303,4386,4215
2022-11-08 14:00:00,2022-11-08 15:00:00,441,3,1794,2330,4568,4311
2022-11-08 15:00:00,2022-11-08 16:00:00,391,0,1879,2333,4603,4611
2022-11-08 16:00:00,2022-11-08 17:00:00,286,0,1904,2361,4551,4401
2022-11-08 17:00:00,2022-11-08 18:00:00,262,0,1898,2090,4250,4228
2022-11-08 18:00:00,2022-11-08 19:00:00,276,0,1896,2024,4196,4022
2022-11-08 19:00:00,2022-11-08 20:00:00,262,0,1857,1867,3986,3807
2022-11-08 20:00:00,2022-11-08 21:00:00,252,0,1818,1910,3980,3566
2022-11-08 21:00:00,2022-11-08 22:00:00,254,0,1771,1857,3882,3371
2022-11-08 22:00:00,2022-11-08 23:00:00,215,0,1729,1761,3705,3308
2022-11-08 23:00:00,2022-11-09 00:00:00,185,0,1720,2166,4071,3194
2022-11-09 00:00:00,2022-11-09 01:00:00,189,0,1609,1928,3726,3207
2022-11-09 01:00:00,2022-11-09 02:00:00,184,0,1606,1929,3719,3139
2022-11-09 02:00:00,2022-11-09 03:00:00,183,0,1720,1784,3687,3120
2022-11-09 03:00:00,2022-11-09 04:00:00,187,0,1653,1682,3522,3288
2022-11-09 04:00:00,2022-11-09 05:00:00,184,0,1647,1921,3752,3759
2022-11-09 05:00:00,2022-11-09 06:00:00,179,2,1619,2369,4169,4192
2022-11-09 06:00:00,2022-11-09 07:00:00,188,57,1590,1866,3701,4354
2022-11-09 07:00:00,2022-11-09 08:00:00,208,184,1463,1756,3611,4368
2022-11-09 08:00:00,2022-11-09 09:00:00,237,326,1596,1827,3986,4460
2022-11-09 09:00:00,2022-11-09 10:00:00,348,398,1653,2014,4413,4355
2022-11-09 10:00:00,2022-11-09 11:00:00,346,418,1602,1976,4342,4231
2022-11-09 11:00:00,2022-11-09 12:00:00,421,316,1509,1814,4060,4281
2022-11-09 12:00:00,2022-11-09 13:00:00,307,201,1417,1654,3579,4253
2022-11-09 13:00:00,2022-11-09 14:00:00,310,62,1321,1402,3095,4154
2022-11-09 14:00:00,2022-11-09 15:00:00,384,3,1340,1179,2906,4294
2022-11-09 15:00:00,2022-11-09 16:00:00,525,0,1375,974,2874,4615
2022-11-09 16:00:00,2022-11-09 17:00:00,603,0,1350,956,2909,4318
2022-11-09 17:00:00,2022-11-09 18:00:00,440,0,1404,996,2840,3982
2022-11-09 18:00:00,2022-11-09 19:00:00,330,0,1336,955,2621,3850
2022-11-09 19:00:00,2022-11-09 20:00:00,298,0,1389,844,2531,3694
2022-11-09 20:00:00,2022-11-09 21:00:00,279,0,1173,904,2356,3464
2022-11-09 21:00:00,2022-11-09 22:00:00,272,0,1387,1101,2760,3190
2022-11-09 22:00:00,2022-11-09 23:00:00,270,0,1333,849,2452,3187
2022-11-09 23:00:00,2022-11-10 00:00:00,244,0,1326,997,2567,3119
2022-11-10 00:00:00,2022-11-10 01:00:00,243,0,1258,985,2486,3103
2022-11-10 01:00:00,2022-11-10 02:00:00,244,0,1191,860,2295,3099
2022-11-10 02:00:00,2022-11-10 03:00:00,249,0,1150,888,2287,3057
2022-11-10 03:00:00,2022-11-10 04:00:00,314,0,1096,1011,2421,3261
2022-11-10 04:00:00,2022-11-10 05:00:00,336,0,1104,1020,2460,3860
2022-11-10 05:00:00,2022-11-10 06:00:00,411,4,1399,1401,3215,4201
2022-11-10 06:00:00,2022-11-10 07:00:00,413,55,1274,1301,3043,4331
2022-11-10 07:00:00,2022-11-10 08:00:00,435,149,1328,1369,3281,4362
2022-11-10 08:00:00,2022-11-10 09:00:00,417,159,1383,1663,3622,4437
2022-11-10 09:00:00,2022-11-10 10:00:00,393,173,1297,1782,3645,4452
2022-11-10 10:00:00,2022-11-10 11:00:00,326,157,1488,2041,4012,4502
2022-11-10 11:00:00,2022-11-10 12:00:00,216,114,1642,2137,4109,4520
2022-11-10 12:00:00,2022-11-10 13:00:00,290,66,1630,2311,4297,4490
2022-11-10 13:00:00,2022-11-10 14:00:00,392,28,1638,2283,4341,4385
2022-11-10 14:00:00,2022-11-10 15:00:00,315,1,1679,2332,4327,4490
2022-11-10 15:00:00,2022-11-10 16:00:00,269,0,1659,2435,4363,4750
2022-11-10 16:00:00,2022-11-10 17:00:00,238,0,1546,2451,4235,4623
2022-11-10 17:00:00,2022-11-10 18:00:00,313,0,1565,2432,4310,4345
2022-11-10 18:00:00,2022-11-10 19:00:00,328,0,1519,2549,4396,4103
2022-11-10 19:00:00,2022-11-10 20:00:00,256,0,1432,2679,4367,3868
2022-11-10 20:00:00,2022-11-10 21:00:00,170,0,1551,2619,4340,3639
2022-11-10 21:00:00,2022-11-10 22:00:00,169,0,1624,2581,4374,3452
2022-11-10 22:00:00,2022-11-10 23:00:00,121,0,1264,2537,3922,3334
2022-11-10 23:00:00,2022-11-11 00:00:00,83,0,1197,2364,3644,3220
2022-11-11 00:00:00,2022-11-11 01:00:00,84,0,1081,2353,3518,3108
2022-11-11 01:00:00,2022-11-11 02:00:00,83,0,1056,2320,3459,3065
2022-11-11 02:00:00,2022-11-11 03:00:00,84,0,991,2284,3359,3068
2022-11-11 03:00:00,2022-11-11 04:00:00,85,0,1146,2286,3517,3241
2022-11-11 04:00:00,2022-11-11 05:00:00,102,0,1514,2346,3962,3808
2022-11-11 05:00:00,2022-11-11 06:00:00,100,0,1625,2597,4322,4252
2022-11-11 06:00:00,2022-11-11 07:00:00,81,10,1495,2504,4090,4595
2022-11-11 07:00:00,2022-11-11 08:00:00,80,39,1966,3295,5380,4657
2022-11-11 08:00:00,2022-11-11 09:00:00,87,63,1892,3102,5144,4795
2022-11-11 09:00:00,2022-11-11 10:00:00,92,79,1929,2749,4849,4789
2022-11-11 10:00:00,2022-11-11 11:00:00,87,101,1874,3004,5066,4715
2022-11-11 11:00:00,2022-11-11 12:00:00,88,96,1926,3347,5457,4618
2022-11-11 12:00:00,2022-11-11 13:00:00,90,75,1964,3371,5500,4511
2022-11-11 13:00:00,2022-11-11 14:00:00,92,35,1891,3386,5404,4423
2022-11-11 14:00:00,2022-11-11 15:00:00,126,3,1914,3211,5254,4618
2022-11-11 15:00:00,2022-11-11 16:00:00,138,0,2023,3317,5478,4738
2022-11-11 16:00:00,2022-11-11 17:00:00,135,0,1909,3263,5307,4507
2022-11-11 17:00:00,2022-11-11 18:00:00,129,0,1935,2987,5051,4260
2022-11-11 18:00:00,2022-11-11 19:00:00,128,0,1787,2835,4750,4061
2022-11-11 19:00:00,2022-11-11 20:00:00,141,0,1814,2833,4788,3852
2022-11-11 20:00:00,2022-11-11 21:00:00,163,0,1818,2537,4518,3682
2022-11-11 21:00:00,2022-11-11 22:00:00,164,0,1696,2696,4556,3514
2022-11-11 22:00:00,2022-11-11 23:00:00,124,0,1573,2413,4110,3320
2022-11-11 23:00:00,2022-11-12 00:00:00,103,0,1537,2252,3892,3201
2022-11-12 00:00:00,2022-11-12 01:00:00,114,0,1667,2265,4046,3080
2022-11-12 01:00:00,2022-11-12 02:00:00,191,0,1649,2367,4207,2936
2022-11-12 02:00:00,2022-11-12 03:00:00,207,0,1525,2112,3844,2780
2022-11-12 03:00:00,2022-11-12 04:00:00,298,0,1371,1784,3453,2804
2022-11-12 04:00:00,2022-11-12 05:00:00,399,0,1178,1424,3001,2923
2022-11-12 05:00:00,2022-11-12 06:00:00,433,1,1013,1078,2525,3159
2022-11-12 06:00:00,2022-11-12 07:00:00,415,16,912,839,2182,3384
2022-11-12 07:00:00,2022-11-12 08:00:00,505,61,762,697,2025,3538
2022-11-12 08:00:00,2022-11-12 09:00:00,590,114,711,662,2077,3644
2022-11-12 09:00:00,2022-11-12 10:00:00,429,142,629,626,1826,3693
2022-11-12 10:00:00,2022-11-12 11:00:00,586,132,607,529,1854,3657
2022-11-12 11:00:00,2022-11-12 12:00:00,635,94,472,457,1658,3618
2022-11-12 12:00:00,2022-11-12 13:00:00,732,47,320,392,1491,3536
2022-11-12 13:00:00,2022-11-12 14:00:00,693,14,285,333,1325,3678
2022-11-12 14:00:00,2022-11-12 15:00:00,758,1,210,267,1236,3886
2022-11-12 15:00:00,2022-11-12 16:00:00,763,0,198,225,1186,4097
2022-11-12 16:00:00,2022-11-12 17:00:00,729,0,140,200,1069,3957
2022-11-12 17:00:00,2022-11-12 18:00:00,733,0,117,233,1083,3660
2022-11-12 18:00:00,2022-11-12 19:00:00,662,0,97,255,1014,3487
2022-11-12 19:00:00,2022-11-12 20:00:00,523,0,96,238,857,3313
2022-11-12 20:00:00,2022-11-12 21:00:00,574,0,87,210,871,3168
2022-11-12 21:00:00,2022-11-12 22:00:00,490,0,57,211,758,2997
2022-11-12 22:00:00,2022-11-12 23:00:00,381,0,111,208,700,2875
2022-11-12 23:00:00,2022-11-13 00:00:00,352,0,194,206,752,2790
2022-11-13 00:00:00,2022-11-13 01:00:00,322,0,152,204,678,2737
2022-11-13 01:00:00,2022-11-13 02:00:00,351,0,60,180,591,2710
2022-11-13 02:00:00,2022-11-13 03:00:00,347,0,84,149,580,2673
2022-11-13 03:00:00,2022-11-13 04:00:00,325,0,69,165,559,2709
2022-11-13 04:00:00,2022-11-13 05:00:00,334,0,50,164,548,2855
2022-11-13 05:00:00,2022-11-13 06:00:00,408,1,71,159,639,3098
2022-11-13 06:00:00,2022-11-13 07:00:00,405,39,106,197,747,3323
2022-11-13 07:00:00,2022-11-13 08:00:00,364,143,85,195,787,3479
2022-11-13 08:00:00,2022-11-13 09:00:00,416,242,112,197,967,3566
2022-11-13 09:00:00,2022-11-13 10:00:00,421,327,148,256,1152,3605
2022-11-13 10:00:00,2022-11-13 11:00:00,429,312,200,288,1229,3550
2022-11-13 11:00:00,2022-11-13 12:00:00,422,234,201,339,1196,3571
2022-11-13 12:00:00,2022-11-13 13:00:00,439,134,238,424,1235,3616
2022-11-13 13:00:00,2022-11-13 14:00:00,407,40,340,508,1295,3658
2022-11-13 14:00:00,2022-11-13 15:00:00,431,3,470,612,1516,3918
2022-11-13 15:00:00,2022-11-13 16:00:00,562,0,631,668,1861,4251
2022-11-13 16:00:00,2022-11-13 17:00:00,595,0,760,769,2124,4122
2022-11-13 17:00:00,2022-11-13 18:00:00,512,0,871,807,2190,3873
2022-11-13 18:00:00,2022-11-13 19:00:00,500,0,878,878,2256,3644
2022-11-13 19:00:00,2022-11-13 20:00:00,329,0,1026,976,2331,3454
2022-11-13 20:00:00,2022-11-13 21:00:00,242,0,1164,1073,2479,3350
2022-11-13 21:00:00,2022-11-13 22:00:00,165,0,1216,1154,2535,3167
2022-11-13 22:00:00,2022-11-13 23:00:00,154,0,1197,1063,2414,3234
2022-11-13 23:00:00,2022-11-14 00:00:00,160,0,1134,1079,2373,3098
2022-11-14 00:00:00,2022-11-14 01:00:00,154,0,1028,950,2132,3182
2022-11-14 01:00:00,2022-11-14 02:00:00,150,0,1147,1186,2483,3058
2022-11-14 02:00:00,2022-11-14 03:00:00,143,0,1039,991,2173,3215
2022-11-14 03:00:00,2022-11-14 04:00:00,177,0,1114,1278,2569,3262
2022-11-14 04:00:00,2022-11-14 05:00:00,265,0,1348,1543,3156,3627
2022-11-14 05:00:00,2022-11-14 06:00:00,413,0,1372,1796,3581,4407
2022-11-14 06:00:00,2022-11-14 07:00:00,372,14,1470,1988,3844,4630
2022-11-14 07:00:00,2022-11-14 08:00:00,280,62,1490,2155,3987,4648
2022-11-14 08:00:00,2022-11-14 09:00:00,249,119,1446,2073,3887,4733
2022-11-14 09:00:00,2022-11-14 10:00:00,207,178,1332,2108,3825,4745
2022-11-14 10:00:00,2022-11-14 11:00:00,243,218,1291,2031,3783,4686
2022-11-14 11:00:00,2022-11-14 12:00:00,332,185,1321,1859,3697,4654
2022-11-14 12:00:00,2022-11-14 13:00:00,377,114,1393,1731,3615,4534
2022-11-14 13:00:00,2022-11-14 14:00:00,411,38,1357,1774,3580,4469
2022-11-14 14:00:00,2022-11-14 15:00:00,433,3,1468,1788,3692,4672
2022-11-14 15:00:00,2022-11-14 16:00:00,373,0,1461,1871,3705,5005
2022-11-14 16:00:00,2022-11-14 17:00:00,336,0,1436,1721,3493,4844
2022-11-14 17:00:00,2022-11-14 18:00:00,352,0,1379,1511,3242,4521
2022-11-14 18:00:00,2022-11-14 19:00:00,339,0,1297,1457,3093,4207
2022-11-14 19:00:00,2022-11-14 20:00:00,320,0,1162,1257,2739,3859
2022-11-14 20:00:00,2022-11-14 21:00:00,311,0,989,1206,2506,3636
2022-11-14 21:00:00,2022-11-14 22:00:00,308,0,909,1124,2341,3402
2022-11-14 22:00:00,2022-11-14 23:00:00,238,0,864,1057,2159,3367
2022-11-14 23:00:00,2022-11-15 00:00:00,233,0,947,1107,2287,3204
2022-11-15 00:00:00,2022-11-15 01:00:00,157,0,1050,1203,2410,3258
2022-11-15 01:00:00,2022-11-15 02:00:00,164,0,1053,1298,2515,3277
2022-11-15 02:00:00,2022-11-15 03:00:00,234,0,1206,1363,2803,3255
2022-11-15 03:00:00,2022-11-15 04:00:00,177,0,1279,1430,2886,3383
2022-11-15 04:00:00,2022-11-15 05:00:00,403,0,1211,1454,3068,3855
2022-11-15 05:00:00,2022-11-15 06:00:00,359,1,1200,1524,3084,4469
2022-11-15 06:00:00,2022-11-15 07:00:00,353,19,1182,1524,3078,4627
2022-11-15 07:00:00,2022-11-15 08:00:00,301,64,1101,1478,2944,4668
2022-11-15 08:00:00,2022-11-15 09:00:00,328,86,978,1456,2848,4733
2022-11-15 09:00:00,2022-11-15 10:00:00,378,80,1069,1560,3087,4735
2022-11-15 10:00:00,2022-11-15 11:00:00,266,73,1273,1802,3414,4688
2022-11-15 11:00:00,2022-11-15 12:00:00,304,66,1532,2036,3938,4677
2022-11-15 12:00:00,2022-11-15 13:00:00,294,41,1683,2222,4240,4621
2022-11-15 13:00:00,2022-11-15 14:00:00,339,11,1691,2345,4386,4554
2022-11-15 14:00:00,2022-11-15 15:00:00,337,0,1809,2584,4730,4720
2022-11-15 15:00:00,2022-11-15 16:00:00,352,0,2031,2657,5040,4965
2022-11-15 16:00:00,2022-11-15 17:00:00,294,0,2041,2930,5265,4778
2022-11-15 17:00:00,2022-11-15 18:00:00,293,0,2075,3203,5571,4547
2022-11-15 18:00:00,2022-11-15 19:00:00,262,0,2035,3322,5619,4527
2022-11-15 19:00:00,2022-11-15 20:00:00,229,0,2015,2927,5171,4360
2022-11-15 20:00:00,2022-11-15 21:00:00,195,0,1937,2942,5074,4132
2022-11-15 21:00:00,2022-11-15 22:00:00,200,0,1926,2904,5030,3816
2022-11-15 22:00:00,2022-11-15 23:00:00,271,0,1907,2983,5161,3668
2022-11-15 23:00:00,2022-11-16 00:00:00,241,0,1941,3031,5213,3544
2022-11-16 00:00:00,2022-11-16 01:00:00,237,0,1943,3119,5299,3509
2022-11-16 01:00:00,2022-11-16 02:00:00,207,0,1968,2948,5123,3455
2022-11-16 02:00:00,2022-11-16 03:00:00,209,0,1907,2997,5113,3481
2022-11-16 03:00:00,2022-11-16 04:00:00,296,0,1971,2944,5211,3720
2022-11-16 04:00:00,2022-11-16 05:00:00,339,0,1952,3583,5874,4260
2022-11-16 05:00:00,2022-11-16 06:00:00,362,1,2116,3908,6387,4664
2022-11-16 06:00:00,2022-11-16 07:00:00,351,14,2119,3587,6071,4950
2022-11-16 07:00:00,2022-11-16 08:00:00,356,47,2128,3897,6428,5013
2022-11-16 08:00:00,2022-11-16 09:00:00,330,77,2123,3872,6402,5004
2022-11-16 09:00:00,2022-11-16 10:00:00,327,95,2126,3847,6395,5012
2022-11-16 10:00:00,2022-11-16 11:00:00,342,93,2122,3785,6342,4967
2022-11-16 11:00:00,2022-11-16 12:00:00,368,81,2136,3744,6329,4950
2022-11-16 12:00:00,2022-11-16 13:00:00,372,48,2139,3652,6211,4857
2022-11-16 13:00:00,2022-11-16 14:00:00,371,12,2118,3634,6135,4816
2022-11-16 14:00:00,2022-11-16 15:00:00,370,1,2137,3719,6227,4975
2022-11-16 15:00:00,2022-11-16 16:00:00,368,0,2124,3734,6226,5202
2022-11-16 16:00:00,2022-11-16 17:00:00,370,0,2126,3804,6300,4994
2022-11-16 17:00:00,2022-11-16 18:00:00,366,0,2130,3855,6351,4720
2022-11-16 18:00:00,2022-11-16 19:00:00,361,0,2109,3867,6337,4494
2022-11-16 19:00:00,2022-11-16 20:00:00,329,0,2100,3861,6290,4383
2022-11-16 20:00:00,2022-11-16 21:00:00,332,0,2131,3901,6364,4029
2022-11-16 21:00:00,2022-11-16 22:00:00,293,0,2102,3354,5749,3975
2022-11-16 22:00:00,2022-11-16 23:00:00,229,0,1961,3244,5434,3785
2022-11-16 23:00:00,2022-11-17 00:00:00,147,0,2084,3369,5600,3640
2022-11-17 00:00:00,2022-11-17 01:00:00,138,0,2028,3628,5794,3603
2022-11-17 01:00:00,2022-11-17 02:00:00,136,0,2012,3704,5852,3593
2022-11-17 02:00:00,2022-11-17 03:00:00,153,0,1968,3802,5923,3531
2022-11-17 03:00:00,2022-11-17 04:00:00,158,0,2019,3806,5983,3811
2022-11-17 04:00:00,2022-11-17 05:00:00,227,0,2019,3476,5722,4370
2022-11-17 05:00:00,2022-11-17 06:00:00,287,0,2070,3922,6279,4845
2022-11-17 06:00:00,2022-11-17 07:00:00,332,20,2054,3863,6269,4964
2022-11-17 07:00:00,2022-11-17 08:00:00,356,97,1979,3872,6304,4997
2022-11-17 08:00:00,2022-11-17 09:00:00,356,154,1969,3861,6340,5013
2022-11-17 09:00:00,2022-11-17 10:00:00,340,216,1998,3864,6418,4973
2022-11-17 10:00:00,2022-11-17 11:00:00,335,280,1951,3872,6438,4939
2022-11-17 11:00:00,2022-11-17 12:00:00,334,267,1926,3869,6396,4921
2022-11-17 12:00:00,2022-11-17 13:00:00,337,145,1938,3877,6297,4885
2022-11-17 13:00:00,2022-11-17 14:00:00,301,40,1963,3985,6289,4910
2022-11-17 14:00:00,2022-11-17 15:00:00,341,1,1977,4017,6336,5008
2022-11-17 15:00:00,2022-11-17 16:00:00,331,0,1988,4044,6363,5266
2022-11-17 16:00:00,2022-11-17 17:00:00,260,0,2018,4021,6299,5083
2022-11-17 17:00:00,2022-11-17 18:00:00,185,0,2043,3990,6218,4801
2022-11-17 18:00:00,2022-11-17 19:00:00,142,0,2027,3947,6116,4621
2022-11-17 19:00:00,2022-11-17 20:00:00,141,0,1980,3936,6057,4405
2022-11-17 20:00:00,2022-11-17 21:00:00,190,0,1985,3844,6019,4122
2022-11-17 21:00:00,2022-11-17 22:00:00,192,0,1974,3796,5962,4016
2022-11-17 22:00:00,2022-11-17 23:00:00,222,0,2031,3707,5960,3828
2022-11-17 23:00:00,2022-11-18 00:00:00,221,0,2041,3350,5612,3738
2022-11-18 00:00:00,2022-11-18 01:00:00,152,0,2019,3152,5323,3655
2022-11-18 01:00:00,2022-11-18 02:00:00,177,0,2053,2995,5225,3644
2022-11-18 02:00:00,2022-11-18 03:00:00,257,0,2056,3116,5429,3650
2022-11-18 03:00:00,2022-11-18 04:00:00,323,0,2088,2863,5274,3871
2022-11-18 04:00:00,2022-11-18 05:00:00,327,0,2072,2657,5056,4344
2022-11-18 05:00:00,2022-11-18 06:00:00,331,1,2052,2908,5292,4808
2022-11-18 06:00:00,2022-11-18 07:00:00,338,23,2055,2918,5334,4983
2022-11-18 07:00:00,2022-11-18 08:00:00,332,122,2020,2955,5429,4964
2022-11-18 08:00:00,2022-11-18 09:00:00,331,265,2003,3090,5689,5122
2022-11-18 09:00:00,2022-11-18 10:00:00,326,364,1957,3093,5740,5030
2022-11-18 10:00:00,2022-11-18 11:00:00,328,363,1880,2796,5367,4903
2022-11-18 11:00:00,2022-11-18 12:00:00,328,356,1833,2830,5347,4843
2022-11-18 12:00:00,2022-11-18 13:00:00,328,209,1845,2737,5119,4709
2022-11-18 13:00:00,2022-11-18 14:00:00,337,73,2018,2566,4994,4669
2022-11-18 14:00:00,2022-11-18 15:00:00,337,2,1919,2471,4729,4903
2022-11-18 15:00:00,2022-11-18 16:00:00,383,0,1897,2438,4718,5086
2022-11-18 16:00:00,2022-11-18 17:00:00,339,0,1908,2485,4732,4845
2022-11-18 17:00:00,2022-11-18 18:00:00,339,0,1826,2399,4564,4529
2022-11-18 18:00:00,2022-11-18 19:00:00,346,0,1691,2282,4319,4310
2022-11-18 19:00:00,2022-11-18 20:00:00,343,0,1708,1997,4048,4103
2022-11-18 20:00:00,2022-11-18 21:00:00,348,0,1515,1646,3509,3895
2022-11-18 21:00:00,2022-11-18 22:00:00,345,0,1522,1409,3276,3704
2022-11-18 22:00:00,2022-11-18 23:00:00,363,0,1412,1288,3063,3522
2022-11-18 23:00:00,2022-11-19 00:00:00,360,0,1528,1310,3198,3392
2022-11-19 00:00:00,2022-11-19 01:00:00,363,0,1510,1407,3280,3315
2022-11-19 01:00:00,2022-11-19 02:00:00,374,0,1481,1471,3326,3199
2022-11-19 02:00:00,2022-11-19 03:00:00,404,0,1396,1332,3132,3186
2022-11-19 03:00:00,2022-11-19 04:00:00,362,0,1424,1275,3061,3267
2022-11-19 04:00:00,2022-11-19 05:00:00,371,0,1531,1306,3208,3429
2022-11-19 05:00:00,2022-11-19 06:00:00,441,1,1598,1299,3339,3642
2022-11-19 06:00:00,2022-11-19 07:00:00,505,23,1598,1411,3537,3846
2022-11-19 07:00:00,2022-11-19 08:00:00,569,111,1495,1352,3527,4031
2022-11-19 08:00:00,2022-11-19 09:00:00,571,201,1617,1259,3648,4111
2022-11-19 09:00:00,2022-11-19 10:00:00,559,265,1524,1308,3656,4108
2022-11-19 10:00:00,2022-11-19 11:00:00,581,246,1384,1411,3622,4142
2022-11-19 11:00:00,2022-11-19 12:00:00,577,179,1417,1330,3503,4119
2022-11-19 12:00:00,2022-11-19 13:00:00,550,93,1281,1222,3146,4100
2022-11-19 13:00:00,2022-11-19 14:00:00,550,19,1184,1205,2958,4125
2022-11-19 14:00:00,2022-11-19 15:00:00,560,1,1182,1162,2905,4326
2022-11-19 15:00:00,2022-11-19 16:00:00,576,0,1214,1217,3007,4578
2022-11-19 16:00:00,2022-11-19 17:00:00,586,0,1195,1222,3003,4420
2022-11-19 17:00:00,2022-11-19 18:00:00,566,0,1161,1177,2904,4143
2022-11-19 18:00:00,2022-11-19 19:00:00,558,0,1113,1198,2869,3946
2022-11-19 19:00:00,2022-11-19 20:00:00,521,0,923,1098,2542,3813
2022-11-19 20:00:00,2022-11-19 21:00:00,539,0,817,1099,2455,3676
2022-11-19 21:00:00,2022-11-19 22:00:00,586,0,751,1116,2453,3544
2022-11-19 22:00:00,2022-11-19 23:00:00,563,0,731,1114,2408,3422
2022-11-19 23:00:00,2022-11-20 00:00:00,564,0,869,1147,2580,3382
2022-11-20 00:00:00,2022-11-20 01:00:00,563,0,861,1249,2673,3357
2022-11-20 01:00:00,2022-11-20 02:00:00,561,0,1231,1272,3064,3338
2022-11-20 02:00:00,2022-11-20 03:00:00,571,0,1200,1225,2996,3317
2022-11-20 03:00:00,2022-11-20 04:00:00,580,0,1205,1229,3014,3345
2022-11-20 04:00:00,2022-11-20 05:00:00,604,0,1120,1147,2871,3394
2022-11-20 05:00:00,2022-11-20 06:00:00,619,0,943,1058,2620,3605
2022-11-20 06:00:00,2022-11-20 07:00:00,644,21,1020,927,2612,3856
2022-11-20 07:00:00,2022-11-20 08:00:00,668,140,848,814,2470,3997
2022-11-20 08:00:00,2022-11-20 09:00:00,768,334,674,603,2379,4059
2022-11-20 09:00:00,2022-11-20 10:00:00,876,470,569,496,2411,4009
2022-11-20 10:00:00,2022-11-20 11:00:00,871,507,473,421,2272,4000
2022-11-20 11:00:00,2022-11-20 12:00:00,916,458,319,349,2042,4002
2022-11-20 12:00:00,2022-11-20 13:00:00,909,280,221,278,1688,4014
2022-11-20 13:00:00,2022-11-20 14:00:00,906,87,166,240,1399,4105
2022-11-20 14:00:00,2022-11-20 15:00:00,928,8,145,240,1321,4448
2022-11-20 15:00:00,2022-11-20 16:00:00,928,7,173,253,1361,4777
2022-11-20 16:00:00,2022-11-20 17:00:00,915,7,159,265,1346,4635
2022-11-20 17:00:00,2022-11-20 18:00:00,909,6,130,243,1288,4351
2022-11-20 18:00:00,2022-11-20 19:00:00,912,6,72,188,1178,4159
2022-11-20 19:00:00,2022-11-20 20:00:00,925,4,40,184,1153,3971
2022-11-20 20:00:00,2022-11-20 21:00:00,913,1,29,230,1173,3799
2022-11-20 21:00:00,2022-11-20 22:00:00,903,1,29,266,1199,3658
2022-11-20 22:00:00,2022-11-20 23:00:00,875,1,80,342,1298,3661
2022-11-20 23:00:00,2022-11-21 00:00:00,866,1,137,385,1389,3537
2022-11-21 00:00:00,2022-11-21 01:00:00,878,1,207,444,1530,3455
2022-11-21 01:00:00,2022-11-21 02:00:00,862,1,379,500,1742,3364
2022-11-21 02:00:00,2022-11-21 03:00:00,824,1,404,525,1754,3403
2022-11-21 03:00:00,2022-11-21 04:00:00,852,1,311,455,1619,3637
2022-11-21 04:00:00,2022-11-21 05:00:00,882,1,319,374,1576,4175
2022-11-21 05:00:00,2022-11-21 06:00:00,892,1,532,319,1744,4728
2022-11-21 06:00:00,2022-11-21 07:00:00,938,3,554,258,1753,4910
2022-11-21 07:00:00,2022-11-21 08:00:00,935,17,541,263,1756,4954
2022-11-21 08:00:00,2022-11-21 09:00:00,938,77,544,269,1828,5028
2022-11-21 09:00:00,2022-11-21 10:00:00,942,134,536,268,1880,4997
2022-11-21 10:00:00,2022-11-21 11:00:00,967,141,541,241,1890,4909
2022-11-21 11:00:00,2022-11-21 12:00:00,964,135,481,250,1830,4895
2022-11-21 12:00:00,2022-11-21 13:00:00,986,82,405,218,1691,4813
2022-11-21 13:00:00,2022-11-21 14:00:00,990,22,310,224,1546,4754
2022-11-21 14:00:00,2022-11-21 15:00:00,1046,1,307,220,1574,4887
2022-11-21 15:00:00,2022-11-21 16:00:00,1013,0,470,283,1766,5190
2022-11-21 16:00:00,2022-11-21 17:00:00,907,0,620,362,1889,5055
2022-11-21 17:00:00,2022-11-21 18:00:00,876,0,901,393,2170,4705
2022-11-21 18:00:00,2022-11-21 19:00:00,855,0,779,446,2080,4505
2022-11-21 19:00:00,2022-11-21 20:00:00,842,0,697,461,2000,4272
2022-11-21 20:00:00,2022-11-21 21:00:00,831,0,737,469,2037,4011
2022-11-21 21:00:00,2022-11-21 22:00:00,831,0,945,573,2349,3825
2022-11-21 22:00:00,2022-11-21 23:00:00,809,0,992,566,2367,3760
2022-11-21 23:00:00,2022-11-22 00:00:00,721,0,1212,600,2533,3681
2022-11-22 00:00:00,2022-11-22 01:00:00,681,0,1263,738,2682,3688
2022-11-22 01:00:00,2022-11-22 02:00:00,559,0,1384,958,2901,3699
2022-11-22 02:00:00,2022-11-22 03:00:00,585,0,1570,1177,3332,3721
2022-11-22 03:00:00,2022-11-22 04:00:00,692,0,1841,1454,3987,3902
2022-11-22 04:00:00,2022-11-22 05:00:00,683,0,1989,1675,4347,4458
2022-11-22 05:00:00,2022-11-22 06:00:00,753,0,2064,1837,4654,4925
2022-11-22 06:00:00,2022-11-22 07:00:00,808,5,2093,1974,4880,5053
2022-11-22 07:00:00,2022-11-22 08:00:00,817,28,2080,2175,5100,5092
2022-11-22 08:00:00,2022-11-22 09:00:00,808,52,2082,2285,5227,5121
2022-11-22 09:00:00,2022-11-22 10:00:00,872,66,2050,2431,5419,5082
2022-11-22 10:00:00,2022-11-22 11:00:00,811,62,2005,2561,5439,5005
2022-11-22 11:00:00,2022-11-22 12:00:00,795,47,1992,2603,5437,5013
2022-11-22 12:00:00,2022-11-22 13:00:00,811,28,1991,2572,5402,4938
2022-11-22 13:00:00,2022-11-22 14:00:00,821,8,1969,2595,5393,4843
2022-11-22 14:00:00,2022-11-22 15:00:00,834,1,1941,2536,5312,5015
2022-11-22 15:00:00,2022-11-22 16:00:00,841,0,2010,2414,5265,5244
2022-11-22 16:00:00,2022-11-22 17:00:00,886,0,1967,2244,5097,5032
2022-11-22 17:00:00,2022-11-22 18:00:00,833,0,1892,2049,4774,4691
2022-11-22 18:00:00,2022-11-22 19:00:00,862,0,1920,1981,4763,4434
2022-11-22 19:00:00,2022-11-22 20:00:00,883,0,1859,1930,4672,4191
2022-11-22 20:00:00,2022-11-22 21:00:00,850,0,1764,1958,4572,3942
2022-11-22 21:00:00,2022-11-22 22:00:00,812,0,1682,1945,4439,3747
2022-11-22 22:00:00,2022-11-22 23:00:00,783,0,1601,1894,4278,3644
2022-11-22 23:00:00,2022-11-23 00:00:00,727,0,1496,1801,4024,3550
2022-11-23 00:00:00,2022-11-23 01:00:00,752,0,1466,1718,3936,3526
2022-11-23 01:00:00,2022-11-23 02:00:00,683,0,1567,1685,3935,3488
2022-11-23 02:00:00,2022-11-23 03:00:00,698,0,1578,1709,3985,3504
2022-11-23 03:00:00,2022-11-23 04:00:00,808,0,1595,1653,4056,3636
2022-11-23 04:00:00,2022-11-23 05:00:00,822,0,1633,1726,4181,4150
2022-11-23 05:00:00,2022-11-23 06:00:00,898,0,1670,1832,4400,4733
2022-11-23 06:00:00,2022-11-23 07:00:00,944,5,1740,1937,4626,4951
2022-11-23 07:00:00,2022-11-23 08:00:00,954,31,1815,1970,4770,4970
2022-11-23 08:00:00,2022-11-23 09:00:00,974,63,1782,1945,4764,4993
2022-11-23 09:00:00,2022-11-23 10:00:00,982,84,1702,1840,4608,4996
2022-11-23 10:00:00,2022-11-23 11:00:00,913,94,1644,1805,4456,4961
2022-11-23 11:00:00,2022-11-23 12:00:00,862,79,1539,1764,4244,4969
2022-11-23 12:00:00,2022-11-23 13:00:00,904,55,1482,1778,4219,4855
2022-11-23 13:00:00,2022-11-23 14:00:00,983,14,1589,1809,4395,4723
2022-11-23 14:00:00,2022-11-23 15:00:00,1038,1,1674,1873,4586,4829
2022-11-23 15:00:00,2022-11-23 16:00:00,972,0,1723,1921,4616,5097
2022-11-23 16:00:00,2022-11-23 17:00:00,964,0,1824,2008,4796,4895
2022-11-23 17:00:00,2022-11-23 18:00:00,815,0,1889,2087,4791,4644
2022-11-23 18:00:00,2022-11-23 19:00:00,689,0,1828,2119,4636,4477
2022-11-23 19:00:00,2022-11-23 20:00:00,860,0,1754,2123,4737,4223
2022-11-23 20:00:00,2022-11-23 21:00:00,806,0,1660,2046,4512,3952
2022-11-23 21:00:00,2022-11-23 22:00:00,699,0,1615,2024,4338,3755
2022-11-23 22:00:00,2022-11-23 23:00:00,691,0,1629,2073,4393,3551
2022-11-23 23:00:00,2022-11-24 00:00:00,515,0,1608,1768,3891,3638
2022-11-24 00:00:00,2022-11-24 01:00:00,470,0,1546,1875,3891,3519
2022-11-24 01:00:00,2022-11-24 02:00:00,468,0,1460,1813,3741,3416
2022-11-24 02:00:00,2022-11-24 03:00:00,539,0,1348,1681,3568,3330
2022-11-24 03:00:00,2022-11-24 04:00:00,791,0,1234,1541,3566,3513
2022-11-24 04:00:00,2022-11-24 05:00:00,820,0,1073,1424,3317,4035
2022-11-24 05:00:00,2022-11-24 06:00:00,971,0,1031,1265,3267,4529
2022-11-24 06:00:00,2022-11-24 07:00:00,902,6,1095,1060,3063,4717
2022-11-24 07:00:00,2022-11-24 08:00:00,870,31,896,949,2746,4757
2022-11-24 08:00:00,2022-11-24 09:00:00,972,61,728,891,2652,4835
2022-11-24 09:00:00,2022-11-24 10:00:00,980,93,627,798,2498,4825
2022-11-24 10:00:00,2022-11-24 11:00:00,979,83,466,721,2249,4747
2022-11-24 11:00:00,2022-11-24 12:00:00,980,67,444,728,2219,4785
2022-11-24 12:00:00,2022-11-24 13:00:00,964,42,387,715,2108,4731
2022-11-24 13:00:00,2022-11-24 14:00:00,975,17,298,700,1990,4680
2022-11-24 14:00:00,2022-11-24 15:00:00,986,1,267,749,2003,4806
2022-11-24 15:00:00,2022-11-24 16:00:00,1004,0,362,783,2149,4967
2022-11-24 16:00:00,2022-11-24 17:00:00,1025,0,454,795,2274,4773
2022-11-24 17:00:00,2022-11-24 18:00:00,1001,0,498,783,2282,4498
2022-11-24 18:00:00,2022-11-24 19:00:00,937,0,524,763,2224,4232
2022-11-24 19:00:00,2022-11-24 20:00:00,666,0,595,770,2031,3985
2022-11-24 20:00:00,2022-11-24 21:00:00,647,0,708,817,2172,3783
2022-11-24 21:00:00,2022-11-24 22:00:00,621,0,829,907,2357,3612
2022-11-24 22:00:00,2022-11-24 23:00:00,546,0,918,1004,2468,3596
2022-11-24 23:00:00,2022-11-25 00:00:00,546,0,947,1003,2496,3547
2022-11-25 00:00:00,2022-11-25 01:00:00,516,0,965,1217,2698,3472
2022-11-25 01:00:00,2022-11-25 02:00:00,462,0,928,1369,2759,3478
2022-11-25 02:00:00,2022-11-25 03:00:00,481,0,1057,1380,2918,3518
2022-11-25 03:00:00,2022-11-25 04:00:00,530,0,1247,1777,3554,3555
2022-11-25 04:00:00,2022-11-25 05:00:00,652,0,1293,1966,3911,4092
2022-11-25 05:00:00,2022-11-25 06:00:00,725,0,1329,2056,4110,4580
2022-11-25 06:00:00,2022-11-25 07:00:00,920,10,1372,2130,4432,4738
2022-11-25 07:00:00,2022-11-25 08:00:00,976,44,1317,2041,4378,4748
2022-11-25 08:00:00,2022-11-25 09:00:00,1009,77,1231,1923,4240,4794
2022-11-25 09:00:00,2022-11-25 10:00:00,1029,95,1047,1746,3917,4758
2022-11-25 10:00:00,2022-11-25 11:00:00,1023,90,1039,1604,3756,4615
2022-11-25 11:00:00,2022-11-25 12:00:00,1026,63,1077,1443,3609,4514
2022-11-25 12:00:00,2022-11-25 13:00:00,1028,39,1073,1293,3433,4413
2022-11-25 13:00:00,2022-11-25 14:00:00,1040,12,1057,1243,3352,4371
2022-11-25 14:00:00,2022-11-25 15:00:00,1029,1,933,1236,3199,4528
2022-11-25 15:00:00,2022-11-25 16:00:00,1054,0,1031,1227,3312,4722
2022-11-25 16:00:00,2022-11-25 17:00:00,1057,0,1158,1066,3281,4564
2022-11-25 17:00:00,2022-11-25 18:00:00,1053,0,1105,915,3073,4267
2022-11-25 18:00:00,2022-11-25 19:00:00,986,0,886,818,2690,4033
2022-11-25 19:00:00,2022-11-25 20:00:00,987,0,674,642,2303,3819
2022-11-25 20:00:00,2022-11-25 21:00:00,984,0,592,511,2087,3617
2022-11-25 21:00:00,2022-11-25 22:00:00,997,0,536,428,1961,3464
2022-11-25 22:00:00,2022-11-25 23:00:00,1009,0,408,376,1793,3361
2022-11-25 23:00:00,2022-11-26 00:00:00,988,0,346,330,1664,3258
2022-11-26 00:00:00,2022-11-26 01:00:00,950,0,283,296,1529,3194
2022-11-26 01:00:00,2022-11-26 02:00:00,985,0,228,322,1535,3140
2022-11-26 02:00:00,2022-11-26 03:00:00,960,0,218,309,1487,3093
2022-11-26 03:00:00,2022-11-26 04:00:00,1001,0,188,326,1515,3106
2022-11-26 04:00:00,2022-11-26 05:00:00,994,0,130,380,1504,3267
2022-11-26 05:00:00,2022-11-26 06:00:00,1007,0,131,405,1543,3500
2022-11-26 06:00:00,2022-11-26 07:00:00,1005,9,127,422,1563,3753
2022-11-26 07:00:00,2022-11-26 08:00:00,1028,88,156,388,1660,3911
2022-11-26 08:00:00,2022-11-26 09:00:00,1046,211,181,375,1813,3966
2022-11-26 09:00:00,2022-11-26 10:00:00,1022,295,223,291,1831,3923
2022-11-26 10:00:00,2022-11-26 11:00:00,915,332,258,231,1736,3871
2022-11-26 11:00:00,2022-11-26 12:00:00,842,266,199,219,1526,3859
2022-11-26 12:00:00,2022-11-26 13:00:00,891,110,172,269,1442,3820
2022-11-26 13:00:00,2022-11-26 14:00:00,1000,15,175,315,1505,3926
2022-11-26 14:00:00,2022-11-26 15:00:00,1085,1,192,350,1628,4139
2022-11-26 15:00:00,2022-11-26 16:00:00,1094,0,307,433,1834,4270
2022-11-26 16:00:00,2022-11-26 17:00:00,1088,0,357,461,1906,4136
2022-11-26 17:00:00,2022-11-26 18:00:00,1100,0,342,517,1959,3921
2022-11-26 18:00:00,2022-11-26 19:00:00,1080,0,406,577,2063,3739
2022-11-26 19:00:00,2022-11-26 20:00:00,988,0,554,634,2176,3569
2022-11-26 20:00:00,2022-11-26 21:00:00,841,0,731,716,2288,3423
2022-11-26 21:00:00,2022-11-26 22:00:00,771,0,614,844,2229,3293
2022-11-26 22:00:00,2022-11-26 23:00:00,581,0,625,795,2001,3175
2022-11-26 23:00:00,2022-11-27 00:00:00,544,0,676,756,1976,3080
2022-11-27 00:00:00,2022-11-27 01:00:00,463,0,677,860,2000,3051
2022-11-27 01:00:00,2022-11-27 02:00:00,457,0,805,963,2225,3076
2022-11-27 02:00:00,2022-11-27 03:00:00,386,0,903,1116,2405,3045
2022-11-27 03:00:00,2022-11-27 04:00:00,416,0,994,1313,2723,3045
2022-11-27 04:00:00,2022-11-27 05:00:00,482,0,1067,1399,2948,3152
2022-11-27 05:00:00,2022-11-27 06:00:00,520,0,1098,1443,3061,3364
2022-11-27 06:00:00,2022-11-27 07:00:00,526,8,1084,1475,3093,3600
2022-11-27 07:00:00,2022-11-27 08:00:00,511,60,1115,1526,3212,3791
2022-11-27 08:00:00,2022-11-27 09:00:00,606,120,1165,1642,3533,3900
2022-11-27 09:00:00,2022-11-27 10:00:00,695,158,1167,1664,3684,3934
2022-11-27 10:00:00,2022-11-27 11:00:00,735,175,1136,1610,3656,3929
2022-11-27 11:00:00,2022-11-27 12:00:00,757,117,1135,1486,3495,3930
2022-11-27 12:00:00,2022-11-27 13:00:00,767,54,1223,1306,3350,3921
2022-11-27 13:00:00,2022-11-27 14:00:00,667,10,1341,1301,3319,3997
2022-11-27 14:00:00,2022-11-27 15:00:00,689,1,1508,1390,3588,4206
2022-11-27 15:00:00,2022-11-27 16:00:00,736,0,1645,1432,3813,4493
2022-11-27 16:00:00,2022-11-27 17:00:00,719,0,1792,1353,3864,4377
2022-11-27 17:00:00,2022-11-27 18:00:00,660,0,1756,1296,3712,4119
2022-11-27 18:00:00,2022-11-27 19:00:00,625,0,1771,1307,3703,3926
2022-11-27 19:00:00,2022-11-27 20:00:00,546,0,1803,1257,3606,3794
2022-11-27 20:00:00,2022-11-27 21:00:00,569,0,1849,1282,3700,3625
2022-11-27 21:00:00,2022-11-27 22:00:00,555,0,1948,1389,3892,3522
2022-11-27 22:00:00,2022-11-27 23:00:00,447,0,1961,1599,4007,3537
2022-11-27 23:00:00,2022-11-28 00:00:00,294,0,1943,1510,3747,3454
2022-11-28 00:00:00,2022-11-28 01:00:00,299,0,1989,1517,3805,3385
2022-11-28 01:00:00,2022-11-28 02:00:00,286,0,2038,2000,4324,3359
2022-11-28 02:00:00,2022-11-28 03:00:00,284,0,2041,2211,4536,3405
2022-11-28 03:00:00,2022-11-28 04:00:00,317,0,2024,2523,4864,3632
2022-11-28 04:00:00,2022-11-28 05:00:00,323,0,2005,2447,4775,4202
2022-11-28 05:00:00,2022-11-28 06:00:00,364,0,2028,2723,5115,4797
2022-11-28 06:00:00,2022-11-28 07:00:00,411,6,2073,2509,4999,5071
2022-11-28 07:00:00,2022-11-28 08:00:00,443,39,2077,2686,5245,5112
2022-11-28 08:00:00,2022-11-28 09:00:00,527,75,2087,2978,5667,5109
2022-11-28 09:00:00,2022-11-28 10:00:00,453,96,2081,2958,5588,5094
2022-11-28 10:00:00,2022-11-28 11:00:00,418,106,2048,2723,5295,5055
2022-11-28 11:00:00,2022-11-28 12:00:00,530,90,2053,2671,5344,4994
2022-11-28 12:00:00,2022-11-28 13:00:00,543,43,2051,2554,5191,4909
2022-11-28 13:00:00,2022-11-28 14:00:00,665,6,2043,2566,5280,4800
2022-11-28 14:00:00,2022-11-28 15:00:00,532,1,2027,2482,5042,4963
2022-11-28 15:00:00,2022-11-28 16:00:00,625,0,2075,2487,5187,5223
2022-11-28 16:00:00,2022-11-28 17:00:00,536,0,1983,2399,4918,4957
2022-11-28 17:00:00,2022-11-28 18:00:00,549,0,1992,2345,4886,4651
2022-11-28 18:00:00,2022-11-28 19:00:00,692,0,1980,2239,4911,4397
2022-11-28 19:00:00,2022-11-28 20:00:00,657,0,1895,2017,4569,4175
2022-11-28 20:00:00,2022-11-28 21:00:00,679,0,1845,1885,4409,3960
2022-11-28 21:00:00,2022-11-28 22:00:00,657,0,1844,1788,4289,3747
2022-11-28 22:00:00,2022-11-28 23:00:00,576,0,1789,1755,4120,3562
2022-11-28 23:00:00,2022-11-29 00:00:00,650,0,1788,1644,4082,3431
2022-11-29 00:00:00,2022-11-29 01:00:00,645,0,1730,1513,3888,3322
2022-11-29 01:00:00,2022-11-29 02:00:00,677,0,1602,1410,3689,3280
2022-11-29 02:00:00,2022-11-29 03:00:00,620,0,1504,1330,3454,3307
2022-11-29 03:00:00,2022-11-29 04:00:00,666,0,1502,1197,3365,3541
2022-11-29 04:00:00,2022-11-29 05:00:00,672,0,1399,1140,3211,4134
2022-11-29 05:00:00,2022-11-29 06:00:00,706,0,1292,1083,3081,4600
2022-11-29 06:00:00,2022-11-29 07:00:00,712,3,1210,978,2903,4785
2022-11-29 07:00:00,2022-11-29 08:00:00,699,31,1039,826,2595,4810
2022-11-29 08:00:00,2022-11-29 09:00:00,750,70,1043,819,2682,4864
2022-11-29 09:00:00,2022-11-29 10:00:00,663,99,1085,723,2570,4833
2022-11-29 10:00:00,2022-11-29 11:00:00,675,105,926,694,2400,4779
2022-11-29 11:00:00,2022-11-29 12:00:00,713,83,906,664,2366,4792
2022-11-29 12:00:00,2022-11-29 13:00:00,718,46,839,642,2245,4740
2022-11-29 13:00:00,2022-11-29 14:00:00,765,16,838,660,2279,4659
2022-11-29 14:00:00,2022-11-29 15:00:00,754,1,823,676,2254,4791
2022-11-29 15:00:00,2022-11-29 16:00:00,730,0,942,573,2245,4953
2022-11-29 16:00:00,2022-11-29 17:00:00,730,0,1082,543,2355,4747
2022-11-29 17:00:00,2022-11-29 18:00:00,705,0,1089,564,2358,4470
2022-11-29 18:00:00,2022-11-29 19:00:00,699,0,1013,547,2259,4276
2022-11-29 19:00:00,2022-11-29 20:00:00,664,0,753,512,1929,4090
2022-11-29 20:00:00,2022-11-29 21:00:00,745,0,699,446,1890,3773
2022-11-29 21:00:00,2022-11-29 22:00:00,706,0,661,472,1839,3638
2022-11-29 22:00:00,2022-11-29 23:00:00,768,0,606,478,1852,3499
2022-11-29 23:00:00,2022-11-30 00:00:00,770,0,624,462,1856,3416
2022-11-30 00:00:00,2022-11-30 01:00:00,814,0,546,463,1823,3379
2022-11-30 01:00:00,2022-11-30 02:00:00,718,0,539,447,1704,3355
2022-11-30 02:00:00,2022-11-30 03:00:00,623,0,507,462,1592,3353
2022-11-30 03:00:00,2022-11-30 04:00:00,666,0,525,494,1685,3548
2022-11-30 04:00:00,2022-11-30 05:00:00,678,0,569,523,1770,4074
2022-11-30 05:00:00,2022-11-30 06:00:00,688,0,629,513,1830,4602
2022-11-30 06:00:00,2022-11-30 07:00:00,747,3,645,532,1927,4786
2022-11-30 07:00:00,2022-11-30 08:00:00,853,35,631,488,2007,4770
2022-11-30 08:00:00,2022-11-30 09:00:00,918,80,519,436,1953,4859
2022-11-30 09:00:00,2022-11-30 10:00:00,911,129,408,377,1825,4812
2022-11-30 10:00:00,2022-11-30 11:00:00,911,138,332,366,1747,4763
2022-11-30 11:00:00,2022-11-30 12:00:00,967,89,306,374,1736,4738
2022-11-30 12:00:00,2022-11-30 13:00:00,1018,52,375,367,1812,4623
2022-11-30 13:00:00,2022-11-30 14:00:00,1034,14,406,397,1851,4565
2022-11-30 14:00:00,2022-11-30 15:00:00,1005,1,438,479,1923,4742
2022-11-30 15:00:00,2022-11-30 16:00:00,991,0,441,546,1978,4866
2022-11-30 16:00:00,2022-11-30 17:00:00,991,0,461,560,2012,4748
2022-11-30 17:00:00,2022-11-30 18:00:00,980,0,455,572,2007,4475
2022-11-30 18:00:00,2022-11-30 19:00:00,1014,0,470,599,2083,4184
2022-11-30 19:00:00,2022-11-30 20:00:00,942,0,459,618,2019,4063
2022-11-30 20:00:00,2022-11-30 21:00:00,943,0,430,581,1954,3865
2022-11-30 21:00:00,2022-11-30 22:00:00,897,0,417,545,1859,3750
2022-11-30 22:00:00,2022-11-30 23:00:00,904,0,350,505,1759,3586
2022-11-30 23:00:00,2022-12-01 00:00:00,906,0,324,503,1733,3482
2022-12-01 00:00:00,2022-12-01 01:00:00,888,0,312,504,1704,3408
2022-12-01 01:00:00,2022-12-01 02:00:00,875,0,371,545,1791,3428
2022-12-01 02:00:00,2022-12-01 03:00:00,905,0,413,583,1901,3434
2022-12-01 03:00:00,2022-12-01 04:00:00,926,0,414,571,1911,3631
2022-12-01 04:00:00,2022-12-01 05:00:00,971,0,440,585,1996,4146
2022-12-01 05:00:00,2022-12-01 06:00:00,1041,0,494,627,2162,4626
2022-12-01 06:00:00,2022-12-01 07:00:00,1127,4,481,614,2226,4753
2022-12-01 07:00:00,2022-12-01 08:00:00,1145,48,393,530,2116,4770
2022-12-01 08:00:00,2022-12-01 09:00:00,1151,129,343,440,2063,4831
2022-12-01 09:00:00,2022-12-01 10:00:00,1134,175,338,376,2023,4786
2022-12-01 10:00:00,2022-12-01 11:00:00,1065,192,328,392,1977,4678
2022-12-01 11:00:00,2022-12-01 12:00:00,1083,161,311,371,1926,4704
2022-12-01 12:00:00,2022-12-01 13:00:00,1024,85,243,344,1696,4667
2022-12-01 13:00:00,2022-12-01 14:00:00,1048,16,310,377,1751,4615
2022-12-01 14:00:00,2022-12-01 15:00:00,1078,1,355,441,1875,4728
2022-12-01 15:00:00,2022-12-01 16:00:00,1056,0,416,514,1986,4916
2022-12-01 16:00:00,2022-12-01 17:00:00,1026,0,417,553,1996,4752
2022-12-01 17:00:00,2022-12-01 18:00:00,1021,0,432,577,2030,4466
2022-12-01 18:00:00,2022-12-01 19:00:00,1003,0,462,588,2053,4249
2022-12-01 19:00:00,2022-12-01 20:00:00,997,0,495,579,2071,4070
2022-12-01 20:00:00,2022-12-01 21:00:00,986,0,529,559,2074,3883
2022-12-01 21:00:00,2022-12-01 22:00:00,982,0,600,574,2156,3717
2022-12-01 22:00:00,2022-12-01 23:00:00,978,0,657,610,2245,3563
2022-12-01 23:00:00,2022-12-02 00:00:00,959,0,515,622,2096,3507
2022-12-02 00:00:00,2022-12-02 01:00:00,955,0,459,688,2102,3457
2022-12-02 01:00:00,2022-12-02 02:00:00,932,0,495,758,2185,3389
2022-12-02 02:00:00,2022-12-02 03:00:00,936,0,623,757,2316,3387
2022-12-02 03:00:00,2022-12-02 04:00:00,961,0,593,759,2313,3552
2022-12-02 04:00:00,2022-12-02 05:00:00,987,0,691,775,2453,4078
2022-12-02 05:00:00,2022-12-02 06:00:00,1013,0,784,775,2572,4567
2022-12-02 06:00:00,2022-12-02 07:00:00,1027,3,775,786,2591,4769
2022-12-02 07:00:00,2022-12-02 08:00:00,1077,44,765,830,2716,4765
2022-12-02 08:00:00,2022-12-02 09:00:00,1134,105,807,868,2914,4806
2022-12-02 09:00:00,2022-12-02 10:00:00,1099,158,938,853,3048,4763
2022-12-02 10:00:00,2022-12-02 11:00:00,1010,158,887,905,2960,4667
2022-12-02 11:00:00,2022-12-02 12:00:00,958,128,941,907,2934,4593
2022-12-02 12:00:00,2022-12-02 13:00:00,973,68,1110,943,3094,4528
2022-12-02 13:00:00,2022-12-02 14:00:00,986,15,1267,1079,3347,4475
2022-12-02 14:00:00,2022-12-02 15:00:00,835,1,1331,1208,3375,4706
2022-12-02 15:00:00,2022-12-02 16:00:00,774,0,1609,1187,3570,4942
2022-12-02 16:00:00,2022-12-02 17:00:00,585,0,1527,1141,3253,4761
2022-12-02 17:00:00,2022-12-02 18:00:00,568,0,1520,1134,3222,4421
2022-12-02 18:00:00,2022-12-02 19:00:00,589,0,1596,1334,3519,4270
2022-12-02 19:00:00,2022-12-02 20:00:00,621,0,1343,1089,3053,4059
2022-12-02 20:00:00,2022-12-02 21:00:00,547,0,1250,1264,3061,3917
2022-12-02 21:00:00,2022-12-02 22:00:00,588,0,1581,1204,3373,3738
2022-12-02 22:00:00,2022-12-02 23:00:00,595,0,1498,1279,3372,3527
2022-12-02 23:00:00,2022-12-03 00:00:00,679,0,1528,1261,3468,3481
2022-12-03 00:00:00,2022-12-03 01:00:00,811,0,1406,1308,3525,3369
2022-12-03 01:00:00,2022-12-03 02:00:00,872,0,1537,1384,3793,3360
2022-12-03 02:00:00,2022-12-03 03:00:00,614,0,1658,1287,3559,3395
2022-12-03 03:00:00,2022-12-03 04:00:00,670,0,1678,1230,3578,3415
2022-12-03 04:00:00,2022-12-03 05:00:00,668,0,1575,1353,3596,3458
2022-12-03 05:00:00,2022-12-03 06:00:00,897,0,1564,1359,3820,3729
2022-12-03 06:00:00,2022-12-03 07:00:00,784,1,1568,1333,3686,3974
2022-12-03 07:00:00,2022-12-03 08:00:00,837,16,1630,1301,3784,4122
2022-12-03 08:00:00,2022-12-03 09:00:00,1032,47,1599,1391,4069,4199
2022-12-03 09:00:00,2022-12-03 10:00:00,1051,81,1665,1419,4216,4248
2022-12-03 10:00:00,2022-12-03 11:00:00,1027,89,1618,1397,4131,4165
2022-12-03 11:00:00,2022-12-03 12:00:00,1000,71,1371,1404,3846,4112
2022-12-03 12:00:00,2022-12-03 13:00:00,1011,37,1303,1343,3694,4101
2022-12-03 13:00:00,2022-12-03 14:00:00,1010,6,1555,1343,3914,4115
2022-12-03 14:00:00,2022-12-03 15:00:00,1032,1,1684,1357,4074,4289
2022-12-03 15:00:00,2022-12-03 16:00:00,1045,0,1537,1467,4049,4500
2022-12-03 16:00:00,2022-12-03 17:00:00,1040,0,1440,1566,4046,4357
2022-12-03 17:00:00,2022-12-03 18:00:00,1017,0,1622,1616,4255,4100
2022-12-03 18:00:00,2022-12-03 19:00:00,1002,0,1702,1633,4337,3927
2022-12-03 19:00:00,2022-12-03 20:00:00,700,0,1618,1567,3885,3934
2022-12-03 20:00:00,2022-12-03 21:00:00,647,0,1572,1675,3894,3732
2022-12-03 21:00:00,2022-12-03 22:00:00,781,0,1514,1755,4050,3573
2022-12-03 22:00:00,2022-12-03 23:00:00,904,0,1406,1722,4032,3502
2022-12-03 23:00:00,2022-12-04 00:00:00,882,0,1397,1684,3963,3371
2022-12-04 00:00:00,2022-12-04 01:00:00,922,0,1433,1771,4126,3291
2022-12-04 01:00:00,2022-12-04 02:00:00,904,0,1417,1790,4111,3321
2022-12-04 02:00:00,2022-12-04 03:00:00,888,0,1415,1719,4022,3283
2022-12-04 03:00:00,2022-12-04 04:00:00,898,0,1367,1650,3915,3289
2022-12-04 04:00:00,2022-12-04 05:00:00,889,0,1361,1640,3890,3382
2022-12-04 05:00:00,2022-12-04 06:00:00,874,0,1366,1657,3897,3578
2022-12-04 06:00:00,2022-12-04 07:00:00,785,1,1410,1639,3835,3892
2022-12-04 07:00:00,2022-12-04 08:00:00,885,19,1441,1579,3924,4046
2022-12-04 08:00:00,2022-12-04 09:00:00,954,49,1496,1564,4063,4123
2022-12-04 09:00:00,2022-12-04 10:00:00,939,63,1486,1574,4062,4195
2022-12-04 10:00:00,2022-12-04 11:00:00,965,65,1562,1619,4211,4165
2022-12-04 11:00:00,2022-12-04 12:00:00,941,53,1572,1628,4194,4168
2022-12-04 12:00:00,2022-12-04 13:00:00,852,33,1632,1720,4237,4173
2022-12-04 13:00:00,2022-12-04 14:00:00,835,6,1847,1826,4514,4214
2022-12-04 14:00:00,2022-12-04 15:00:00,692,1,1934,1864,4491,4501
2022-12-04 15:00:00,2022-12-04 16:00:00,610,0,1963,1772,4345,4746
2022-12-04 16:00:00,2022-12-04 17:00:00,713,0,1999,1710,4422,4572
2022-12-04 17:00:00,2022-12-04 18:00:00,582,0,1939,1730,4251,4279
2022-12-04 18:00:00,2022-12-04 19:00:00,635,0,1910,1736,4281,4062
2022-12-04 19:00:00,2022-12-04 20:00:00,678,0,1986,1715,4379,3837
2022-12-04 20:00:00,2022-12-04 21:00:00,810,0,1939,1707,4456,3640
2022-12-04 21:00:00,2022-12-04 22:00:00,849,0,1981,1817,4647,3579
2022-12-04 22:00:00,2022-12-04 23:00:00,742,0,1986,1871,4599,3554
2022-12-04 23:00:00,2022-12-05 00:00:00,741,0,2008,1865,4614,3504
2022-12-05 00:00:00,2022-12-05 01:00:00,772,0,1949,1881,4602,3422
2022-12-05 01:00:00,2022-12-05 02:00:00,763,0,1916,1865,4544,3370
2022-12-05 02:00:00,2022-12-05 03:00:00,810,0,1899,1814,4523,3458
2022-12-05 03:00:00,2022-12-05 04:00:00,692,0,1705,1492,3889,3728
2022-12-05 04:00:00,2022-12-05 05:00:00,705,0,1565,1424,3694,4265
2022-12-05 05:00:00,2022-12-05 06:00:00,788,0,1730,1546,4064,4839
2022-12-05 06:00:00,2022-12-05 07:00:00,693,0,1677,1305,3675,5096
2022-12-05 07:00:00,2022-12-05 08:00:00,712,10,1586,1423,3731,5094
2022-12-05 08:00:00,2022-12-05 09:00:00,835,32,1561,1328,3756,5122
2022-12-05 09:00:00,2022-12-05 10:00:00,911,61,1441,1288,3701,5046
2022-12-05 10:00:00,2022-12-05 11:00:00,936,73,1315,1214,3538,4918
2022-12-05 11:00:00,2022-12-05 12:00:00,926,56,1274,1149,3405,4939
2022-12-05 12:00:00,2022-12-05 13:00:00,937,28,1161,1106,3232,4874
2022-12-05 13:00:00,2022-12-05 14:00:00,960,6,1146,1048,3160,4810
2022-12-05 14:00:00,2022-12-05 15:00:00,984,1,1057,955,2997,4918
2022-12-05 15:00:00,2022-12-05 16:00:00,994,0,922,811,2727,5096
2022-12-05 16:00:00,2022-12-05 17:00:00,947,0,697,694,2338,4857
2022-12-05 17:00:00,2022-12-05 18:00:00,945,0,487,604,2036,4542
2022-12-05 18:00:00,2022-12-05 19:00:00,983,0,427,517,1927,4243
2022-12-05 19:00:00,2022-12-05 20:00:00,1015,0,278,452,1745,3982
2022-12-05 20:00:00,2022-12-05 21:00:00,1037,0,226,403,1666,3783
2022-12-05 21:00:00,2022-12-05 22:00:00,1010,0,363,375,1748,3639
2022-12-05 22:00:00,2022-12-05 23:00:00,1012,0,501,336,1849,3420
2022-12-05 23:00:00,2022-12-06 00:00:00,1000,0,393,318,1711,3450
2022-12-06 00:00:00,2022-12-06 01:00:00,994,0,297,276,1567,3386
2022-12-06 01:00:00,2022-12-06 02:00:00,1011,0,277,246,1534,3305
2022-12-06 02:00:00,2022-12-06 03:00:00,1026,0,259,241,1526,3323
2022-12-06 03:00:00,2022-12-06 04:00:00,982,0,276,255,1513,3526
2022-12-06 04:00:00,2022-12-06 05:00:00,1019,0,315,240,1574,4050
2022-12-06 05:00:00,2022-12-06 06:00:00,1021,0,246,215,1482,4632
2022-12-06 06:00:00,2022-12-06 07:00:00,1062,5,264,214,1545,4832
2022-12-06 07:00:00,2022-12-06 08:00:00,1010,62,256,208,1536,4856
2022-12-06 08:00:00,2022-12-06 09:00:00,998,182,184,179,1543,4872
2022-12-06 09:00:00,2022-12-06 10:00:00,1002,236,180,132,1550,4767
2022-12-06 10:00:00,2022-12-06 11:00:00,1016,241,161,117,1535,4665
2022-12-06 11:00:00,2022-12-06 12:00:00,949,199,132,135,1415,4690
2022-12-06 12:00:00,2022-12-06 13:00:00,975,98,179,135,1387,4637
2022-12-06 13:00:00,2022-12-06 14:00:00,961,20,340,127,1448,4609
2022-12-06 14:00:00,2022-12-06 15:00:00,875,1,335,147,1358,4799
2022-12-06 15:00:00,2022-12-06 16:00:00,967,0,513,156,1636,4990
2022-12-06 16:00:00,2022-12-06 17:00:00,1005,0,477,117,1599,4767
2022-12-06 17:00:00,2022-12-06 18:00:00,1009,0,507,103,1619,4500
2022-12-06 18:00:00,2022-12-06 19:00:00,944,0,529,89,1562,4309
2022-12-06 19:00:00,2022-12-06 20:00:00,917,0,458,69,1444,4126
2022-12-06 20:00:00,2022-12-06 21:00:00,912,0,311,86,1309,3908
2022-12-06 21:00:00,2022-12-06 22:00:00,907,0,323,114,1344,3722
2022-12-06 22:00:00,2022-12-06 23:00:00,885,0,561,115,1561,3585
2022-12-06 23:00:00,2022-12-07 00:00:00,830,0,781,192,1803,3536
2022-12-07 00:00:00,2022-12-07 01:00:00,839,0,778,390,2007,3566
2022-12-07 01:00:00,2022-12-07 02:00:00,847,0,730,672,2249,3559
2022-12-07 02:00:00,2022-12-07 03:00:00,818,0,723,913,2454,3544
2022-12-07 03:00:00,2022-12-07 04:00:00,769,0,683,1156,2608,3746
2022-12-07 04:00:00,2022-12-07 05:00:00,786,0,754,1348,2888,4323
2022-12-07 05:00:00,2022-12-07 06:00:00,779,0,825,1404,3008,4848
2022-12-07 06:00:00,2022-12-07 07:00:00,975,4,876,1153,3008,4697
2022-12-07 07:00:00,2022-12-07 08:00:00,998,48,1121,933,3100,4597
2022-12-07 08:00:00,2022-12-07 09:00:00,895,117,1139,798,2949,4723
2022-12-07 09:00:00,2022-12-07 10:00:00,892,152,1003,706,2753,4735
2022-12-07 10:00:00,2022-12-07 11:00:00,923,175,833,577,2508,4628
2022-12-07 11:00:00,2022-12-07 12:00:00,883,181,865,519,2448,4647
2022-12-07 12:00:00,2022-12-07 13:00:00,853,82,929,492,2356,4668
2022-12-07 13:00:00,2022-12-07 14:00:00,892,15,831,433,2171,4698
2022-12-07 14:00:00,2022-12-07 15:00:00,894,0,812,333,2039,4944
2022-12-07 15:00:00,2022-12-07 16:00:00,943,0,724,231,1898,5154
2022-12-07 16:00:00,2022-12-07 17:00:00,775,0,619,176,1570,4969
2022-12-07 17:00:00,2022-12-07 18:00:00,770,0,521,151,1442,4671
2022-12-07 18:00:00,2022-12-07 19:00:00,754,0,356,169,1279,4411
2022-12-07 19:00:00,2022-12-07 20:00:00,688,0,318,185,1191,4254
2022-12-07 20:00:00,2022-12-07 21:00:00,741,0,255,198,1194,4047
2022-12-07 21:00:00,2022-12-07 22:00:00,767,0,214,180,1161,3906
2022-12-07 22:00:00,2022-12-07 23:00:00,767,0,242,177,1186,3777
2022-12-07 23:00:00,2022-12-08 00:00:00,813,0,198,170,1181,3721
2022-12-08 00:00:00,2022-12-08 01:00:00,879,0,129,203,1211,3712
2022-12-08 01:00:00,2022-12-08 02:00:00,899,0,57,257,1213,3668
2022-12-08 02:00:00,2022-12-08 03:00:00,903,0,27,286,1216,3630
2022-12-08 03:00:00,2022-12-08 04:00:00,903,0,34,325,1262,3832
2022-12-08 04:00:00,2022-12-08 05:00:00,904,0,63,385,1352,4397
2022-12-08 05:00:00,2022-12-08 06:00:00,907,0,98,456,1461,4943
2022-12-08 06:00:00,2022-12-08 07:00:00,878,2,99,471,1450,5147
2022-12-08 07:00:00,2022-12-08 08:00:00,846,39,130,479,1494,5067
2022-12-08 08:00:00,2022-12-08 09:00:00,857,136,144,492,1629,5004
2022-12-08 09:00:00,2022-12-08 10:00:00,931,227,181,487,1826,4782
2022-12-08 10:00:00,2022-12-08 11:00:00,920,248,217,532,1917,4654
2022-12-08 11:00:00,2022-12-08 12:00:00,870,223,322,652,2067,4641
2022-12-08 12:00:00,2022-12-08 13:00:00,872,100,450,858,2280,4629
2022-12-08 13:00:00,2022-12-08 14:00:00,873,18,498,1138,2527,4636
2022-12-08 14:00:00,2022-12-08 15:00:00,904,0,594,1397,2895,4797
2022-12-08 15:00:00,2022-12-08 16:00:00,970,0,704,1567,3241,5009
2022-12-08 16:00:00,2022-12-08 17:00:00,966,0,758,1379,3103,4772
2022-12-08 17:00:00,2022-12-08 18:00:00,975,0,814,1094,2883,4538
2022-12-08 18:00:00,2022-12-08 19:00:00,967,0,790,912,2669,4268
2022-12-08 19:00:00,2022-12-08 20:00:00,907,0,826,836,2569,4103
2022-12-08 20:00:00,2022-12-08 21:00:00,905,0,903,763,2571,3950
2022-12-08 21:00:00,2022-12-08 22:00:00,876,0,892,647,2415,3844
2022-12-08 22:00:00,2022-12-08 23:00:00,866,0,796,597,2259,3645
2022-12-08 23:00:00,2022-12-09 00:00:00,867,0,646,497,2010,3617
2022-12-09 00:00:00,2022-12-09 01:00:00,867,0,471,400,1738,3601
2022-12-09 01:00:00,2022-12-09 02:00:00,870,0,353,373,1596,3543
2022-12-09 02:00:00,2022-12-09 03:00:00,861,0,250,374,1485,3544
2022-12-09 03:00:00,2022-12-09 04:00:00,856,0,244,369,1469,3728
2022-12-09 04:00:00,2022-12-09 05:00:00,902,0,253,358,1513,4224
2022-12-09 05:00:00,2022-12-09 06:00:00,976,0,330,397,1703,4730
2022-12-09 06:00:00,2022-12-09 07:00:00,986,1,273,460,1720,4920
2022-12-09 07:00:00,2022-12-09 08:00:00,935,9,391,528,1863,4959
2022-12-09 08:00:00,2022-12-09 09:00:00,922,25,372,455,1774,4998
2022-12-09 09:00:00,2022-12-09 10:00:00,917,47,334,421,1719,4890
2022-12-09 10:00:00,2022-12-09 11:00:00,954,51,263,388,1656,4741
2022-12-09 11:00:00,2022-12-09 12:00:00,983,39,244,323,1589,4643
2022-12-09 12:00:00,2022-12-09 13:00:00,965,29,374,315,1683,4532
2022-12-09 13:00:00,2022-12-09 14:00:00,960,9,229,352,1550,4531
2022-12-09 14:00:00,2022-12-09 15:00:00,965,0,246,361,1572,4693
2022-12-09 15:00:00,2022-12-09 16:00:00,999,0,292,411,1702,4807
2022-12-09 16:00:00,2022-12-09 17:00:00,922,0,314,465,1701,4621
2022-12-09 17:00:00,2022-12-09 18:00:00,928,0,446,534,1908,4320
2022-12-09 18:00:00,2022-12-09 19:00:00,962,0,451,588,2001,4020
2022-12-09 19:00:00,2022-12-09 20:00:00,928,0,463,642,2033,3855
2022-12-09 20:00:00,2022-12-09 21:00:00,906,0,413,658,1977,3728
2022-12-09 21:00:00,2022-12-09 22:00:00,871,0,346,620,1837,3599
2022-12-09 22:00:00,2022-12-09 23:00:00,876,0,505,623,2004,3511
2022-12-09 23:00:00,2022-12-10 00:00:00,874,0,306,646,1826,3415
2022-12-10 00:00:00,2022-12-10 01:00:00,874,0,396,631,1901,3373
2022-12-10 01:00:00,2022-12-10 02:00:00,875,0,551,633,2059,3304
2022-12-10 02:00:00,2022-12-10 03:00:00,876,0,671,585,2132,3296
2022-12-10 03:00:00,2022-12-10 04:00:00,877,0,685,594,2156,3313
2022-12-10 04:00:00,2022-12-10 05:00:00,883,0,751,563,2197,3420
2022-12-10 05:00:00,2022-12-10 06:00:00,908,0,781,540,2229,3644
2022-12-10 06:00:00,2022-12-10 07:00:00,919,1,749,531,2200,3879
2022-12-10 07:00:00,2022-12-10 08:00:00,953,16,697,473,2139,4036
2022-12-10 08:00:00,2022-12-10 09:00:00,963,48,694,423,2128,4106
2022-12-10 09:00:00,2022-12-10 10:00:00,958,77,715,356,2106,4105
2022-12-10 10:00:00,2022-12-10 11:00:00,941,77,714,310,2042,4080
2022-12-10 11:00:00,2022-12-10 12:00:00,945,59,688,271,1963,4087
2022-12-10 12:00:00,2022-12-10 13:00:00,916,36,611,243,1806,4087
2022-12-10 13:00:00,2022-12-10 14:00:00,947,6,563,249,1765,4161
2022-12-10 14:00:00,2022-12-10 15:00:00,936,0,578,276,1790,4378
2022-12-10 15:00:00,2022-12-10 16:00:00,929,0,616,278,1823,4560
2022-12-10 16:00:00,2022-12-10 17:00:00,942,0,533,243,1718,4437
2022-12-10 17:00:00,2022-12-10 18:00:00,957,0,574,219,1750,4161
2022-12-10 18:00:00,2022-12-10 19:00:00,931,0,569,210,1710,3961
2022-12-10 19:00:00,2022-12-10 20:00:00,919,0,627,224,1770,3808
2022-12-10 20:00:00,2022-12-10 21:00:00,920,0,609,230,1759,3691
2022-12-10 21:00:00,2022-12-10 22:00:00,920,0,605,215,1740,3573
2022-12-10 22:00:00,2022-12-10 23:00:00,925,0,638,208,1771,3436
2022-12-10 23:00:00,2022-12-11 00:00:00,926,0,607,193,1726,3359
2022-12-11 00:00:00,2022-12-11 01:00:00,929,0,609,190,1728,3312
2022-12-11 01:00:00,2022-12-11 02:00:00,920,0,532,236,1688,3332
2022-12-11 02:00:00,2022-12-11 03:00:00,923,0,602,264,1789,3315
2022-12-11 03:00:00,2022-12-11 04:00:00,921,0,717,276,1914,3326
2022-12-11 04:00:00,2022-12-11 05:00:00,912,0,703,274,1889,3424
2022-12-11 05:00:00,2022-12-11 06:00:00,887,0,715,322,1924,3634
2022-12-11 06:00:00,2022-12-11 07:00:00,809,1,747,405,1962,3903
2022-12-11 07:00:00,2022-12-11 08:00:00,743,28,754,378,1903,4049
2022-12-11 08:00:00,2022-12-11 09:00:00,721,88,700,397,1906,4101
2022-12-11 09:00:00,2022-12-11 10:00:00,777,135,710,356,1978,4063
2022-12-11 10:00:00,2022-12-11 11:00:00,789,85,599,302,1775,3976
2022-12-11 11:00:00,2022-12-11 12:00:00,773,72,562,267,1674,4019
2022-12-11 12:00:00,2022-12-11 13:00:00,752,58,567,307,1684,4127
2022-12-11 13:00:00,2022-12-11 14:00:00,751,12,505,393,1661,4190
2022-12-11 14:00:00,2022-12-11 15:00:00,740,0,575,456,1771,4370
2022-12-11 15:00:00,2022-12-11 16:00:00,726,0,677,584,1987,4625
2022-12-11 16:00:00,2022-12-11 17:00:00,650,0,782,650,2082,4557
2022-12-11 17:00:00,2022-12-11 18:00:00,688,0,908,681,2277,4273
2022-12-11 18:00:00,2022-12-11 19:00:00,678,0,818,635,2131,4077
2022-12-11 19:00:00,2022-12-11 20:00:00,745,0,783,627,2155,3908
2022-12-11 20:00:00,2022-12-11 21:00:00,775,0,767,569,2111,3779
2022-12-11 21:00:00,2022-12-11 22:00:00,822,0,719,534,2075,3666
2022-12-11 22:00:00,2022-12-11 23:00:00,807,0,658,493,1958,3616
2022-12-11 23:00:00,2022-12-12 00:00:00,803,0,648,534,1985,3549
2022-12-12 00:00:00,2022-12-12 01:00:00,798,0,713,562,2073,3533
2022-12-12 01:00:00,2022-12-12 02:00:00,796,0,771,563,2130,3542
2022-12-12 02:00:00,2022-12-12 03:00:00,798,0,775,509,2082,3571
2022-12-12 03:00:00,2022-12-12 04:00:00,813,0,789,514,2116,3736
2022-12-12 04:00:00,2022-12-12 05:00:00,846,0,788,494,2128,4270
2022-12-12 05:00:00,2022-12-12 06:00:00,856,0,855,502,2213,4813
2022-12-12 06:00:00,2022-12-12 07:00:00,926,1,907,518,2352,5031
2022-12-12 07:00:00,2022-12-12 08:00:00,907,19,940,424,2290,5051
2022-12-12 08:00:00,2022-12-12 09:00:00,866,55,913,371,2205,5092
2022-12-12 09:00:00,2022-12-12 10:00:00,873,97,790,315,2075,5040
2022-12-12 10:00:00,2022-12-12 11:00:00,895,90,840,311,2136,4952
2022-12-12 11:00:00,2022-12-12 12:00:00,901,75,857,298,2131,4961
2022-12-12 12:00:00,2022-12-12 13:00:00,924,48,942,349,2263,4959
2022-12-12 13:00:00,2022-12-12 14:00:00,872,10,1021,438,2341,4922
2022-12-12 14:00:00,2022-12-12 15:00:00,880,0,1110,496,2486,5078
2022-12-12 15:00:00,2022-12-12 16:00:00,859,0,1099,517,2475,5300
2022-12-12 16:00:00,2022-12-12 17:00:00,879,0,1039,503,2421,5037
2022-12-12 17:00:00,2022-12-12 18:00:00,920,0,914,430,2264,4686
2022-12-12 18:00:00,2022-12-12 19:00:00,895,0,897,355,2147,4460
2022-12-12 19:00:00,2022-12-12 20:00:00,890,0,958,318,2166,4246
2022-12-12 20:00:00,2022-12-12 21:00:00,877,0,1028,283,2188,4111
2022-12-12 21:00:00,2022-12-12 22:00:00,878,0,1089,281,2248,3956
2022-12-12 22:00:00,2022-12-12 23:00:00,851,0,1123,285,2259,3897
2022-12-12 23:00:00,2022-12-13 00:00:00,821,0,1081,288,2190,3840
2022-12-13 00:00:00,2022-12-13 01:00:00,821,0,1018,285,2124,3834
2022-12-13 01:00:00,2022-12-13 02:00:00,823,0,903,265,1991,3785
2022-12-13 02:00:00,2022-12-13 03:00:00,822,0,808,237,1867,3794
2022-12-13 03:00:00,2022-12-13 04:00:00,827,0,773,201,1801,3985
2022-12-13 04:00:00,2022-12-13 05:00:00,828,0,636,175,1639,4485
2022-12-13 05:00:00,2022-12-13 06:00:00,827,0,510,152,1489,5040
2022-12-13 06:00:00,2022-12-13 07:00:00,836,1,438,141,1416,5163
2022-12-13 07:00:00,2022-12-13 08:00:00,628,41,503,192,1364,5233
2022-12-13 08:00:00,2022-12-13 09:00:00,677,118,566,230,1591,5361
2022-12-13 09:00:00,2022-12-13 10:00:00,638,168,515,277,1598,5313
2022-12-13 10:00:00,2022-12-13 11:00:00,583,174,438,295,1490,5228
2022-12-13 11:00:00,2022-12-13 12:00:00,639,118,369,330,1456,5096
2022-12-13 12:00:00,2022-12-13 13:00:00,582,48,384,469,1483,5087
2022-12-13 13:00:00,2022-12-13 14:00:00,591,7,378,613,1589,5028
2022-12-13 14:00:00,2022-12-13 15:00:00,634,1,444,824,1903,5210
2022-12-13 15:00:00,2022-12-13 16:00:00,650,0,624,1056,2330,5376
2022-12-13 16:00:00,2022-12-13 17:00:00,592,0,837,1204,2633,5243
2022-12-13 17:00:00,2022-12-13 18:00:00,580,0,1482,1331,3393,4938
2022-12-13 18:00:00,2022-12-13 19:00:00,635,0,1598,1432,3665,4682
2022-12-13 19:00:00,2022-12-13 20:00:00,612,0,1591,1461,3664,4441
2022-12-13 20:00:00,2022-12-13 21:00:00,588,0,1842,1582,4012,4214
2022-12-13 21:00:00,2022-12-13 22:00:00,573,0,1860,1712,4145,4027
2022-12-13 22:00:00,2022-12-13 23:00:00,566,0,1861,1617,4044,3914
2022-12-13 23:00:00,2022-12-14 00:00:00,579,0,1894,1550,4023,3788
2022-12-14 00:00:00,2022-12-14 01:00:00,584,0,1792,1483,3859,3717
2022-12-14 01:00:00,2022-12-14 02:00:00,644,0,1661,1403,3708,3630
2022-12-14 02:00:00,2022-12-14 03:00:00,653,0,1480,1463,3596,3630
2022-12-14 03:00:00,2022-12-14 04:00:00,647,0,1552,1329,3528,3806
2022-12-14 04:00:00,2022-12-14 05:00:00,706,0,1495,1260,3461,4345
2022-12-14 05:00:00,2022-12-14 06:00:00,730,0,1343,1071,3144,4877
2022-12-14 06:00:00,2022-12-14 07:00:00,742,2,1330,803,2877,5002
2022-12-14 07:00:00,2022-12-14 08:00:00,783,29,1258,656,2726,4993
2022-12-14 08:00:00,2022-12-14 09:00:00,855,85,1250,524,2714,5045
2022-12-14 09:00:00,2022-12-14 10:00:00,962,125,1145,469,2701,5021
2022-12-14 10:00:00,2022-12-14 11:00:00,975,144,1026,433,2578,4982
2022-12-14 11:00:00,2022-12-14 12:00:00,989,122,777,420,2308,5002
2022-12-14 12:00:00,2022-12-14 13:00:00,1036,60,547,392,2035,4882
2022-12-14 13:00:00,2022-12-14 14:00:00,1094,10,552,385,2041,4794
2022-12-14 14:00:00,2022-12-14 15:00:00,1099,0,490,412,2001,5048
2022-12-14 15:00:00,2022-12-14 16:00:00,1036,0,693,449,2178,5256
2022-12-14 16:00:00,2022-12-14 17:00:00,1028,0,658,474,2160,5052
2022-12-14 17:00:00,2022-12-14 18:00:00,1020,0,639,496,2155,4745
2022-12-14 18:00:00,2022-12-14 19:00:00,1015,0,557,449,2021,4492
2022-12-14 19:00:00,2022-12-14 20:00:00,908,0,454,407,1769,4294
2022-12-14 20:00:00,2022-12-14 21:00:00,747,0,501,423,1671,4119
2022-12-14 21:00:00,2022-12-14 22:00:00,714,0,527,365,1606,3906
2022-12-14 22:00:00,2022-12-14 23:00:00,720,0,557,311,1588,3823
2022-12-14 23:00:00,2022-12-15 00:00:00,718,0,617,222,1557,3765
2022-12-15 00:00:00,2022-12-15 01:00:00,720,0,561,166,1447,3744
2022-12-15 01:00:00,2022-12-15 02:00:00,736,0,473,156,1365,3739
2022-12-15 02:00:00,2022-12-15 03:00:00,790,0,358,113,1261,3684
2022-12-15 03:00:00,2022-12-15 04:00:00,704,0,378,92,1174,3944
2022-12-15 04:00:00,2022-12-15 05:00:00,841,0,334,76,1251,4419
2022-12-15 05:00:00,2022-12-15 06:00:00,1067,0,307,85,1459,4929
2022-12-15 06:00:00,2022-12-15 07:00:00,1096,1,326,91,1514,5136
2022-12-15 07:00:00,2022-12-15 08:00:00,1028,10,301,86,1425,5213
2022-12-15 08:00:00,2022-12-15 09:00:00,1090,39,268,72,1469,5244
2022-12-15 09:00:00,2022-12-15 10:00:00,1100,71,239,78,1488,5156
2022-12-15 10:00:00,2022-12-15 11:00:00,1105,82,210,74,1471,5029
2022-12-15 11:00:00,2022-12-15 12:00:00,1103,74,183,63,1423,5008
2022-12-15 12:00:00,2022-12-15 13:00:00,1100,42,144,64,1350,4992
2022-12-15 13:00:00,2022-12-15 14:00:00,1042,6,142,70,1260,4956
2022-12-15 14:00:00,2022-12-15 15:00:00,1039,0,91,80,1210,5176
2022-12-15 15:00:00,2022-12-15 16:00:00,1005,0,63,98,1166,5435
2022-12-15 16:00:00,2022-12-15 17:00:00,666,0,67,124,857,5240
2022-12-15 17:00:00,2022-12-15 18:00:00,800,0,84,151,1035,4963
2022-12-15 18:00:00,2022-12-15 19:00:00,987,0,69,156,1212,4747
2022-12-15 19:00:00,2022-12-15 20:00:00,909,0,63,152,1124,4572
2022-12-15 20:00:00,2022-12-15 21:00:00,831,0,49,160,1040,4374
2022-12-15 21:00:00,2022-12-15 22:00:00,732,0,59,156,947,4177
2022-12-15 22:00:00,2022-12-15 23:00:00,729,0,113,164,1006,4121
2022-12-15 23:00:00,2022-12-16 00:00:00,739,0,152,186,1077,4087
2022-12-16 00:00:00,2022-12-16 01:00:00,743,0,133,185,1061,4064
2022-12-16 01:00:00,2022-12-16 02:00:00,745,0,114,186,1045,4024
2022-12-16 02:00:00,2022-12-16 03:00:00,744,0,83,226,1053,4021
2022-12-16 03:00:00,2022-12-16 04:00:00,820,0,139,253,1212,4216
2022-12-16 04:00:00,2022-12-16 05:00:00,972,0,181,244,1397,4733
2022-12-16 05:00:00,2022-12-16 06:00:00,1026,0,189,260,1475,5295
2022-12-16 06:00:00,2022-12-16 07:00:00,1077,2,149,298,1526,5428
2022-12-16 07:00:00,2022-12-16 08:00:00,1050,37,110,359,1556,5443
2022-12-16 08:00:00,2022-12-16 09:00:00,1021,111,117,392,1641,5454
2022-12-16 09:00:00,2022-12-16 10:00:00,1020,167,91,396,1674,5371
2022-12-16 10:00:00,2022-12-16 11:00:00,1018,185,68,414,1685,5160
2022-12-16 11:00:00,2022-12-16 12:00:00,935,160,101,446,1642,4961
2022-12-16 12:00:00,2022-12-16 13:00:00,1007,84,99,532,1722,4859
2022-12-16 13:00:00,2022-12-16 14:00:00,1013,12,127,682,1834,4832
2022-12-16 14:00:00,2022-12-16 15:00:00,1083,0,184,877,2144,5061
2022-12-16 15:00:00,2022-12-16 16:00:00,1081,0,291,1070,2442,5311
2022-12-16 16:00:00,2022-12-16 17:00:00,1048,0,356,1124,2528,5192
2022-12-16 17:00:00,2022-12-16 18:00:00,1005,0,408,1235,2648,4918
2022-12-16 18:00:00,2022-12-16 19:00:00,1004,0,481,1364,2849,4726
2022-12-16 19:00:00,2022-12-16 20:00:00,838,0,588,1520,2946,4606
2022-12-16 20:00:00,2022-12-16 21:00:00,762,0,672,1618,3052,4450
2022-12-16 21:00:00,2022-12-16 22:00:00,677,0,703,1576,2956,4293
2022-12-16 22:00:00,2022-12-16 23:00:00,717,0,732,1574,3023,4124
2022-12-16 23:00:00,2022-12-17 00:00:00,740,0,827,1570,3137,4005
2022-12-17 00:00:00,2022-12-17 01:00:00,710,0,855,1551,3116,3958
2022-12-17 01:00:00,2022-12-17 02:00:00,705,0,859,1587,3151,3934
2022-12-17 02:00:00,2022-12-17 03:00:00,701,0,952,1588,3241,3914
2022-12-17 03:00:00,2022-12-17 04:00:00,704,0,1084,1766,3554,3939
2022-12-17 04:00:00,2022-12-17 05:00:00,740,0,1116,1897,3753,4003
2022-12-17 05:00:00,2022-12-17 06:00:00,711,0,1181,2023,3915,4272
2022-12-17 06:00:00,2022-12-17 07:00:00,714,2,1176,2095,3987,4536
2022-12-17 07:00:00,2022-12-17 08:00:00,721,20,1230,2219,4190,4680
2022-12-17 08:00:00,2022-12-17 09:00:00,720,54,1279,2214,4267,4754
2022-12-17 09:00:00,2022-12-17 10:00:00,768,90,1339,2232,4429,4721
2022-12-17 10:00:00,2022-12-17 11:00:00,746,115,1418,2361,4640,4694
2022-12-17 11:00:00,2022-12-17 12:00:00,735,111,1449,2377,4672,4647
2022-12-17 12:00:00,2022-12-17 13:00:00,741,62,1485,2369,4657,4639
2022-12-17 13:00:00,2022-12-17 14:00:00,741,13,1589,2475,4818,4702
2022-12-17 14:00:00,2022-12-17 15:00:00,740,0,1636,2546,4922,4899
2022-12-17 15:00:00,2022-12-17 16:00:00,707,0,1709,2631,5047,5130
2022-12-17 16:00:00,2022-12-17 17:00:00,686,0,1787,2684,5157,5070
2022-12-17 17:00:00,2022-12-17 18:00:00,666,0,1836,2770,5272,4794
2022-12-17 18:00:00,2022-12-17 19:00:00,697,0,1931,2958,5586,4588
2022-12-17 19:00:00,2022-12-17 20:00:00,706,0,1954,3050,5710,4432
2022-12-17 20:00:00,2022-12-17 21:00:00,731,0,1977,3060,5768,4198
2022-12-17 21:00:00,2022-12-17 22:00:00,739,0,2007,2970,5716,4028
2022-12-17 22:00:00,2022-12-17 23:00:00,753,0,2021,2874,5648,3965
2022-12-17 23:00:00,2022-12-18 00:00:00,756,0,1992,2754,5502,3897
2022-12-18 00:00:00,2022-12-18 01:00:00,742,0,1958,2663,5363,3802
2022-12-18 01:00:00,2022-12-18 02:00:00,727,0,2005,2605,5337,3708
2022-12-18 02:00:00,2022-12-18 03:00:00,735,0,1998,2512,5245,3628
2022-12-18 03:00:00,2022-12-18 04:00:00,708,0,2001,2414,5123,3714
2022-12-18 04:00:00,2022-12-18 05:00:00,620,0,1984,2255,4859,3800
2022-12-18 05:00:00,2022-12-18 06:00:00,612,0,1954,2306,4872,4043
2022-12-18 06:00:00,2022-12-18 07:00:00,703,2,2016,2226,4947,4325
2022-12-18 07:00:00,2022-12-18 08:00:00,716,43,1986,2186,4931,4524
2022-12-18 08:00:00,2022-12-18 09:00:00,712,127,1940,2061,4840,4529
2022-12-18 09:00:00,2022-12-18 10:00:00,748,182,1798,1909,4637,4500
2022-12-18 10:00:00,2022-12-18 11:00:00,746,175,1540,1801,4262,4449
2022-12-18 11:00:00,2022-12-18 12:00:00,748,141,1449,1554,3892,4452
2022-12-18 12:00:00,2022-12-18 13:00:00,751,70,1409,1379,3609,4455
2022-12-18 13:00:00,2022-12-18 14:00:00,717,12,1367,1417,3513,4520
2022-12-18 14:00:00,2022-12-18 15:00:00,726,0,1550,1359,3635,4735
2022-12-18 15:00:00,2022-12-18 16:00:00,748,0,1475,1353,3576,4910
2022-12-18 16:00:00,2022-12-18 17:00:00,760,0,1647,1321,3728,4777
2022-12-18 17:00:00,2022-12-18 18:00:00,729,0,1728,1442,3899,4635
2022-12-18 18:00:00,2022-12-18 19:00:00,715,0,1788,1705,4208,4655
2022-12-18 19:00:00,2022-12-18 20:00:00,725,0,1906,1904,4535,4458
2022-12-18 20:00:00,2022-12-18 21:00:00,720,0,1961,2067,4748,4247
2022-12-18 21:00:00,2022-12-18 22:00:00,712,0,1986,2191,4889,4102
2022-12-18 22:00:00,2022-12-18 23:00:00,724,0,2021,2297,5042,4033
2022-12-18 23:00:00,2022-12-19 00:00:00,713,0,1991,2312,5016,4000
2022-12-19 00:00:00,2022-12-19 01:00:00,693,0,2035,2285,5013,4001
2022-12-19 01:00:00,2022-12-19 02:00:00,654,0,2017,2189,4860,3952
2022-12-19 02:00:00,2022-12-19 03:00:00,660,0,1978,2052,4690,3906
2022-12-19 03:00:00,2022-12-19 04:00:00,706,0,1974,1997,4677,4025
2022-12-19 04:00:00,2022-12-19 05:00:00,725,0,2004,1911,4640,4499
2022-12-19 05:00:00,2022-12-19 06:00:00,735,0,1982,1892,4609,5118
2022-12-19 06:00:00,2022-12-19 07:00:00,717,1,1984,1999,4701,5355
2022-12-19 07:00:00,2022-12-19 08:00:00,707,6,1949,1892,4554,5419
2022-12-19 08:00:00,2022-12-19 09:00:00,752,18,1930,1839,4539,5403
2022-12-19 09:00:00,2022-12-19 10:00:00,735,30,1927,1904,4596,5388
2022-12-19 10:00:00,2022-12-19 11:00:00,728,41,1999,1882,4650,5333
2022-12-19 11:00:00,2022-12-19 12:00:00,754,33,2000,1859,4646,5323
2022-12-19 12:00:00,2022-12-19 13:00:00,783,19,1990,1836,4628,5283
2022-12-19 13:00:00,2022-12-19 14:00:00,793,2,1992,1865,4652,5222
2022-12-19 14:00:00,2022-12-19 15:00:00,759,0,1987,1905,4651,5293
2022-12-19 15:00:00,2022-12-19 16:00:00,766,0,1984,2001,4751,5447
2022-12-19 16:00:00,2022-12-19 17:00:00,735,0,1989,2238,4962,5283
2022-12-19 17:00:00,2022-12-19 18:00:00,770,0,2015,2460,5245,4923
2022-12-19 18:00:00,2022-12-19 19:00:00,752,0,2048,2585,5385,4663
2022-12-19 19:00:00,2022-12-19 20:00:00,741,0,2072,2539,5352,4446
2022-12-19 20:00:00,2022-12-19 21:00:00,726,0,2076,2655,5457,4183
2022-12-19 21:00:00,2022-12-19 22:00:00,721,0,2062,2738,5521,4007
2022-12-19 22:00:00,2022-12-19 23:00:00,685,0,2036,2760,5481,3905
2022-12-19 23:00:00,2022-12-20 00:00:00,705,0,2024,2806,5535,3845
2022-12-20 00:00:00,2022-12-20 01:00:00,622,0,1991,2801,5414,3813
2022-12-20 01:00:00,2022-12-20 02:00:00,617,0,1991,2797,5405,3859
2022-12-20 02:00:00,2022-12-20 03:00:00,553,0,1959,2593,5105,3812
2022-12-20 03:00:00,2022-12-20 04:00:00,596,0,1983,2291,4870,3919
2022-12-20 04:00:00,2022-12-20 05:00:00,686,0,1925,2131,4742,4286
2022-12-20 05:00:00,2022-12-20 06:00:00,717,0,2010,2164,4891,4840
2022-12-20 06:00:00,2022-12-20 07:00:00,753,1,2057,2276,5087,5135
2022-12-20 07:00:00,2022-12-20 08:00:00,778,10,2038,2429,5255,5142
2022-12-20 08:00:00,2022-12-20 09:00:00,775,35,2048,2563,5421,5162
2022-12-20 09:00:00,2022-12-20 10:00:00,768,44,2047,2745,5604,5151
2022-12-20 10:00:00,2022-12-20 11:00:00,757,49,2046,2838,5690,5123
2022-12-20 11:00:00,2022-12-20 12:00:00,769,38,2045,2958,5810,5114
2022-12-20 12:00:00,2022-12-20 13:00:00,733,16,2027,3018,5794,5056
2022-12-20 13:00:00,2022-12-20 14:00:00,707,4,2060,3050,5821,4987
2022-12-20 14:00:00,2022-12-20 15:00:00,602,0,2036,2969,5607,5111
2022-12-20 15:00:00,2022-12-20 16:00:00,780,0,1826,2560,5166,5176
2022-12-20 16:00:00,2022-12-20 17:00:00,801,0,1659,2016,4476,4890
2022-12-20 17:00:00,2022-12-20 18:00:00,646,0,1752,1655,4053,4598
2022-12-20 18:00:00,2022-12-20 19:00:00,732,0,1733,1552,4017,4346
2022-12-20 19:00:00,2022-12-20 20:00:00,538,0,1600,1413,3551,4162
2022-12-20 20:00:00,2022-12-20 21:00:00,771,0,1460,1309,3540,3905
2022-12-20 21:00:00,2022-12-20 22:00:00,822,0,1273,1114,3209,3749
2022-12-20 22:00:00,2022-12-20 23:00:00,739,0,1127,980,2846,3575
2022-12-20 23:00:00,2022-12-21 00:00:00,758,0,863,1028,2649,3507
2022-12-21 00:00:00,2022-12-21 01:00:00,751,0,732,1028,2511,3437
2022-12-21 01:00:00,2022-12-21 02:00:00,737,0,673,988,2398,3424
2022-12-21 02:00:00,2022-12-21 03:00:00,737,0,539,1064,2340,3432
2022-12-21 03:00:00,2022-12-21 04:00:00,714,0,568,1144,2426,3600
2022-12-21 04:00:00,2022-12-21 05:00:00,764,0,603,1103,2470,4063
2022-12-21 05:00:00,2022-12-21 06:00:00,823,0,607,1018,2448,4617
2022-12-21 06:00:00,2022-12-21 07:00:00,856,1,679,1022,2558,4859
2022-12-21 07:00:00,2022-12-21 08:00:00,701,30,658,1010,2399,4889
2022-12-21 08:00:00,2022-12-21 09:00:00,854,88,718,989,2649,4921
2022-12-21 09:00:00,2022-12-21 10:00:00,825,117,838,1075,2855,4931
2022-12-21 10:00:00,2022-12-21 11:00:00,815,134,949,1250,3148,4871
2022-12-21 11:00:00,2022-12-21 12:00:00,816,110,1029,1444,3399,4930
2022-12-21 12:00:00,2022-12-21 13:00:00,776,62,1109,1690,3637,4846
2022-12-21 13:00:00,2022-12-21 14:00:00,783,10,1279,1931,4003,4738
2022-12-21 14:00:00,2022-12-21 15:00:00,717,0,1335,2144,4196,4901
2022-12-21 15:00:00,2022-12-21 16:00:00,647,0,1181,2198,4026,5031
2022-12-21 16:00:00,2022-12-21 17:00:00,826,0,1448,1944,4218,4851
2022-12-21 17:00:00,2022-12-21 18:00:00,730,0,1634,1916,4280,4605
2022-12-21 18:00:00,2022-12-21 19:00:00,637,0,1873,2027,4537,4431
2022-12-21 19:00:00,2022-12-21 20:00:00,750,0,1822,2099,4671,4167
2022-12-21 20:00:00,2022-12-21 21:00:00,763,0,1883,2097,4743,3935
2022-12-21 21:00:00,2022-12-21 22:00:00,746,0,1930,1979,4655,3802
2022-12-21 22:00:00,2022-12-21 23:00:00,746,0,1859,1803,4408,3578
2022-12-21 23:00:00,2022-12-22 00:00:00,737,0,1732,1692,4161,3477
2022-12-22 00:00:00,2022-12-22 01:00:00,690,0,1558,1663,3911,3444
2022-12-22 01:00:00,2022-12-22 02:00:00,696,0,1441,1684,3821,3386
2022-12-22 02:00:00,2022-12-22 03:00:00,738,0,1412,1663,3813,3348
2022-12-22 03:00:00,2022-12-22 04:00:00,729,0,1338,1643,3710,3454
2022-12-22 04:00:00,2022-12-22 05:00:00,805,0,1229,1593,3627,3908
2022-12-22 05:00:00,2022-12-22 06:00:00,822,0,1319,1570,3711,4424
2022-12-22 06:00:00,2022-12-22 07:00:00,830,1,1409,1602,3842,4651
2022-12-22 07:00:00,2022-12-22 08:00:00,825,24,1316,1598,3763,4698
2022-12-22 08:00:00,2022-12-22 09:00:00,819,78,1275,1544,3716,4766
2022-12-22 09:00:00,2022-12-22 10:00:00,820,143,1302,1592,3857,4716
2022-12-22 10:00:00,2022-12-22 11:00:00,778,186,1298,1702,3964,4559
2022-12-22 11:00:00,2022-12-22 12:00:00,789,143,1251,1981,4164,4554
2022-12-22 12:00:00,2022-12-22 13:00:00,781,78,1380,2127,4366,4508
2022-12-22 13:00:00,2022-12-22 14:00:00,779,15,1488,2146,4428,4440
2022-12-22 14:00:00,2022-12-22 15:00:00,763,0,1617,2113,4493,4581
2022-12-22 15:00:00,2022-12-22 16:00:00,837,0,1751,2133,4721,4715
2022-12-22 16:00:00,2022-12-22 17:00:00,873,0,1834,1988,4695,4586
2022-12-22 17:00:00,2022-12-22 18:00:00,792,0,1678,1859,4329,4310
2022-12-22 18:00:00,2022-12-22 19:00:00,844,0,1669,1707,4220,4050
2022-12-22 19:00:00,2022-12-22 20:00:00,787,0,1594,1571,3952,3890
2022-12-22 20:00:00,2022-12-22 21:00:00,791,0,1517,1423,3731,3687
2022-12-22 21:00:00,2022-12-22 22:00:00,796,0,1340,1343,3479,3522
2022-12-22 22:00:00,2022-12-22 23:00:00,742,0,1075,1190,3007,3393
2022-12-22 23:00:00,2022-12-23 00:00:00,628,0,1129,956,2713,3299
2022-12-23 00:00:00,2022-12-23 01:00:00,613,0,932,825,2370,3296
2022-12-23 01:00:00,2022-12-23 02:00:00,626,0,714,804,2144,3200
2022-12-23 02:00:00,2022-12-23 03:00:00,600,0,686,707,1993,3109
2022-12-23 03:00:00,2022-12-23 04:00:00,660,0,747,641,2048,3219
2022-12-23 04:00:00,2022-12-23 05:00:00,726,0,772,580,2078,3559
2022-12-23 05:00:00,2022-12-23 06:00:00,706,0,747,566,2019,4000
2022-12-23 06:00:00,2022-12-23 07:00:00,699,2,650,555,1906,4351
2022-12-23 07:00:00,2022-12-23 08:00:00,713,62,592,555,1922,4419
2022-12-23 08:00:00,2022-12-23 09:00:00,718,244,547,474,1983,4474
2022-12-23 09:00:00,2022-12-23 10:00:00,769,403,460,338,1970,4365
2022-12-23 10:00:00,2022-12-23 11:00:00,792,446,360,201,1799,4271
2022-12-23 11:00:00,2022-12-23 12:00:00,810,389,221,116,1536,4212
2022-12-23 12:00:00,2022-12-23 13:00:00,809,204,168,86,1267,4198
2022-12-23 13:00:00,2022-12-23 14:00:00,793,30,115,77,1015,4276
2022-12-23 14:00:00,2022-12-23 15:00:00,813,1,107,74,995,4537
2022-12-23 15:00:00,2022-12-23 16:00:00,826,0,62,66,954,4728
2022-12-23 16:00:00,2022-12-23 17:00:00,827,0,40,95,962,4601
2022-12-23 17:00:00,2022-12-23 18:00:00,787,0,41,159,987,4350
2022-12-23 18:00:00,2022-12-23 19:00:00,768,0,42,228,1038,4173
2022-12-23 19:00:00,2022-12-23 20:00:00,759,0,124,311,1194,4023
2022-12-23 20:00:00,2022-12-23 21:00:00,745,0,180,330,1255,3836
2022-12-23 21:00:00,2022-12-23 22:00:00,655,0,158,310,1123,3745
2022-12-23 22:00:00,2022-12-23 23:00:00,697,0,135,308,1140,3687
2022-12-23 23:00:00,2022-12-24 00:00:00,671,0,217,362,1250,3653
2022-12-24 00:00:00,2022-12-24 01:00:00,575,0,291,424,1290,3617
2022-12-24 01:00:00,2022-12-24 02:00:00,581,0,322,397,1300,3631
2022-12-24 02:00:00,2022-12-24 03:00:00,611,0,363,380,1354,3543
2022-12-24 03:00:00,2022-12-24 04:00:00,607,0,418,392,1417,3511
2022-12-24 04:00:00,2022-12-24 05:00:00,613,0,377,401,1391,3566
2022-12-24 05:00:00,2022-12-24 06:00:00,668,0,372,380,1420,3807
2022-12-24 06:00:00,2022-12-24 07:00:00,624,1,398,469,1492,4058
2022-12-24 07:00:00,2022-12-24 08:00:00,683,32,404,515,1634,4197
2022-12-24 08:00:00,2022-12-24 09:00:00,701,101,442,470,1714,4211
2022-12-24 09:00:00,2022-12-24 10:00:00,713,144,422,403,1682,4230
2022-12-24 10:00:00,2022-12-24 11:00:00,711,153,453,395,1712,4182
2022-12-24 11:00:00,2022-12-24 12:00:00,709,145,448,409,1711,4157
2022-12-24 12:00:00,2022-12-24 13:00:00,712,83,509,450,1754,4190
2022-12-24 13:00:00,2022-12-24 14:00:00,707,16,647,510,1880,4332
2022-12-24 14:00:00,2022-12-24 15:00:00,759,0,744,594,2097,4651
2022-12-24 15:00:00,2022-12-24 16:00:00,774,0,740,678,2192,4878
2022-12-24 16:00:00,2022-12-24 17:00:00,696,0,624,725,2045,4121
2022-12-24 17:00:00,2022-12-24 18:00:00,722,0,385,704,1811,3707
2022-12-24 18:00:00,2022-12-24 19:00:00,701,0,466,704,1871,3619
2022-12-24 19:00:00,2022-12-24 20:00:00,695,0,415,709,1819,3499
2022-12-24 20:00:00,2022-12-24 21:00:00,703,0,459,641,1803,3386
2022-12-24 21:00:00,2022-12-24 22:00:00,637,0,459,644,1740,3360
2022-12-24 22:00:00,2022-12-24 23:00:00,612,0,627,674,1913,3293
2022-12-24 23:00:00,2022-12-25 00:00:00,591,0,702,773,2066,3221
2022-12-25 00:00:00,2022-12-25 01:00:00,576,0,751,683,2010,3139
2022-12-25 01:00:00,2022-12-25 02:00:00,604,0,810,725,2139,3129
2022-12-25 02:00:00,2022-12-25 03:00:00,602,0,794,894,2290,3146
2022-12-25 03:00:00,2022-12-25 04:00:00,602,0,847,966,2415,3151
2022-12-25 04:00:00,2022-12-25 05:00:00,573,0,1019,1079,2671,3207
2022-12-25 05:00:00,2022-12-25 06:00:00,573,0,980,1289,2842,3317
2022-12-25 06:00:00,2022-12-25 07:00:00,599,1,1084,1631,3315,3546
2022-12-25 07:00:00,2022-12-25 08:00:00,600,14,1207,1744,3565,3689
2022-12-25 08:00:00,2022-12-25 09:00:00,571,41,1186,1749,3547,3841
2022-12-25 09:00:00,2022-12-25 10:00:00,582,52,1260,1780,3674,3866
2022-12-25 10:00:00,2022-12-25 11:00:00,555,51,1335,1771,3712,3952
2022-12-25 11:00:00,2022-12-25 12:00:00,572,40,1273,1622,3507,3857
2022-12-25 12:00:00,2022-12-25 13:00:00,575,23,1368,1561,3527,3808
2022-12-25 13:00:00,2022-12-25 14:00:00,562,3,1236,1485,3286,3864
2022-12-25 14:00:00,2022-12-25 15:00:00,574,0,1237,1428,3239,4073
2022-12-25 15:00:00,2022-12-25 16:00:00,525,0,1331,1363,3219,4212
2022-12-25 16:00:00,2022-12-25 17:00:00,510,0,1277,1346,3133,4114
2022-12-25 17:00:00,2022-12-25 18:00:00,593,0,1211,1248,3052,3901
2022-12-25 18:00:00,2022-12-25 19:00:00,675,0,1031,1101,2807,3744
2022-12-25 19:00:00,2022-12-25 20:00:00,666,0,1066,900,2632,3636
2022-12-25 20:00:00,2022-12-25 21:00:00,618,0,797,813,2228,3470
2022-12-25 21:00:00,2022-12-25 22:00:00,537,0,642,833,2012,3300
2022-12-25 22:00:00,2022-12-25 23:00:00,564,0,606,707,1877,3241
2022-12-25 23:00:00,2022-12-26 00:00:00,403,0,633,627,1663,3174
2022-12-26 00:00:00,2022-12-26 01:00:00,325,0,600,645,1570,3135
2022-12-26 01:00:00,2022-12-26 02:00:00,312,0,552,547,1411,3181
2022-12-26 02:00:00,2022-12-26 03:00:00,318,0,599,582,1499,3192
2022-12-26 03:00:00,2022-12-26 04:00:00,288,0,712,698,1698,3193
2022-12-26 04:00:00,2022-12-26 05:00:00,312,0,680,913,1905,3252
2022-12-26 05:00:00,2022-12-26 06:00:00,361,0,912,987,2260,3474
2022-12-26 06:00:00,2022-12-26 07:00:00,417,0,1047,1168,2632,3696
2022-12-26 07:00:00,2022-12-26 08:00:00,477,8,1111,1551,3147,3921
2022-12-26 08:00:00,2022-12-26 09:00:00,481,40,1118,1896,3535,4048
2022-12-26 09:00:00,2022-12-26 10:00:00,489,69,1228,2208,3994,4117
2022-12-26 10:00:00,2022-12-26 11:00:00,410,98,1606,2446,4560,4064
2022-12-26 11:00:00,2022-12-26 12:00:00,341,87,1939,2590,4957,4001
2022-12-26 12:00:00,2022-12-26 13:00:00,314,49,2002,3091,5456,3958
2022-12-26 13:00:00,2022-12-26 14:00:00,356,19,2121,3259,5755,3900
2022-12-26 14:00:00,2022-12-26 15:00:00,422,1,2102,3372,5897,4053
2022-12-26 15:00:00,2022-12-26 16:00:00,507,0,2106,3088,5701,4239
2022-12-26 16:00:00,2022-12-26 17:00:00,496,0,2023,2858,5377,4112
2022-12-26 17:00:00,2022-12-26 18:00:00,538,0,2084,2603,5225,3973
2022-12-26 18:00:00,2022-12-26 19:00:00,528,0,2003,2509,5040,3881
2022-12-26 19:00:00,2022-12-26 20:00:00,547,0,2037,2381,4965,3754
2022-12-26 20:00:00,2022-12-26 21:00:00,543,0,2067,2359,4969,3626
2022-12-26 21:00:00,2022-12-26 22:00:00,492,0,2080,2335,4907,3508
2022-12-26 22:00:00,2022-12-26 23:00:00,503,0,2103,2181,4787,3474
2022-12-26 23:00:00,2022-12-27 00:00:00,474,0,2035,1893,4402,3408
2022-12-27 00:00:00,2022-12-27 01:00:00,477,0,2012,1736,4225,3337
2022-12-27 01:00:00,2022-12-27 02:00:00,474,0,1968,1702,4144,3312
2022-12-27 02:00:00,2022-12-27 03:00:00,482,0,1892,1734,4108,3293
2022-12-27 03:00:00,2022-12-27 04:00:00,498,0,1884,1930,4312,3370
2022-12-27 04:00:00,2022-12-27 05:00:00,479,0,1896,2154,4529,3595
2022-12-27 05:00:00,2022-12-27 06:00:00,540,0,1964,2241,4745,3916
2022-12-27 06:00:00,2022-12-27 07:00:00,556,2,2058,2183,4799,4182
2022-12-27 07:00:00,2022-12-27 08:00:00,585,61,1797,2095,4538,4322
2022-12-27 08:00:00,2022-12-27 09:00:00,584,217,1767,1992,4560,4375
2022-12-27 09:00:00,2022-12-27 10:00:00,598,352,1713,1979,4642,4323
2022-12-27 10:00:00,2022-12-27 11:00:00,586,431,1629,1812,4458,4248
2022-12-27 11:00:00,2022-12-27 12:00:00,607,297,1592,1745,4241,4209
2022-12-27 12:00:00,2022-12-27 13:00:00,566,150,1929,1607,4252,4176
2022-12-27 13:00:00,2022-12-27 14:00:00,581,23,1955,1539,4098,4218
2022-12-27 14:00:00,2022-12-27 15:00:00,605,0,1895,1435,3935,4447
2022-12-27 15:00:00,2022-12-27 16:00:00,612,0,1960,1511,4083,4670
2022-12-27 16:00:00,2022-12-27 17:00:00,593,0,1861,1450,3904,4497
2022-12-27 17:00:00,2022-12-27 18:00:00,605,0,1752,1274,3631,4228
2022-12-27 18:00:00,2022-12-27 19:00:00,622,0,1751,1166,3539,4056
2022-12-27 19:00:00,2022-12-27 20:00:00,588,0,1830,1255,3673,3863
2022-12-27 20:00:00,2022-12-27 21:00:00,521,0,1811,1357,3689,3711
2022-12-27 21:00:00,2022-12-27 22:00:00,515,0,1761,1676,3952,3630
2022-12-27 22:00:00,2022-12-27 23:00:00,520,0,1829,2021,4370,3552
2022-12-27 23:00:00,2022-12-28 00:00:00,516,0,1857,2267,4640,3613
2022-12-28 00:00:00,2022-12-28 01:00:00,496,0,1940,2838,5274,3582
2022-12-28 01:00:00,2022-12-28 02:00:00,479,0,1801,2603,4883,3621
2022-12-28 02:00:00,2022-12-28 03:00:00,450,0,1636,3192,5278,3541
2022-12-28 03:00:00,2022-12-28 04:00:00,412,0,1883,3178,5473,3635
2022-12-28 04:00:00,2022-12-28 05:00:00,437,0,2036,3405,5878,3745
2022-12-28 05:00:00,2022-12-28 06:00:00,442,0,2091,3245,5778,4067
2022-12-28 06:00:00,2022-12-28 07:00:00,518,0,2091,2871,5480,4307
2022-12-28 07:00:00,2022-12-28 08:00:00,478,12,2027,2732,5249,4457
2022-12-28 08:00:00,2022-12-28 09:00:00,461,59,2014,2663,5197,4541
2022-12-28 09:00:00,2022-12-28 10:00:00,518,137,2009,2575,5239,4518
2022-12-28 10:00:00,2022-12-28 11:00:00,556,171,1939,2416,5082,4396
2022-12-28 11:00:00,2022-12-28 12:00:00,575,155,1786,2174,4690,4349
2022-12-28 12:00:00,2022-12-28 13:00:00,629,91,1601,1587,3908,4289
2022-12-28 13:00:00,2022-12-28 14:00:00,655,18,1609,1198,3480,4253
2022-12-28 14:00:00,2022-12-28 15:00:00,624,0,1429,1019,3072,4444
2022-12-28 15:00:00,2022-12-28 16:00:00,628,0,1403,909,2940,4664
2022-12-28 16:00:00,2022-12-28 17:00:00,629,0,1722,1132,3483,4532
2022-12-28 17:00:00,2022-12-28 18:00:00,629,0,1707,1556,3892,4281
2022-12-28 18:00:00,2022-12-28 19:00:00,607,0,1950,2083,4640,4115
2022-12-28 19:00:00,2022-12-28 20:00:00,592,0,2038,2282,4912,4095
2022-12-28 20:00:00,2022-12-28 21:00:00,515,0,2049,2472,5036,3825
2022-12-28 21:00:00,2022-12-28 22:00:00,516,0,2038,2577,5131,3751
2022-12-28 22:00:00,2022-12-28 23:00:00,451,0,1433,2962,4846,3620
2022-12-28 23:00:00,2022-12-29 00:00:00,387,0,1533,3207,5127,3506
2022-12-29 00:00:00,2022-12-29 01:00:00,410,0,1586,3291,5287,3409
2022-12-29 01:00:00,2022-12-29 02:00:00,403,0,1583,3102,5088,3364
2022-12-29 02:00:00,2022-12-29 03:00:00,383,0,1565,3059,5007,3349
2022-12-29 03:00:00,2022-12-29 04:00:00,331,0,1538,3133,5002,3401
2022-12-29 04:00:00,2022-12-29 05:00:00,295,0,1661,3192,5148,3639
2022-12-29 05:00:00,2022-12-29 06:00:00,340,0,2097,3261,5698,3976
2022-12-29 06:00:00,2022-12-29 07:00:00,386,1,2110,3390,5887,4316
2022-12-29 07:00:00,2022-12-29 08:00:00,350,25,2031,3485,5891,4442
2022-12-29 08:00:00,2022-12-29 09:00:00,359,82,2055,3547,6043,4546
2022-12-29 09:00:00,2022-12-29 10:00:00,328,130,2048,3585,6091,4508
2022-12-29 10:00:00,2022-12-29 11:00:00,278,160,2019,3439,5896,4549
2022-12-29 11:00:00,2022-12-29 12:00:00,252,120,2121,3225,5718,4493
2022-12-29 12:00:00,2022-12-29 13:00:00,252,59,2085,2996,5392,4378
2022-12-29 13:00:00,2022-12-29 14:00:00,335,14,2006,3159,5514,4381
2022-12-29 14:00:00,2022-12-29 15:00:00,422,0,2073,3358,5853,4532
2022-12-29 15:00:00,2022-12-29 16:00:00,512,0,2069,3440,6021,4703
2022-12-29 16:00:00,2022-12-29 17:00:00,512,0,2042,3407,5961,4567
2022-12-29 17:00:00,2022-12-29 18:00:00,514,0,2066,3277,5857,4271
2022-12-29 18:00:00,2022-12-29 19:00:00,502,0,2057,3147,5706,4053
2022-12-29 19:00:00,2022-12-29 20:00:00,412,0,2067,3037,5516,3903
2022-12-29 20:00:00,2022-12-29 21:00:00,443,0,2082,2817,5342,3710
2022-12-29 21:00:00,2022-12-29 22:00:00,368,0,2032,2805,5205,3548
2022-12-29 22:00:00,2022-12-29 23:00:00,389,0,2016,3093,5498,3491
2022-12-29 23:00:00,2022-12-30 00:00:00,391,0,1975,3372,5738,3430
2022-12-30 00:00:00,2022-12-30 01:00:00,341,0,2060,3447,5848,3355
2022-12-30 01:00:00,2022-12-30 02:00:00,327,0,1933,3418,5678,3309
2022-12-30 02:00:00,2022-12-30 03:00:00,304,0,1863,3411,5578,3314
2022-12-30 03:00:00,2022-12-30 04:00:00,298,0,1988,3379,5665,3392
2022-12-30 04:00:00,2022-12-30 05:00:00,307,0,1916,2883,5106,3612
2022-12-30 05:00:00,2022-12-30 06:00:00,417,0,1944,2384,4745,3859
2022-12-30 06:00:00,2022-12-30 07:00:00,491,3,2009,2152,4655,4153
2022-12-30 07:00:00,2022-12-30 08:00:00,504,65,1991,2127,4687,4318
2022-12-30 08:00:00,2022-12-30 09:00:00,502,146,1962,2090,4700,4441
2022-12-30 09:00:00,2022-12-30 10:00:00,501,172,1871,2331,4875,4430
2022-12-30 10:00:00,2022-12-30 11:00:00,447,160,1975,2806,5388,4420
2022-12-30 11:00:00,2022-12-30 12:00:00,475,125,1975,3043,5618,4511
2022-12-30 12:00:00,2022-12-30 13:00:00,507,74,1923,3074,5578,4336
2022-12-30 13:00:00,2022-12-30 14:00:00,476,17,1876,3161,5530,4330
2022-12-30 14:00:00,2022-12-30 15:00:00,449,0,2004,3425,5878,4565
2022-12-30 15:00:00,2022-12-30 16:00:00,491,0,2089,3648,6228,4720
2022-12-30 16:00:00,2022-12-30 17:00:00,499,0,2031,3829,6359,4622
2022-12-30 17:00:00,2022-12-30 18:00:00,505,0,2074,3926,6505,4375
2022-12-30 18:00:00,2022-12-30 19:00:00,501,0,2057,3968,6526,4187
2022-12-30 19:00:00,2022-12-30 20:00:00,351,0,2033,4020,6404,4103
2022-12-30 20:00:00,2022-12-30 21:00:00,327,0,1910,4020,6257,3965
2022-12-30 21:00:00,2022-12-30 22:00:00,349,0,1214,3754,5317,3750
2022-12-30 22:00:00,2022-12-30 23:00:00,235,0,1574,3528,5337,3523
2022-12-30 23:00:00,2022-12-31 00:00:00,227,0,1168,2897,4292,3408
2022-12-31 00:00:00,2022-12-31 01:00:00,235,0,369,2949,3553,3262
2022-12-31 01:00:00,2022-12-31 02:00:00,232,0,386,2845,3463,3162
2022-12-31 02:00:00,2022-12-31 03:00:00,232,0,376,2740,3348,3071
2022-12-31 03:00:00,2022-12-31 04:00:00,232,0,373,2673,3278,3104
2022-12-31 04:00:00,2022-12-31 05:00:00,231,0,382,2518,3131,3235
2022-12-31 05:00:00,2022-12-31 06:00:00,237,0,375,2423,3035,3419
2022-12-31 06:00:00,2022-12-31 07:00:00,241,1,1650,2274,4166,3710
2022-12-31 07:00:00,2022-12-31 08:00:00,233,21,1783,2142,4179,3904
2022-12-31 08:00:00,2022-12-31 09:00:00,301,69,1707,1861,3938,4026
2022-12-31 09:00:00,2022-12-31 10:00:00,305,93,1846,1599,3843,4102
2022-12-31 10:00:00,2022-12-31 11:00:00,254,81,1972,1486,3793,4130
2022-12-31 11:00:00,2022-12-31 12:00:00,234,58,1745,1147,3184,4147
2022-12-31 12:00:00,2022-12-31 13:00:00,355,29,1366,933,2683,4083
2022-12-31 13:00:00,2022-12-31 14:00:00,393,7,1004,877,2281,4105
2022-12-31 14:00:00,2022-12-31 15:00:00,441,0,951,891,2283,4293
2022-12-31 15:00:00,2022-12-31 16:00:00,542,0,931,832,2305,4398
2022-12-31 16:00:00,2022-12-31 17:00:00,453,0,920,812,2185,4291
2022-12-31 17:00:00,2022-12-31 18:00:00,384,0,849,731,1964,3932
2022-12-31 18:00:00,2022-12-31 19:00:00,368,0,778,605,1751,3694
2022-12-31 19:00:00,2022-12-31 20:00:00,406,0,864,495,1765,3713
2022-12-31 20:00:00,2022-12-31 21:00:00,323,0,819,451,1593,3579
2022-12-31 21:00:00,2022-12-31 22:00:00,263,0,942,583,1788,3520
2022-12-31 22:00:00,2022-12-31 23:00:00,258,0,1097,887,2242,3440
2022-12-31 23:00:00,2023-01-01 00:00:00,286,0,1260,1233,2779,3389
