StartTime,EndTime,quantity_B01,quantity_B11,quantity_B16,quantity_B18,quantity_B19,total_green_energy,Load
2022-01-01 00:00:00,2022-01-01 01:00:00,85,0,4,6940,5739,12768,40706
2022-01-01 01:00:00,2022-01-01 02:00:00,85,0,4,5548,5494,11131,39465
2022-01-01 02:00:00,2022-01-01 03:00:00,86,0,4,5550,5684,11324,38923
2022-01-01 03:00:00,2022-01-01 04:00:00,85,0,4,5709,5492,11290,38211
2022-01-01 04:00:00,2022-01-01 05:00:00,85,0,4,5860,5144,11093,38146
2022-01-01 05:00:00,2022-01-01 06:00:00,85,0,4,6295,4644,11028,38956
2022-01-01 06:00:00,2022-01-01 07:00:00,83,0,4,6252,4082,10421,39968
2022-01-01 07:00:00,2022-01-01 08:00:00,84,0,5,5794,4682,10565,40808
2022-01-01 08:00:00,2022-01-01 09:00:00,84,0,33,6484,4754,11355,41742
2022-01-01 09:00:00,2022-01-01 10:00:00,84,0,118,7686,5395,13283,42796
2022-01-01 10:00:00,2022-01-01 11:00:00,83,0,147,8346,5463,14039,42494
2022-01-01 11:00:00,2022-01-01 12:00:00,84,0,146,8743,5875,14848,42294
2022-01-01 12:00:00,2022-01-01 13:00:00,83,0,122,8805,6061,15071,43153
2022-01-01 13:00:00,2022-01-01 14:00:00,83,0,78,8705,6192,15058,44379
2022-01-01 14:00:00,2022-01-01 15:00:00,80,0,48,8532,6336,14996,45865
2022-01-01 15:00:00,2022-01-01 16:00:00,83,0,4,7816,6717,14620,48406
2022-01-01 16:00:00,2022-01-01 17:00:00,84,0,4,8505,7006,15599,52021
2022-01-01 17:00:00,2022-01-01 18:00:00,83,0,4,8859,7265,16211,51429
2022-01-01 18:00:00,2022-01-01 19:00:00,84,0,4,8956,7162,16206,49999
2022-01-01 19:00:00,2022-01-01 20:00:00,84,0,4,8479,6735,15302,47940
2022-01-01 20:00:00,2022-01-01 21:00:00,83,0,4,7758,6258,14103,46052
2022-01-01 21:00:00,2022-01-01 22:00:00,85,0,4,7854,5735,13678,44113
2022-01-01 22:00:00,2022-01-01 23:00:00,84,0,4,8411,5530,14029,42275
2022-01-01 23:00:00,2022-01-02 00:00:00,82,0,4,8234,5890,14210,41053
2022-01-02 00:00:00,2022-01-02 01:00:00,81,0,4,8263,6671,15019,39562
2022-01-02 01:00:00,2022-01-02 02:00:00,82,0,4,8718,6370,15174,38687
2022-01-02 02:00:00,2022-01-02 03:00:00,84,0,4,8866,6199,15153,38236
2022-01-02 03:00:00,2022-01-02 04:00:00,84,0,4,8578,6573,15239,38283
2022-01-02 04:00:00,2022-01-02 05:00:00,84,0,4,8011,7163,15262,38979
2022-01-02 05:00:00,2022-01-02 06:00:00,83,0,4,7959,7155,15201,40264
2022-01-02 06:00:00,2022-01-02 07:00:00,83,0,4,8523,7326,15936,42237
2022-01-02 07:00:00,2022-01-02 08:00:00,84,0,4,8468,7759,16315,44702
2022-01-02 08:00:00,2022-01-02 09:00:00,84,0,11,8533,8267,16895,46562
2022-01-02 09:00:00,2022-01-02 10:00:00,84,0,75,8720,7987,16866,46441
2022-01-02 10:00:00,2022-01-02 11:00:00,84,0,71,8863,8023,17041,47998
2022-01-02 11:00:00,2022-01-02 12:00:00,84,0,61,8689,8473,17307,48585
2022-01-02 12:00:00,2022-01-02 13:00:00,84,0,93,8682,8213,17072,47660
2022-01-02 13:00:00,2022-01-02 14:00:00,83,0,74,8770,7769,16696,47919
2022-01-02 14:00:00,2022-01-02 15:00:00,82,0,28,8746,7734,16590,48988
2022-01-02 15:00:00,2022-01-02 16:00:00,83,0,3,8612,7081,15779,51783
2022-01-02 16:00:00,2022-01-02 17:00:00,84,0,4,8848,7043,15979,55587
2022-01-02 17:00:00,2022-01-02 18:00:00,84,0,4,8779,6762,15629,54121
2022-01-02 18:00:00,2022-01-02 19:00:00,84,0,4,8918,6856,15862,52577
2022-01-02 19:00:00,2022-01-02 20:00:00,84,0,4,8583,7331,16002,50705
2022-01-02 20:00:00,2022-01-02 21:00:00,84,0,4,8337,7946,16371,48614
2022-01-02 21:00:00,2022-01-02 22:00:00,84,0,4,8294,8188,16570,46842
2022-01-02 22:00:00,2022-01-02 23:00:00,83,0,4,8719,8368,17174,44466
2022-01-02 23:00:00,2022-01-03 00:00:00,83,0,4,8183,8530,16800,42800
2022-01-03 00:00:00,2022-01-03 01:00:00,82,0,4,6659,8546,15291,41392
2022-01-03 01:00:00,2022-01-03 02:00:00,84,0,4,6650,8453,15191,40806
2022-01-03 02:00:00,2022-01-03 03:00:00,84,0,4,6663,8098,14849,40492
2022-01-03 03:00:00,2022-01-03 04:00:00,84,0,4,7072,8069,15229,40988
2022-01-03 04:00:00,2022-01-03 05:00:00,84,0,4,7890,8222,16200,43740
2022-01-03 05:00:00,2022-01-03 06:00:00,84,0,4,8626,8084,16798,47804
2022-01-03 06:00:00,2022-01-03 07:00:00,84,0,4,8734,8107,16929,52778
2022-01-03 07:00:00,2022-01-03 08:00:00,83,0,4,8887,8174,17148,57029
2022-01-03 08:00:00,2022-01-03 09:00:00,83,0,42,8903,8116,17144,58111
2022-01-03 09:00:00,2022-01-03 10:00:00,84,0,130,8882,8058,17154,56875
2022-01-03 10:00:00,2022-01-03 11:00:00,84,0,213,8910,8090,17297,55464
2022-01-03 11:00:00,2022-01-03 12:00:00,84,0,248,8909,8130,17371,55854
2022-01-03 12:00:00,2022-01-03 13:00:00,83,0,242,8911,8096,17332,56252
2022-01-03 13:00:00,2022-01-03 14:00:00,83,0,107,8924,7950,17064,57466
2022-01-03 14:00:00,2022-01-03 15:00:00,83,0,28,8917,7671,16699,58816
2022-01-03 15:00:00,2022-01-03 16:00:00,84,0,3,8833,7471,16391,61242
2022-01-03 16:00:00,2022-01-03 17:00:00,83,0,4,8504,7365,15956,63810
2022-01-03 17:00:00,2022-01-03 18:00:00,83,0,4,8022,7052,15161,60621
2022-01-03 18:00:00,2022-01-03 19:00:00,83,0,4,7962,6745,14794,58003
2022-01-03 19:00:00,2022-01-03 20:00:00,83,0,4,7138,6478,13703,54823
2022-01-03 20:00:00,2022-01-03 21:00:00,84,0,4,6582,6158,12828,52129
2022-01-03 21:00:00,2022-01-03 22:00:00,84,0,4,5972,5968,12028,49295
2022-01-03 22:00:00,2022-01-03 23:00:00,84,0,4,5710,5562,11360,46530
2022-01-03 23:00:00,2022-01-04 00:00:00,84,0,4,5324,5363,10775,44424
2022-01-04 00:00:00,2022-01-04 01:00:00,84,0,4,5132,4865,10085,43524
2022-01-04 01:00:00,2022-01-04 02:00:00,84,0,4,5204,4542,9834,42615
2022-01-04 02:00:00,2022-01-04 03:00:00,84,0,4,4320,4232,8640,42249
2022-01-04 03:00:00,2022-01-04 04:00:00,84,0,4,3569,3884,7541,42804
2022-01-04 04:00:00,2022-01-04 05:00:00,84,0,4,3486,3828,7402,45047
2022-01-04 05:00:00,2022-01-04 06:00:00,83,0,4,2842,3683,6612,49175
2022-01-04 06:00:00,2022-01-04 07:00:00,82,0,4,3001,3576,6663,54802
2022-01-04 07:00:00,2022-01-04 08:00:00,81,0,4,2832,2930,5847,59275
2022-01-04 08:00:00,2022-01-04 09:00:00,67,0,17,3562,2772,6418,60815
2022-01-04 09:00:00,2022-01-04 10:00:00,70,0,53,1981,2724,4828,60695
2022-01-04 10:00:00,2022-01-04 11:00:00,78,0,56,3092,2450,5676,60731
2022-01-04 11:00:00,2022-01-04 12:00:00,81,0,101,3574,2321,6077,60624
2022-01-04 12:00:00,2022-01-04 13:00:00,65,0,140,4840,1758,6803,60527
2022-01-04 13:00:00,2022-01-04 14:00:00,64,0,126,4848,1664,6702,60152
2022-01-04 14:00:00,2022-01-04 15:00:00,64,0,56,3879,1949,5948,60484
2022-01-04 15:00:00,2022-01-04 16:00:00,65,0,3,5583,2344,7995,62735
2022-01-04 16:00:00,2022-01-04 17:00:00,64,0,4,4989,2060,7117,65179
2022-01-04 17:00:00,2022-01-04 18:00:00,64,0,4,6387,2313,8768,61854
2022-01-04 18:00:00,2022-01-04 19:00:00,63,0,4,7692,3271,11030,59419
2022-01-04 19:00:00,2022-01-04 20:00:00,63,0,4,7407,3601,11075,56378
2022-01-04 20:00:00,2022-01-04 21:00:00,63,0,4,8149,4251,12467,53698
2022-01-04 21:00:00,2022-01-04 22:00:00,62,0,4,8570,5323,13959,51094
2022-01-04 22:00:00,2022-01-04 23:00:00,63,0,4,8401,5431,13899,48171
2022-01-04 23:00:00,2022-01-05 00:00:00,61,0,4,8653,5774,14492,46082
2022-01-05 00:00:00,2022-01-05 01:00:00,60,0,4,8784,6276,15124,44542
2022-01-05 01:00:00,2022-01-05 02:00:00,60,0,4,8828,6686,15578,44317
2022-01-05 02:00:00,2022-01-05 03:00:00,63,0,4,8928,7056,16051,44149
2022-01-05 03:00:00,2022-01-05 04:00:00,64,0,4,8933,7431,16432,44739
2022-01-05 04:00:00,2022-01-05 05:00:00,62,0,4,8922,7706,16694,46258
2022-01-05 05:00:00,2022-01-05 06:00:00,63,0,4,8876,8148,17091,49996
2022-01-05 06:00:00,2022-01-05 07:00:00,62,0,4,8919,8422,17407,55534
2022-01-05 07:00:00,2022-01-05 08:00:00,63,0,7,8898,8343,17311,59353
2022-01-05 08:00:00,2022-01-05 09:00:00,64,0,29,8893,8357,17343,61021
2022-01-05 09:00:00,2022-01-05 10:00:00,63,0,137,8910,8301,17411,61124
2022-01-05 10:00:00,2022-01-05 11:00:00,62,0,296,8887,8397,17642,60209
2022-01-05 11:00:00,2022-01-05 12:00:00,61,0,309,8884,8455,17709,59304
2022-01-05 12:00:00,2022-01-05 13:00:00,61,0,233,8701,8403,17398,59158
2022-01-05 13:00:00,2022-01-05 14:00:00,61,0,111,8767,8230,17169,59484
2022-01-05 14:00:00,2022-01-05 15:00:00,59,0,49,8712,7824,16644,60449
2022-01-05 15:00:00,2022-01-05 16:00:00,62,0,5,8787,7769,16623,62690
2022-01-05 16:00:00,2022-01-05 17:00:00,61,0,4,8837,7341,16243,65027
2022-01-05 17:00:00,2022-01-05 18:00:00,62,0,4,8835,7050,15951,62286
2022-01-05 18:00:00,2022-01-05 19:00:00,63,0,4,8846,6783,15696,59793
2022-01-05 19:00:00,2022-01-05 20:00:00,63,0,4,8459,7035,15561,56930
2022-01-05 20:00:00,2022-01-05 21:00:00,63,0,4,7198,6484,13749,54108
2022-01-05 21:00:00,2022-01-05 22:00:00,64,0,4,6927,6221,13216,51647
2022-01-05 22:00:00,2022-01-05 23:00:00,64,0,4,5979,6189,12236,48823
2022-01-05 23:00:00,2022-01-06 00:00:00,62,0,4,7407,5706,13179,46607
2022-01-06 00:00:00,2022-01-06 01:00:00,64,0,4,5444,4432,9944,44926
2022-01-06 01:00:00,2022-01-06 02:00:00,64,0,4,4633,4219,8920,43936
2022-01-06 02:00:00,2022-01-06 03:00:00,62,0,4,4062,2672,6800,43617
2022-01-06 03:00:00,2022-01-06 04:00:00,63,0,4,3079,1839,4985,44290
2022-01-06 04:00:00,2022-01-06 05:00:00,61,0,4,1595,1593,3253,46569
2022-01-06 05:00:00,2022-01-06 06:00:00,60,0,4,1245,1061,2370,51235
2022-01-06 06:00:00,2022-01-06 07:00:00,61,0,4,1200,744,2009,57237
2022-01-06 07:00:00,2022-01-06 08:00:00,62,0,10,358,700,1130,60865
2022-01-06 08:00:00,2022-01-06 09:00:00,61,0,119,332,780,1292,59895
2022-01-06 09:00:00,2022-01-06 10:00:00,64,0,256,794,996,2110,56254
2022-01-06 10:00:00,2022-01-06 11:00:00,64,0,366,1409,991,2830,53946
2022-01-06 11:00:00,2022-01-06 12:00:00,61,0,425,2336,1479,4301,52892
2022-01-06 12:00:00,2022-01-06 13:00:00,61,0,373,2881,2020,5335,53562
2022-01-06 13:00:00,2022-01-06 14:00:00,61,0,222,3881,2094,6258,55745
2022-01-06 14:00:00,2022-01-06 15:00:00,60,0,73,5070,2837,8040,58746
2022-01-06 15:00:00,2022-01-06 16:00:00,64,0,4,6183,3054,9305,62312
2022-01-06 16:00:00,2022-01-06 17:00:00,62,0,4,7198,4304,11568,65345
2022-01-06 17:00:00,2022-01-06 18:00:00,62,0,4,8463,5306,13835,62671
2022-01-06 18:00:00,2022-01-06 19:00:00,62,0,4,8923,6854,15843,60087
2022-01-06 19:00:00,2022-01-06 20:00:00,64,0,4,8944,7455,16467,57242
2022-01-06 20:00:00,2022-01-06 21:00:00,63,0,4,8706,7734,16507,54355
2022-01-06 21:00:00,2022-01-06 22:00:00,61,0,4,8121,7861,16047,51176
2022-01-06 22:00:00,2022-01-06 23:00:00,63,0,4,8501,7888,16456,48467
2022-01-06 23:00:00,2022-01-07 00:00:00,63,0,4,8570,8116,16753,46534
2022-01-07 00:00:00,2022-01-07 01:00:00,63,0,4,8593,8098,16758,44996
2022-01-07 01:00:00,2022-01-07 02:00:00,64,0,4,8739,8060,16867,43913
2022-01-07 02:00:00,2022-01-07 03:00:00,64,0,4,7819,7980,15867,43252
2022-01-07 03:00:00,2022-01-07 04:00:00,64,0,4,8510,7624,16202,43937
2022-01-07 04:00:00,2022-01-07 05:00:00,61,0,4,8290,7526,15881,45972
2022-01-07 05:00:00,2022-01-07 06:00:00,60,0,4,8661,7208,15933,50094
2022-01-07 06:00:00,2022-01-07 07:00:00,62,0,4,8654,6503,15223,55364
2022-01-07 07:00:00,2022-01-07 08:00:00,62,0,4,8825,5779,14670,59510
2022-01-07 08:00:00,2022-01-07 09:00:00,63,0,44,8832,5536,14475,60270
2022-01-07 09:00:00,2022-01-07 10:00:00,64,0,112,8360,5756,14292,58822
2022-01-07 10:00:00,2022-01-07 11:00:00,63,0,162,7734,5959,13918,57216
2022-01-07 11:00:00,2022-01-07 12:00:00,62,0,223,7869,5827,13981,57208
2022-01-07 12:00:00,2022-01-07 13:00:00,62,0,234,8030,5942,14268,57496
2022-01-07 13:00:00,2022-01-07 14:00:00,61,0,136,8620,5185,14002,58620
2022-01-07 14:00:00,2022-01-07 15:00:00,61,0,47,8137,4951,13196,59952
2022-01-07 15:00:00,2022-01-07 16:00:00,62,0,6,7311,4489,11868,61849
2022-01-07 16:00:00,2022-01-07 17:00:00,63,0,4,6487,4217,10771,63875
2022-01-07 17:00:00,2022-01-07 18:00:00,63,0,4,6191,4185,10443,61344
2022-01-07 18:00:00,2022-01-07 19:00:00,63,0,4,5619,3855,9541,58692
2022-01-07 19:00:00,2022-01-07 20:00:00,64,0,4,5503,2502,8073,55978
2022-01-07 20:00:00,2022-01-07 21:00:00,64,0,4,5982,2426,8476,53240
2022-01-07 21:00:00,2022-01-07 22:00:00,63,0,4,5530,2280,7877,50276
2022-01-07 22:00:00,2022-01-07 23:00:00,63,0,4,5775,2679,8521,47876
2022-01-07 23:00:00,2022-01-08 00:00:00,64,0,4,5596,3194,8858,46441
2022-01-08 00:00:00,2022-01-08 01:00:00,64,0,4,5877,3027,8972,45103
2022-01-08 01:00:00,2022-01-08 02:00:00,63,0,4,4794,2359,7220,43938
2022-01-08 02:00:00,2022-01-08 03:00:00,65,0,4,3400,2521,5990,42972
2022-01-08 03:00:00,2022-01-08 04:00:00,64,0,4,2957,3301,6326,43129
2022-01-08 04:00:00,2022-01-08 05:00:00,64,0,4,3221,2820,6109,44362
2022-01-08 05:00:00,2022-01-08 06:00:00,64,0,4,2767,2967,5802,46133
2022-01-08 06:00:00,2022-01-08 07:00:00,64,0,4,2877,3665,6610,48407
2022-01-08 07:00:00,2022-01-08 08:00:00,64,0,11,4279,3687,8041,51083
2022-01-08 08:00:00,2022-01-08 09:00:00,64,0,107,5956,4275,10402,52765
2022-01-08 09:00:00,2022-01-08 10:00:00,64,0,220,8054,5494,13832,53386
2022-01-08 10:00:00,2022-01-08 11:00:00,64,0,260,8755,6551,15630,53587
2022-01-08 11:00:00,2022-01-08 12:00:00,64,0,240,8872,7202,16378,53954
2022-01-08 12:00:00,2022-01-08 13:00:00,64,0,152,8869,7549,16634,54699
2022-01-08 13:00:00,2022-01-08 14:00:00,64,0,84,8901,8213,17262,55728
2022-01-08 14:00:00,2022-01-08 15:00:00,64,0,19,8924,8518,17525,56287
2022-01-08 15:00:00,2022-01-08 16:00:00,63,0,3,8863,8576,17505,58088
2022-01-08 16:00:00,2022-01-08 17:00:00,64,0,4,8841,8619,17528,60536
2022-01-08 17:00:00,2022-01-08 18:00:00,64,0,4,8848,8551,17467,58553
2022-01-08 18:00:00,2022-01-08 19:00:00,65,0,4,8751,8152,16972,56189
2022-01-08 19:00:00,2022-01-08 20:00:00,64,0,4,7798,7665,15531,53161
2022-01-08 20:00:00,2022-01-08 21:00:00,65,0,4,8563,6983,15615,51056
2022-01-08 21:00:00,2022-01-08 22:00:00,66,0,4,8704,6990,15764,48901
2022-01-08 22:00:00,2022-01-08 23:00:00,64,0,4,8672,5821,14561,46830
2022-01-08 23:00:00,2022-01-09 00:00:00,64,0,4,7468,4286,11822,44718
2022-01-09 00:00:00,2022-01-09 01:00:00,65,0,4,8131,5982,14182,43657
2022-01-09 01:00:00,2022-01-09 02:00:00,64,0,4,7503,7518,15089,42827
2022-01-09 02:00:00,2022-01-09 03:00:00,64,0,4,8125,7758,15951,41823
2022-01-09 03:00:00,2022-01-09 04:00:00,63,0,4,8838,7752,16657,41723
2022-01-09 04:00:00,2022-01-09 05:00:00,64,0,4,8791,7625,16484,42409
2022-01-09 05:00:00,2022-01-09 06:00:00,64,0,4,8745,7309,16122,43688
2022-01-09 06:00:00,2022-01-09 07:00:00,64,0,4,8368,6910,15346,45764
2022-01-09 07:00:00,2022-01-09 08:00:00,62,0,5,8172,6108,14347,47644
2022-01-09 08:00:00,2022-01-09 09:00:00,62,0,61,8371,5561,14055,48748
2022-01-09 09:00:00,2022-01-09 10:00:00,64,0,162,7727,4891,12844,48586
2022-01-09 10:00:00,2022-01-09 11:00:00,64,0,241,6768,4358,11431,47980
2022-01-09 11:00:00,2022-01-09 12:00:00,64,0,286,6134,4001,10485,47366
2022-01-09 12:00:00,2022-01-09 13:00:00,65,0,266,4454,3735,8520,47128
2022-01-09 13:00:00,2022-01-09 14:00:00,64,0,184,3656,3538,7442,48044
2022-01-09 14:00:00,2022-01-09 15:00:00,64,0,90,2873,2885,5912,49958
2022-01-09 15:00:00,2022-01-09 16:00:00,64,0,7,2186,2484,4741,54013
2022-01-09 16:00:00,2022-01-09 17:00:00,64,0,4,2133,2161,4362,59212
2022-01-09 17:00:00,2022-01-09 18:00:00,66,0,4,1840,2083,3993,57664
2022-01-09 18:00:00,2022-01-09 19:00:00,64,0,4,1678,2144,3890,55799
2022-01-09 19:00:00,2022-01-09 20:00:00,66,0,4,1556,1992,3618,53644
2022-01-09 20:00:00,2022-01-09 21:00:00,66,0,4,1304,1201,2575,51308
2022-01-09 21:00:00,2022-01-09 22:00:00,67,0,4,939,878,1888,49131
2022-01-09 22:00:00,2022-01-09 23:00:00,64,0,4,463,760,1291,46626
2022-01-09 23:00:00,2022-01-10 00:00:00,65,0,4,473,709,1251,45132
2022-01-10 00:00:00,2022-01-10 01:00:00,64,0,4,214,768,1050,43895
2022-01-10 01:00:00,2022-01-10 02:00:00,64,0,4,132,729,929,43386
2022-01-10 02:00:00,2022-01-10 03:00:00,64,0,4,75,808,951,43203
2022-01-10 03:00:00,2022-01-10 04:00:00,64,0,4,124,881,1073,44050
2022-01-10 04:00:00,2022-01-10 05:00:00,39,0,4,103,779,925,46653
2022-01-10 05:00:00,2022-01-10 06:00:00,40,0,4,124,650,818,51887
2022-01-10 06:00:00,2022-01-10 07:00:00,38,0,4,283,569,894,59219
2022-01-10 07:00:00,2022-01-10 08:00:00,40,0,9,274,504,827,63708
2022-01-10 08:00:00,2022-01-10 09:00:00,40,0,94,317,481,932,63368
2022-01-10 09:00:00,2022-01-10 10:00:00,38,0,263,350,479,1130,60467
2022-01-10 10:00:00,2022-01-10 11:00:00,36,0,392,362,500,1290,57646
2022-01-10 11:00:00,2022-01-10 12:00:00,38,0,437,509,490,1474,56018
2022-01-10 12:00:00,2022-01-10 13:00:00,39,0,401,560,476,1476,55343
2022-01-10 13:00:00,2022-01-10 14:00:00,40,0,270,544,455,1309,56170
2022-01-10 14:00:00,2022-01-10 15:00:00,40,0,99,705,497,1341,59861
2022-01-10 15:00:00,2022-01-10 16:00:00,40,0,8,834,687,1569,63786
2022-01-10 16:00:00,2022-01-10 17:00:00,40,0,4,919,1094,2057,66666
2022-01-10 17:00:00,2022-01-10 18:00:00,40,0,4,1720,1210,2974,64047
2022-01-10 18:00:00,2022-01-10 19:00:00,40,0,4,1932,1190,3166,61655
2022-01-10 19:00:00,2022-01-10 20:00:00,44,0,4,2322,1193,3563,58648
2022-01-10 20:00:00,2022-01-10 21:00:00,41,0,4,2302,1340,3687,55600
2022-01-10 21:00:00,2022-01-10 22:00:00,41,0,4,2756,1509,4310,52490
2022-01-10 22:00:00,2022-01-10 23:00:00,40,0,4,3160,1670,4874,49466
2022-01-10 23:00:00,2022-01-11 00:00:00,40,0,4,3381,1816,5241,47487
2022-01-11 00:00:00,2022-01-11 01:00:00,41,0,4,3670,2301,6016,46124
2022-01-11 01:00:00,2022-01-11 02:00:00,40,0,4,3578,2239,5861,45464
2022-01-11 02:00:00,2022-01-11 03:00:00,19,0,4,4057,2078,6158,45187
2022-01-11 03:00:00,2022-01-11 04:00:00,7,0,4,4011,2021,6043,45806
2022-01-11 04:00:00,2022-01-11 05:00:00,6,0,4,3916,2021,5947,48116
2022-01-11 05:00:00,2022-01-11 06:00:00,7,0,4,4095,2168,6274,53687
2022-01-11 06:00:00,2022-01-11 07:00:00,8,0,4,4108,2318,6438,60847
2022-01-11 07:00:00,2022-01-11 08:00:00,7,0,33,3725,2540,6305,64084
2022-01-11 08:00:00,2022-01-11 09:00:00,5,0,156,4067,2723,6951,63545
2022-01-11 09:00:00,2022-01-11 10:00:00,7,0,199,4191,2924,7321,60977
2022-01-11 10:00:00,2022-01-11 11:00:00,8,0,295,4235,2743,7281,58366
2022-01-11 11:00:00,2022-01-11 12:00:00,6,0,439,3847,2329,6621,56213
2022-01-11 12:00:00,2022-01-11 13:00:00,6,0,354,3830,2212,6402,57002
2022-01-11 13:00:00,2022-01-11 14:00:00,12,0,137,3410,1966,5525,58053
2022-01-11 14:00:00,2022-01-11 15:00:00,12,0,63,3221,1910,5206,60762
2022-01-11 15:00:00,2022-01-11 16:00:00,12,0,7,2992,1917,4928,63944
2022-01-11 16:00:00,2022-01-11 17:00:00,12,0,4,2932,1974,4922,67236
2022-01-11 17:00:00,2022-01-11 18:00:00,12,0,4,2826,2187,5029,64483
2022-01-11 18:00:00,2022-01-11 19:00:00,12,0,4,1935,2208,4159,61745
2022-01-11 19:00:00,2022-01-11 20:00:00,13,0,4,1228,1941,3186,58320
2022-01-11 20:00:00,2022-01-11 21:00:00,9,0,4,1048,1694,2755,55529
2022-01-11 21:00:00,2022-01-11 22:00:00,47,0,4,865,1427,2343,52417
2022-01-11 22:00:00,2022-01-11 23:00:00,130,0,4,815,1251,2200,49631
2022-01-11 23:00:00,2022-01-12 00:00:00,177,0,4,372,1090,1643,47343
2022-01-12 00:00:00,2022-01-12 01:00:00,176,0,4,360,770,1310,45882
2022-01-12 01:00:00,2022-01-12 02:00:00,176,0,4,520,901,1601,45020
2022-01-12 02:00:00,2022-01-12 03:00:00,169,0,4,855,597,1625,45045
2022-01-12 03:00:00,2022-01-12 04:00:00,129,0,4,862,437,1432,45714
2022-01-12 04:00:00,2022-01-12 05:00:00,120,0,4,781,432,1337,47920
2022-01-12 05:00:00,2022-01-12 06:00:00,121,0,4,830,521,1476,53118
2022-01-12 06:00:00,2022-01-12 07:00:00,122,0,4,734,457,1317,60004
2022-01-12 07:00:00,2022-01-12 08:00:00,121,0,10,593,399,1123,64547
2022-01-12 08:00:00,2022-01-12 09:00:00,121,0,67,544,458,1190,64579
2022-01-12 09:00:00,2022-01-12 10:00:00,122,0,142,614,502,1380,62658
2022-01-12 10:00:00,2022-01-12 11:00:00,121,0,174,605,620,1520,61205
2022-01-12 11:00:00,2022-01-12 12:00:00,121,0,181,772,719,1793,60078
2022-01-12 12:00:00,2022-01-12 13:00:00,122,0,174,709,804,1809,60336
2022-01-12 13:00:00,2022-01-12 14:00:00,121,0,117,892,784,1914,61193
2022-01-12 14:00:00,2022-01-12 15:00:00,122,0,51,1044,1182,2399,62342
2022-01-12 15:00:00,2022-01-12 16:00:00,123,0,4,1112,1346,2585,64585
2022-01-12 16:00:00,2022-01-12 17:00:00,127,0,4,1020,1314,2465,67251
2022-01-12 17:00:00,2022-01-12 18:00:00,126,0,4,864,1205,2199,64476
2022-01-12 18:00:00,2022-01-12 19:00:00,112,0,4,1076,1171,2363,61842
2022-01-12 19:00:00,2022-01-12 20:00:00,73,0,4,1260,1380,2717,58721
2022-01-12 20:00:00,2022-01-12 21:00:00,69,0,4,1258,1525,2856,55830
2022-01-12 21:00:00,2022-01-12 22:00:00,68,0,4,1250,1780,3102,52349
2022-01-12 22:00:00,2022-01-12 23:00:00,52,0,4,1637,1883,3576,49369
2022-01-12 23:00:00,2022-01-13 00:00:00,40,0,4,1524,2043,3611,47151
2022-01-13 00:00:00,2022-01-13 01:00:00,41,0,4,1812,1981,3838,45518
2022-01-13 01:00:00,2022-01-13 02:00:00,42,0,4,1823,2007,3876,44861
2022-01-13 02:00:00,2022-01-13 03:00:00,40,0,4,1716,2204,3964,44708
2022-01-13 03:00:00,2022-01-13 04:00:00,42,0,4,1573,2354,3973,45240
2022-01-13 04:00:00,2022-01-13 05:00:00,44,0,4,1664,2355,4067,47498
2022-01-13 05:00:00,2022-01-13 06:00:00,43,0,4,1939,2527,4513,52813
2022-01-13 06:00:00,2022-01-13 07:00:00,43,0,4,2037,2597,4681,60249
2022-01-13 07:00:00,2022-01-13 08:00:00,43,0,4,2146,2350,4543,64439
2022-01-13 08:00:00,2022-01-13 09:00:00,41,0,26,2074,2319,4460,64834
2022-01-13 09:00:00,2022-01-13 10:00:00,41,0,61,1979,2737,4818,63751
2022-01-13 10:00:00,2022-01-13 11:00:00,44,0,96,2124,2644,4908,63052
2022-01-13 11:00:00,2022-01-13 12:00:00,43,0,95,2179,3122,5439,61934
2022-01-13 12:00:00,2022-01-13 13:00:00,44,0,84,1877,3322,5327,61813
2022-01-13 13:00:00,2022-01-13 14:00:00,44,0,74,1969,3444,5531,61946
2022-01-13 14:00:00,2022-01-13 15:00:00,40,0,39,2640,3320,6039,62985
2022-01-13 15:00:00,2022-01-13 16:00:00,40,0,4,2156,3389,5589,64671
2022-01-13 16:00:00,2022-01-13 17:00:00,43,0,4,1911,3325,5283,67246
2022-01-13 17:00:00,2022-01-13 18:00:00,44,0,4,2230,3024,5302,64666
2022-01-13 18:00:00,2022-01-13 19:00:00,44,0,4,2377,2656,5081,61722
2022-01-13 19:00:00,2022-01-13 20:00:00,44,0,4,2644,2514,5206,58326
2022-01-13 20:00:00,2022-01-13 21:00:00,44,0,4,2626,2841,5515,55203
2022-01-13 21:00:00,2022-01-13 22:00:00,43,0,4,2512,3159,5718,52075
2022-01-13 22:00:00,2022-01-13 23:00:00,44,0,4,3087,2768,5903,49465
2022-01-13 23:00:00,2022-01-14 00:00:00,44,0,4,3364,2572,5984,47465
2022-01-14 00:00:00,2022-01-14 01:00:00,44,0,4,3233,2232,5513,46195
2022-01-14 01:00:00,2022-01-14 02:00:00,42,0,4,3043,1915,5004,45366
2022-01-14 02:00:00,2022-01-14 03:00:00,44,0,4,3455,2105,5608,45174
2022-01-14 03:00:00,2022-01-14 04:00:00,44,0,4,3195,1965,5208,45689
2022-01-14 04:00:00,2022-01-14 05:00:00,43,0,4,2511,1797,4355,48005
2022-01-14 05:00:00,2022-01-14 06:00:00,41,0,4,2343,1615,4003,53461
2022-01-14 06:00:00,2022-01-14 07:00:00,40,0,4,1947,2091,4082,60293
2022-01-14 07:00:00,2022-01-14 08:00:00,40,0,3,1856,1778,3677,64046
2022-01-14 08:00:00,2022-01-14 09:00:00,40,0,38,1637,1263,2978,64963
2022-01-14 09:00:00,2022-01-14 10:00:00,40,0,100,1080,892,2112,64222
2022-01-14 10:00:00,2022-01-14 11:00:00,40,0,118,773,778,1709,63149
2022-01-14 11:00:00,2022-01-14 12:00:00,40,0,107,729,768,1644,62672
2022-01-14 12:00:00,2022-01-14 13:00:00,43,0,83,366,631,1123,62700
2022-01-14 13:00:00,2022-01-14 14:00:00,43,0,59,374,560,1036,62924
2022-01-14 14:00:00,2022-01-14 15:00:00,41,0,26,236,445,748,62976
2022-01-14 15:00:00,2022-01-14 16:00:00,40,0,8,133,393,574,64041
2022-01-14 16:00:00,2022-01-14 17:00:00,40,0,8,120,371,539,66196
2022-01-14 17:00:00,2022-01-14 18:00:00,41,0,8,102,396,547,63597
2022-01-14 18:00:00,2022-01-14 19:00:00,44,0,8,83,419,554,60363
2022-01-14 19:00:00,2022-01-14 20:00:00,42,0,8,81,402,533,57313
2022-01-14 20:00:00,2022-01-14 21:00:00,43,0,8,102,373,526,54436
2022-01-14 21:00:00,2022-01-14 22:00:00,44,0,8,97,363,512,51598
2022-01-14 22:00:00,2022-01-14 23:00:00,41,0,8,86,365,500,49112
2022-01-14 23:00:00,2022-01-15 00:00:00,40,0,8,117,392,557,46837
2022-01-15 00:00:00,2022-01-15 01:00:00,40,0,8,221,407,676,45188
2022-01-15 01:00:00,2022-01-15 02:00:00,44,0,8,228,508,788,44593
2022-01-15 02:00:00,2022-01-15 03:00:00,41,0,8,392,555,996,43900
2022-01-15 03:00:00,2022-01-15 04:00:00,40,0,8,491,605,1144,43872
2022-01-15 04:00:00,2022-01-15 05:00:00,40,0,8,737,678,1463,44493
2022-01-15 05:00:00,2022-01-15 06:00:00,40,0,8,956,792,1796,46246
2022-01-15 06:00:00,2022-01-15 07:00:00,40,0,8,893,943,1884,49378
2022-01-15 07:00:00,2022-01-15 08:00:00,40,0,7,868,1142,2057,53057
2022-01-15 08:00:00,2022-01-15 09:00:00,40,0,29,744,1132,1945,55895
2022-01-15 09:00:00,2022-01-15 10:00:00,40,0,74,782,1102,1998,56459
2022-01-15 10:00:00,2022-01-15 11:00:00,40,0,94,832,1196,2162,56599
2022-01-15 11:00:00,2022-01-15 12:00:00,39,0,104,695,1192,2030,56235
2022-01-15 12:00:00,2022-01-15 13:00:00,40,0,99,753,1305,2197,55693
2022-01-15 13:00:00,2022-01-15 14:00:00,40,0,72,700,1233,2045,55572
2022-01-15 14:00:00,2022-01-15 15:00:00,39,0,29,823,962,1853,55822
2022-01-15 15:00:00,2022-01-15 16:00:00,40,0,6,942,884,1872,57651
2022-01-15 16:00:00,2022-01-15 17:00:00,40,0,4,901,1079,2024,60824
2022-01-15 17:00:00,2022-01-15 18:00:00,44,0,4,966,1070,2084,59169
2022-01-15 18:00:00,2022-01-15 19:00:00,41,0,4,1167,1016,2228,56737
2022-01-15 19:00:00,2022-01-15 20:00:00,43,0,4,1674,1111,2832,54277
2022-01-15 20:00:00,2022-01-15 21:00:00,40,0,4,1834,947,2825,52162
2022-01-15 21:00:00,2022-01-15 22:00:00,40,0,4,1614,846,2504,49838
2022-01-15 22:00:00,2022-01-15 23:00:00,40,0,4,1659,1074,2777,47355
2022-01-15 23:00:00,2022-01-16 00:00:00,40,0,4,2800,1379,4223,44875
2022-01-16 00:00:00,2022-01-16 01:00:00,42,0,4,3654,1585,5285,43777
2022-01-16 01:00:00,2022-01-16 02:00:00,43,0,4,5249,2048,7344,43229
2022-01-16 02:00:00,2022-01-16 03:00:00,42,0,4,6453,2542,9041,42893
2022-01-16 03:00:00,2022-01-16 04:00:00,44,0,4,5053,2904,8005,42688
2022-01-16 04:00:00,2022-01-16 05:00:00,42,0,4,4108,3760,7914,42853
2022-01-16 05:00:00,2022-01-16 06:00:00,40,0,4,4339,3827,8210,43794
2022-01-16 06:00:00,2022-01-16 07:00:00,40,0,4,3808,4171,8023,45587
2022-01-16 07:00:00,2022-01-16 08:00:00,42,0,4,3520,3950,7516,47878
2022-01-16 08:00:00,2022-01-16 09:00:00,40,0,35,3387,4165,7627,50163
2022-01-16 09:00:00,2022-01-16 10:00:00,40,0,89,2660,4368,7157,50883
2022-01-16 10:00:00,2022-01-16 11:00:00,40,0,90,3452,4564,8146,51880
2022-01-16 11:00:00,2022-01-16 12:00:00,40,0,88,4124,5047,9299,52495
2022-01-16 12:00:00,2022-01-16 13:00:00,40,0,77,4774,5701,10592,52517
2022-01-16 13:00:00,2022-01-16 14:00:00,40,0,52,4719,5060,9871,52405
2022-01-16 14:00:00,2022-01-16 15:00:00,40,0,35,4103,4286,8464,52845
2022-01-16 15:00:00,2022-01-16 16:00:00,41,0,5,3891,3854,7791,54883
2022-01-16 16:00:00,2022-01-16 17:00:00,42,0,4,4068,4412,8526,59159
2022-01-16 17:00:00,2022-01-16 18:00:00,43,0,4,4421,4395,8863,57967
2022-01-16 18:00:00,2022-01-16 19:00:00,44,0,4,3639,4172,7859,55862
2022-01-16 19:00:00,2022-01-16 20:00:00,43,0,4,4464,4197,8708,53237
2022-01-16 20:00:00,2022-01-16 21:00:00,44,0,4,4409,4325,8782,50987
2022-01-16 21:00:00,2022-01-16 22:00:00,42,0,4,3757,4286,8089,48442
2022-01-16 22:00:00,2022-01-16 23:00:00,40,0,4,2947,4472,7463,46040
2022-01-16 23:00:00,2022-01-17 00:00:00,42,0,4,2805,4282,7133,44616
2022-01-17 00:00:00,2022-01-17 01:00:00,43,0,4,3084,4569,7700,43473
2022-01-17 01:00:00,2022-01-17 02:00:00,44,0,4,3411,4706,8165,42790
2022-01-17 02:00:00,2022-01-17 03:00:00,44,0,4,3647,5012,8707,42836
2022-01-17 03:00:00,2022-01-17 04:00:00,44,0,4,3273,5528,8849,43633
2022-01-17 04:00:00,2022-01-17 05:00:00,42,0,4,4145,5788,9979,46022
2022-01-17 05:00:00,2022-01-17 06:00:00,40,0,4,3948,5954,9946,51296
2022-01-17 06:00:00,2022-01-17 07:00:00,40,0,4,3821,5952,9817,58114
2022-01-17 07:00:00,2022-01-17 08:00:00,40,0,7,4257,6094,10398,62250
2022-01-17 08:00:00,2022-01-17 09:00:00,40,0,40,4171,5883,10134,62775
2022-01-17 09:00:00,2022-01-17 10:00:00,40,0,139,4233,5735,10147,61468
2022-01-17 10:00:00,2022-01-17 11:00:00,40,0,200,4311,5832,10383,60274
2022-01-17 11:00:00,2022-01-17 12:00:00,40,0,173,4322,5690,10225,59545
2022-01-17 12:00:00,2022-01-17 13:00:00,40,0,210,4199,5784,10233,58868
2022-01-17 13:00:00,2022-01-17 14:00:00,40,0,162,4046,5757,10005,58372
2022-01-17 14:00:00,2022-01-17 15:00:00,40,0,74,3439,5482,9035,59956
2022-01-17 15:00:00,2022-01-17 16:00:00,40,0,7,2564,4736,7347,62908
2022-01-17 16:00:00,2022-01-17 17:00:00,40,0,4,2768,4280,7092,66135
2022-01-17 17:00:00,2022-01-17 18:00:00,40,0,4,2528,3827,6399,63985
2022-01-17 18:00:00,2022-01-17 19:00:00,40,0,4,2116,3308,5468,61503
2022-01-17 19:00:00,2022-01-17 20:00:00,40,0,4,1584,2273,3901,58369
2022-01-17 20:00:00,2022-01-17 21:00:00,40,0,4,1237,1636,2917,55240
2022-01-17 21:00:00,2022-01-17 22:00:00,40,0,4,1040,1700,2784,51893
2022-01-17 22:00:00,2022-01-17 23:00:00,40,0,4,906,1739,2689,49138
2022-01-17 23:00:00,2022-01-18 00:00:00,41,0,4,1012,1781,2838,46968
2022-01-18 00:00:00,2022-01-18 01:00:00,42,0,4,1063,1641,2750,45649
2022-01-18 01:00:00,2022-01-18 02:00:00,43,0,4,1051,1364,2462,45058
2022-01-18 02:00:00,2022-01-18 03:00:00,43,0,4,1215,1059,2321,44824
2022-01-18 03:00:00,2022-01-18 04:00:00,41,0,4,794,864,1703,45450
2022-01-18 04:00:00,2022-01-18 05:00:00,42,0,4,463,490,999,47548
2022-01-18 05:00:00,2022-01-18 06:00:00,40,0,4,241,381,666,52841
2022-01-18 06:00:00,2022-01-18 07:00:00,40,0,4,94,372,510,59909
2022-01-18 07:00:00,2022-01-18 08:00:00,42,0,7,184,338,571,64094
2022-01-18 08:00:00,2022-01-18 09:00:00,41,0,51,514,405,1011,64426
2022-01-18 09:00:00,2022-01-18 10:00:00,41,0,127,866,661,1695,62990
2022-01-18 10:00:00,2022-01-18 11:00:00,44,0,209,1251,695,2199,61375
2022-01-18 11:00:00,2022-01-18 12:00:00,40,0,197,1201,639,2077,60095
2022-01-18 12:00:00,2022-01-18 13:00:00,40,0,159,1139,801,2139,59519
2022-01-18 13:00:00,2022-01-18 14:00:00,40,0,131,1350,876,2397,59825
2022-01-18 14:00:00,2022-01-18 15:00:00,40,0,100,1254,932,2326,61422
2022-01-18 15:00:00,2022-01-18 16:00:00,40,0,10,1119,962,2131,64154
2022-01-18 16:00:00,2022-01-18 17:00:00,38,0,4,1106,862,2010,66816
2022-01-18 17:00:00,2022-01-18 18:00:00,40,0,4,1181,725,1950,64695
2022-01-18 18:00:00,2022-01-18 19:00:00,40,0,4,1120,918,2082,62339
2022-01-18 19:00:00,2022-01-18 20:00:00,40,0,4,1232,1078,2354,59096
2022-01-18 20:00:00,2022-01-18 21:00:00,40,0,4,1492,1012,2548,56091
2022-01-18 21:00:00,2022-01-18 22:00:00,40,0,4,1451,918,2413,52714
2022-01-18 22:00:00,2022-01-18 23:00:00,40,0,4,1698,1041,2783,49645
2022-01-18 23:00:00,2022-01-19 00:00:00,40,0,4,2340,1042,3426,47394
2022-01-19 00:00:00,2022-01-19 01:00:00,40,0,4,2556,1054,3654,45759
2022-01-19 01:00:00,2022-01-19 02:00:00,40,0,4,2802,1438,4284,44834
2022-01-19 02:00:00,2022-01-19 03:00:00,40,0,4,2656,1666,4366,44664
2022-01-19 03:00:00,2022-01-19 04:00:00,40,0,4,2912,1604,4560,45275
2022-01-19 04:00:00,2022-01-19 05:00:00,40,0,4,3280,1578,4902,47521
2022-01-19 05:00:00,2022-01-19 06:00:00,40,0,4,3416,1774,5234,52866
2022-01-19 06:00:00,2022-01-19 07:00:00,39,0,4,4323,1922,6288,60187
2022-01-19 07:00:00,2022-01-19 08:00:00,37,0,3,4612,2466,7118,64358
2022-01-19 08:00:00,2022-01-19 09:00:00,36,0,23,5066,3062,8187,65819
2022-01-19 09:00:00,2022-01-19 10:00:00,38,0,87,5425,3723,9273,65589
2022-01-19 10:00:00,2022-01-19 11:00:00,40,0,79,6007,4329,10455,64530
2022-01-19 11:00:00,2022-01-19 12:00:00,40,0,80,6555,4756,11431,63529
2022-01-19 12:00:00,2022-01-19 13:00:00,40,0,64,6796,5197,12097,63928
2022-01-19 13:00:00,2022-01-19 14:00:00,40,0,58,7223,5648,12969,63835
2022-01-19 14:00:00,2022-01-19 15:00:00,40,0,17,7833,5751,13641,64344
2022-01-19 15:00:00,2022-01-19 16:00:00,40,0,3,8959,5955,14957,65615
2022-01-19 16:00:00,2022-01-19 17:00:00,41,0,4,8966,6268,15279,67478
2022-01-19 17:00:00,2022-01-19 18:00:00,42,0,4,8712,6265,15023,64509
2022-01-19 18:00:00,2022-01-19 19:00:00,41,0,4,8888,6221,15154,61848
2022-01-19 19:00:00,2022-01-19 20:00:00,44,0,4,8928,6085,15061,58605
2022-01-19 20:00:00,2022-01-19 21:00:00,41,0,4,8863,5871,14779,55543
2022-01-19 21:00:00,2022-01-19 22:00:00,40,0,4,8416,5906,14366,52236
2022-01-19 22:00:00,2022-01-19 23:00:00,40,0,4,7379,5482,12905,48905
2022-01-19 23:00:00,2022-01-20 00:00:00,40,0,4,7949,5960,13953,46783
2022-01-20 00:00:00,2022-01-20 01:00:00,41,0,4,7766,6486,14297,45068
2022-01-20 01:00:00,2022-01-20 02:00:00,40,0,4,8974,6753,15771,44512
2022-01-20 02:00:00,2022-01-20 03:00:00,40,0,4,8941,6687,15672,44452
2022-01-20 03:00:00,2022-01-20 04:00:00,41,0,4,9031,6938,16014,45073
2022-01-20 04:00:00,2022-01-20 05:00:00,41,0,4,8700,7157,15902,47470
2022-01-20 05:00:00,2022-01-20 06:00:00,40,0,4,8561,7146,15751,52334
2022-01-20 06:00:00,2022-01-20 07:00:00,40,0,4,8850,6721,15615,59325
2022-01-20 07:00:00,2022-01-20 08:00:00,40,0,13,8653,6214,14920,63146
2022-01-20 08:00:00,2022-01-20 09:00:00,40,0,118,8190,5764,14112,62638
2022-01-20 09:00:00,2022-01-20 10:00:00,40,0,289,8699,5865,14893,60177
2022-01-20 10:00:00,2022-01-20 11:00:00,40,0,315,9001,6447,15803,58002
2022-01-20 11:00:00,2022-01-20 12:00:00,40,0,373,8674,6423,15510,56416
2022-01-20 12:00:00,2022-01-20 13:00:00,40,0,409,8842,6540,15831,56655
2022-01-20 13:00:00,2022-01-20 14:00:00,40,0,243,9083,6816,16182,58461
2022-01-20 14:00:00,2022-01-20 15:00:00,40,0,87,8881,6659,15667,60531
2022-01-20 15:00:00,2022-01-20 16:00:00,42,0,17,8792,6645,15496,63215
2022-01-20 16:00:00,2022-01-20 17:00:00,40,0,4,8443,6392,14879,66557
2022-01-20 17:00:00,2022-01-20 18:00:00,40,0,4,8488,6004,14536,64959
2022-01-20 18:00:00,2022-01-20 19:00:00,43,0,4,8355,5512,13914,62216
2022-01-20 19:00:00,2022-01-20 20:00:00,40,0,4,8510,5534,14088,59313
2022-01-20 20:00:00,2022-01-20 21:00:00,43,0,4,7690,5285,13022,56182
2022-01-20 21:00:00,2022-01-20 22:00:00,40,0,4,7925,4229,12198,52848
2022-01-20 22:00:00,2022-01-20 23:00:00,40,0,4,6495,3430,9969,49755
2022-01-20 23:00:00,2022-01-21 00:00:00,41,0,4,6332,3272,9649,46977
2022-01-21 00:00:00,2022-01-21 01:00:00,40,0,4,7075,3550,10669,45932
2022-01-21 01:00:00,2022-01-21 02:00:00,42,0,4,6356,3235,9637,45002
2022-01-21 02:00:00,2022-01-21 03:00:00,40,0,4,5695,3596,9335,44577
2022-01-21 03:00:00,2022-01-21 04:00:00,40,0,4,5650,3004,8698,44928
2022-01-21 04:00:00,2022-01-21 05:00:00,40,0,4,5538,3000,8582,47168
2022-01-21 05:00:00,2022-01-21 06:00:00,40,0,4,5663,2932,8639,52519
2022-01-21 06:00:00,2022-01-21 07:00:00,39,0,4,5281,3091,8415,59685
2022-01-21 07:00:00,2022-01-21 08:00:00,40,0,11,4537,3010,7598,63504
2022-01-21 08:00:00,2022-01-21 09:00:00,40,0,108,4855,3337,8340,62413
2022-01-21 09:00:00,2022-01-21 10:00:00,40,0,132,5243,3760,9175,60183
2022-01-21 10:00:00,2022-01-21 11:00:00,40,0,171,5186,3716,9113,59256
2022-01-21 11:00:00,2022-01-21 12:00:00,40,0,164,5002,4128,9334,59561
2022-01-21 12:00:00,2022-01-21 13:00:00,40,0,125,4834,4550,9549,60583
2022-01-21 13:00:00,2022-01-21 14:00:00,40,0,91,4390,4432,8953,60930
2022-01-21 14:00:00,2022-01-21 15:00:00,40,0,48,4302,4510,8900,61095
2022-01-21 15:00:00,2022-01-21 16:00:00,40,0,11,4438,4297,8786,62514
2022-01-21 16:00:00,2022-01-21 17:00:00,40,0,4,4478,4485,9007,65284
2022-01-21 17:00:00,2022-01-21 18:00:00,40,0,4,4560,4343,8947,62894
2022-01-21 18:00:00,2022-01-21 19:00:00,40,0,4,4760,4358,9162,59968
2022-01-21 19:00:00,2022-01-21 20:00:00,40,0,4,5410,4560,10014,56802
2022-01-21 20:00:00,2022-01-21 21:00:00,40,0,4,5551,4160,9755,53762
2022-01-21 21:00:00,2022-01-21 22:00:00,40,0,4,5213,4006,9263,50796
2022-01-21 22:00:00,2022-01-21 23:00:00,40,0,4,5305,3980,9329,48343
2022-01-21 23:00:00,2022-01-22 00:00:00,41,0,4,4038,3797,7880,45925
2022-01-22 00:00:00,2022-01-22 01:00:00,41,0,4,3394,3836,7275,43972
2022-01-22 01:00:00,2022-01-22 02:00:00,41,0,4,3096,3520,6661,42997
2022-01-22 02:00:00,2022-01-22 03:00:00,40,0,4,2651,2944,5639,42462
2022-01-22 03:00:00,2022-01-22 04:00:00,40,0,4,2549,2400,4993,42393
2022-01-22 04:00:00,2022-01-22 05:00:00,40,0,4,2109,2229,4382,43214
2022-01-22 05:00:00,2022-01-22 06:00:00,40,0,4,2331,2405,4780,45347
2022-01-22 06:00:00,2022-01-22 07:00:00,40,0,4,1979,2490,4513,48806
2022-01-22 07:00:00,2022-01-22 08:00:00,40,0,8,1594,2271,3913,51725
2022-01-22 08:00:00,2022-01-22 09:00:00,40,0,54,1240,1996,3330,54181
2022-01-22 09:00:00,2022-01-22 10:00:00,40,0,125,828,2116,3109,55473
2022-01-22 10:00:00,2022-01-22 11:00:00,40,0,162,835,2037,3074,55722
2022-01-22 11:00:00,2022-01-22 12:00:00,40,0,120,1031,2201,3392,55562
2022-01-22 12:00:00,2022-01-22 13:00:00,40,0,85,1117,2080,3322,55290
2022-01-22 13:00:00,2022-01-22 14:00:00,40,0,71,1026,1986,3123,55089
2022-01-22 14:00:00,2022-01-22 15:00:00,40,0,38,835,1883,2796,55083
2022-01-22 15:00:00,2022-01-22 16:00:00,40,0,8,1107,1760,2915,56510
2022-01-22 16:00:00,2022-01-22 17:00:00,40,0,4,946,1632,2622,59461
2022-01-22 17:00:00,2022-01-22 18:00:00,40,0,4,735,1466,2245,58230
2022-01-22 18:00:00,2022-01-22 19:00:00,42,0,4,459,1386,1891,56009
2022-01-22 19:00:00,2022-01-22 20:00:00,44,0,4,484,1160,1692,53081
2022-01-22 20:00:00,2022-01-22 21:00:00,44,0,4,425,858,1331,50581
2022-01-22 21:00:00,2022-01-22 22:00:00,44,0,4,600,788,1436,48426
2022-01-22 22:00:00,2022-01-22 23:00:00,42,0,4,470,633,1149,46531
2022-01-22 23:00:00,2022-01-23 00:00:00,42,0,4,278,536,860,44913
2022-01-23 00:00:00,2022-01-23 01:00:00,42,0,4,238,446,730,43537
2022-01-23 01:00:00,2022-01-23 02:00:00,43,0,4,206,456,709,42612
2022-01-23 02:00:00,2022-01-23 03:00:00,42,0,4,140,421,607,42176
2022-01-23 03:00:00,2022-01-23 04:00:00,40,0,4,93,434,571,42298
2022-01-23 04:00:00,2022-01-23 05:00:00,40,0,4,100,428,572,42723
2022-01-23 05:00:00,2022-01-23 06:00:00,40,0,4,103,416,563,43618
2022-01-23 06:00:00,2022-01-23 07:00:00,40,0,4,152,417,613,45654
2022-01-23 07:00:00,2022-01-23 08:00:00,40,0,12,166,405,623,48183
2022-01-23 08:00:00,2022-01-23 09:00:00,40,0,77,211,408,736,50528
2022-01-23 09:00:00,2022-01-23 10:00:00,40,0,150,256,398,844,51204
2022-01-23 10:00:00,2022-01-23 11:00:00,40,0,196,230,432,898,51476
2022-01-23 11:00:00,2022-01-23 12:00:00,41,0,164,229,483,917,51621
2022-01-23 12:00:00,2022-01-23 13:00:00,41,0,117,261,570,989,51503
2022-01-23 13:00:00,2022-01-23 14:00:00,41,0,77,305,570,993,51896
2022-01-23 14:00:00,2022-01-23 15:00:00,42,0,30,189,471,732,52531
2022-01-23 15:00:00,2022-01-23 16:00:00,40,0,5,143,397,585,54525
2022-01-23 16:00:00,2022-01-23 17:00:00,40,0,4,171,408,623,58966
2022-01-23 17:00:00,2022-01-23 18:00:00,44,0,4,303,531,882,57518
2022-01-23 18:00:00,2022-01-23 19:00:00,42,0,4,490,552,1088,55278
2022-01-23 19:00:00,2022-01-23 20:00:00,44,0,4,592,511,1151,52954
2022-01-23 20:00:00,2022-01-23 21:00:00,41,0,4,738,507,1290,50962
2022-01-23 21:00:00,2022-01-23 22:00:00,40,0,4,658,501,1203,48653
2022-01-23 22:00:00,2022-01-23 23:00:00,40,0,4,718,481,1243,46289
2022-01-23 23:00:00,2022-01-24 00:00:00,40,0,4,1019,499,1562,44870
2022-01-24 00:00:00,2022-01-24 01:00:00,43,0,4,1207,535,1789,43915
2022-01-24 01:00:00,2022-01-24 02:00:00,43,0,4,1054,518,1619,43413
2022-01-24 02:00:00,2022-01-24 03:00:00,44,0,4,1037,468,1553,43290
2022-01-24 03:00:00,2022-01-24 04:00:00,44,0,4,964,401,1413,44199
2022-01-24 04:00:00,2022-01-24 05:00:00,42,0,4,831,384,1261,47068
2022-01-24 05:00:00,2022-01-24 06:00:00,40,0,4,743,379,1166,52173
2022-01-24 06:00:00,2022-01-24 07:00:00,40,0,4,625,359,1028,59297
2022-01-24 07:00:00,2022-01-24 08:00:00,41,0,4,574,358,977,64025
2022-01-24 08:00:00,2022-01-24 09:00:00,44,0,28,525,358,955,64882
2022-01-24 09:00:00,2022-01-24 10:00:00,44,0,59,576,365,1044,63624
2022-01-24 10:00:00,2022-01-24 11:00:00,40,0,83,525,347,995,62008
2022-01-24 11:00:00,2022-01-24 12:00:00,40,0,97,529,352,1018,61026
2022-01-24 12:00:00,2022-01-24 13:00:00,40,0,87,550,366,1043,60899
2022-01-24 13:00:00,2022-01-24 14:00:00,40,0,65,429,369,903,61182
2022-01-24 14:00:00,2022-01-24 15:00:00,40,0,33,309,367,749,62337
2022-01-24 15:00:00,2022-01-24 16:00:00,40,0,6,259,360,665,64072
2022-01-24 16:00:00,2022-01-24 17:00:00,40,0,4,262,356,662,67371
2022-01-24 17:00:00,2022-01-24 18:00:00,40,0,4,224,382,650,64949
2022-01-24 18:00:00,2022-01-24 19:00:00,40,0,4,174,404,622,62199
2022-01-24 19:00:00,2022-01-24 20:00:00,40,0,4,158,419,621,58995
2022-01-24 20:00:00,2022-01-24 21:00:00,40,0,4,165,462,671,55828
2022-01-24 21:00:00,2022-01-24 22:00:00,40,0,4,239,447,730,52696
2022-01-24 22:00:00,2022-01-24 23:00:00,40,0,4,220,396,660,49722
2022-01-24 23:00:00,2022-01-25 00:00:00,40,0,4,186,415,645,47327
2022-01-25 00:00:00,2022-01-25 01:00:00,40,0,4,90,420,554,46004
2022-01-25 01:00:00,2022-01-25 02:00:00,41,0,4,95,398,538,45478
2022-01-25 02:00:00,2022-01-25 03:00:00,41,0,4,74,395,514,45254
2022-01-25 03:00:00,2022-01-25 04:00:00,40,0,4,69,394,507,45947
2022-01-25 04:00:00,2022-01-25 05:00:00,40,0,4,82,376,502,48574
2022-01-25 05:00:00,2022-01-25 06:00:00,40,0,4,81,369,494,53724
2022-01-25 06:00:00,2022-01-25 07:00:00,40,0,4,85,359,488,60406
2022-01-25 07:00:00,2022-01-25 08:00:00,40,0,3,104,345,492,64247
2022-01-25 08:00:00,2022-01-25 09:00:00,40,0,16,94,334,484,65236
2022-01-25 09:00:00,2022-01-25 10:00:00,40,0,41,89,373,543,65066
2022-01-25 10:00:00,2022-01-25 11:00:00,40,0,59,85,379,563,64265
2022-01-25 11:00:00,2022-01-25 12:00:00,40,0,69,105,393,607,63664
2022-01-25 12:00:00,2022-01-25 13:00:00,40,0,77,157,465,739,63430
2022-01-25 13:00:00,2022-01-25 14:00:00,40,0,59,149,489,737,63146
2022-01-25 14:00:00,2022-01-25 15:00:00,40,0,30,176,461,707,63613
2022-01-25 15:00:00,2022-01-25 16:00:00,40,0,5,279,488,812,64918
2022-01-25 16:00:00,2022-01-25 17:00:00,40,0,4,300,566,910,67329
2022-01-25 17:00:00,2022-01-25 18:00:00,40,0,4,344,542,930,64883
2022-01-25 18:00:00,2022-01-25 19:00:00,40,0,4,312,501,857,62290
2022-01-25 19:00:00,2022-01-25 20:00:00,40,0,4,363,481,888,59293
2022-01-25 20:00:00,2022-01-25 21:00:00,40,0,4,456,480,980,56284
2022-01-25 21:00:00,2022-01-25 22:00:00,40,0,4,623,633,1300,52707
2022-01-25 22:00:00,2022-01-25 23:00:00,39,0,4,1224,600,1867,49947
2022-01-25 23:00:00,2022-01-26 00:00:00,39,0,4,1904,681,2628,47749
2022-01-26 00:00:00,2022-01-26 01:00:00,40,0,4,2038,706,2788,45851
2022-01-26 01:00:00,2022-01-26 02:00:00,40,0,4,2147,1115,3306,45324
2022-01-26 02:00:00,2022-01-26 03:00:00,40,0,4,2873,1679,4596,45074
2022-01-26 03:00:00,2022-01-26 04:00:00,40,0,4,3220,1668,4932,45599
2022-01-26 04:00:00,2022-01-26 05:00:00,40,0,4,2998,1954,4996,47919
2022-01-26 05:00:00,2022-01-26 06:00:00,40,0,4,2929,2476,5449,52667
2022-01-26 06:00:00,2022-01-26 07:00:00,40,0,4,3240,2379,5663,59806
2022-01-26 07:00:00,2022-01-26 08:00:00,40,0,3,2728,2430,5201,64188
2022-01-26 08:00:00,2022-01-26 09:00:00,40,0,15,2394,2555,5004,65408
2022-01-26 09:00:00,2022-01-26 10:00:00,40,0,39,2452,2245,4776,65428
2022-01-26 10:00:00,2022-01-26 11:00:00,41,0,71,3224,1877,5213,64725
2022-01-26 11:00:00,2022-01-26 12:00:00,40,0,95,3391,1645,5171,63730
2022-01-26 12:00:00,2022-01-26 13:00:00,40,0,119,3228,2134,5521,63789
2022-01-26 13:00:00,2022-01-26 14:00:00,40,0,102,3062,2456,5660,63680
2022-01-26 14:00:00,2022-01-26 15:00:00,40,0,61,3244,3111,6456,63730
2022-01-26 15:00:00,2022-01-26 16:00:00,40,0,13,3618,3732,7403,64826
2022-01-26 16:00:00,2022-01-26 17:00:00,40,0,4,4075,4303,8422,67372
2022-01-26 17:00:00,2022-01-26 18:00:00,40,0,4,5196,5087,10327,64744
2022-01-26 18:00:00,2022-01-26 19:00:00,40,0,4,6161,6012,12217,62100
2022-01-26 19:00:00,2022-01-26 20:00:00,40,0,4,6156,6541,12741,58902
2022-01-26 20:00:00,2022-01-26 21:00:00,40,0,4,7265,7209,14518,55368
2022-01-26 21:00:00,2022-01-26 22:00:00,40,0,4,8125,7091,15260,51499
2022-01-26 22:00:00,2022-01-26 23:00:00,40,0,4,8534,7159,15737,48971
2022-01-26 23:00:00,2022-01-27 00:00:00,40,0,4,8339,7415,15798,46721
2022-01-27 00:00:00,2022-01-27 01:00:00,40,0,4,8631,7428,16103,45289
2022-01-27 01:00:00,2022-01-27 02:00:00,41,0,4,8780,7625,16450,44319
2022-01-27 02:00:00,2022-01-27 03:00:00,40,0,4,8782,7837,16663,43847
2022-01-27 03:00:00,2022-01-27 04:00:00,40,0,4,8762,8019,16825,44446
2022-01-27 04:00:00,2022-01-27 05:00:00,40,0,4,8807,8056,16907,46847
2022-01-27 05:00:00,2022-01-27 06:00:00,40,0,4,8742,7941,16727,51328
2022-01-27 06:00:00,2022-01-27 07:00:00,40,0,4,8803,7647,16494,58087
2022-01-27 07:00:00,2022-01-27 08:00:00,40,0,4,8755,7616,16415,62303
2022-01-27 08:00:00,2022-01-27 09:00:00,40,0,30,8697,7428,16195,63371
2022-01-27 09:00:00,2022-01-27 10:00:00,40,0,69,8671,7384,16164,62868
2022-01-27 10:00:00,2022-01-27 11:00:00,41,0,126,8610,7288,16065,62250
2022-01-27 11:00:00,2022-01-27 12:00:00,40,0,156,8644,7254,16094,60972
2022-01-27 12:00:00,2022-01-27 13:00:00,40,0,173,8488,7344,16045,60157
2022-01-27 13:00:00,2022-01-27 14:00:00,40,0,147,8102,7456,15745,59862
2022-01-27 14:00:00,2022-01-27 15:00:00,40,0,107,7536,7326,15009,60286
2022-01-27 15:00:00,2022-01-27 16:00:00,40,0,22,7162,7292,14516,62065
2022-01-27 16:00:00,2022-01-27 17:00:00,40,0,5,6418,7131,13594,65265
2022-01-27 17:00:00,2022-01-27 18:00:00,40,0,4,7539,7347,14930,63497
2022-01-27 18:00:00,2022-01-27 19:00:00,40,0,4,8091,7309,15444,61215
2022-01-27 19:00:00,2022-01-27 20:00:00,40,0,4,7602,7073,14719,58343
2022-01-27 20:00:00,2022-01-27 21:00:00,40,0,4,7409,7080,14533,54882
2022-01-27 21:00:00,2022-01-27 22:00:00,40,0,4,6860,7144,14048,51366
2022-01-27 22:00:00,2022-01-27 23:00:00,40,0,4,5587,6906,12537,48329
2022-01-27 23:00:00,2022-01-28 00:00:00,41,0,4,5976,6657,12678,46386
2022-01-28 00:00:00,2022-01-28 01:00:00,42,0,4,5464,6888,12398,45378
2022-01-28 01:00:00,2022-01-28 02:00:00,44,0,4,4354,6800,11202,44331
2022-01-28 02:00:00,2022-01-28 03:00:00,43,0,4,3977,6621,10645,43538
2022-01-28 03:00:00,2022-01-28 04:00:00,44,0,4,3896,6166,10110,44367
2022-01-28 04:00:00,2022-01-28 05:00:00,41,0,4,3593,5614,9252,46635
2022-01-28 05:00:00,2022-01-28 06:00:00,40,0,4,3267,4714,8025,51501
2022-01-28 06:00:00,2022-01-28 07:00:00,40,0,4,2711,3335,6090,58604
2022-01-28 07:00:00,2022-01-28 08:00:00,40,0,20,1808,1770,3638,61739
2022-01-28 08:00:00,2022-01-28 09:00:00,40,0,149,1007,1149,2345,59606
2022-01-28 09:00:00,2022-01-28 10:00:00,41,0,387,639,772,1839,55291
2022-01-28 10:00:00,2022-01-28 11:00:00,44,0,459,424,630,1557,52262
2022-01-28 11:00:00,2022-01-28 12:00:00,40,0,486,1104,762,2392,50828
2022-01-28 12:00:00,2022-01-28 13:00:00,40,0,451,1687,1157,3335,50393
2022-01-28 13:00:00,2022-01-28 14:00:00,40,0,315,2342,2108,4805,52728
2022-01-28 14:00:00,2022-01-28 15:00:00,40,0,140,3046,2387,5613,56671
2022-01-28 15:00:00,2022-01-28 16:00:00,40,0,28,3700,2410,6178,60056
2022-01-28 16:00:00,2022-01-28 17:00:00,40,0,4,4993,3325,8362,64353
2022-01-28 17:00:00,2022-01-28 18:00:00,41,0,4,7471,4645,12161,62193
2022-01-28 18:00:00,2022-01-28 19:00:00,40,0,4,8205,5370,13619,60010
2022-01-28 19:00:00,2022-01-28 20:00:00,41,0,4,8290,6499,14834,56843
2022-01-28 20:00:00,2022-01-28 21:00:00,43,0,4,8631,6980,15658,53493
2022-01-28 21:00:00,2022-01-28 22:00:00,42,0,4,8414,7088,15548,50440
2022-01-28 22:00:00,2022-01-28 23:00:00,40,0,4,8376,7259,15679,48197
2022-01-28 23:00:00,2022-01-29 00:00:00,40,0,4,8574,7410,16028,46046
2022-01-29 00:00:00,2022-01-29 01:00:00,41,0,4,8520,7364,15929,44619
2022-01-29 01:00:00,2022-01-29 02:00:00,43,0,4,8565,7504,16116,43490
2022-01-29 02:00:00,2022-01-29 03:00:00,41,0,4,8764,7545,16354,42781
2022-01-29 03:00:00,2022-01-29 04:00:00,44,0,4,8729,7590,16367,42772
2022-01-29 04:00:00,2022-01-29 05:00:00,43,0,4,8618,7636,16301,43400
2022-01-29 05:00:00,2022-01-29 06:00:00,40,0,4,8493,7565,16102,45143
2022-01-29 06:00:00,2022-01-29 07:00:00,41,0,4,8502,7878,16425,48101
2022-01-29 07:00:00,2022-01-29 08:00:00,40,0,6,8799,8097,16942,50568
2022-01-29 08:00:00,2022-01-29 09:00:00,40,0,40,8794,8285,17159,53313
2022-01-29 09:00:00,2022-01-29 10:00:00,40,0,119,8755,8541,17455,52742
2022-01-29 10:00:00,2022-01-29 11:00:00,40,0,156,8755,8739,17690,51506
2022-01-29 11:00:00,2022-01-29 12:00:00,40,0,156,8687,8746,17629,50494
2022-01-29 12:00:00,2022-01-29 13:00:00,40,0,194,8283,8786,17303,50053
2022-01-29 13:00:00,2022-01-29 14:00:00,40,0,133,7998,8759,16930,51337
2022-01-29 14:00:00,2022-01-29 15:00:00,40,0,59,7793,8509,16401,51595
2022-01-29 15:00:00,2022-01-29 16:00:00,40,0,22,7479,8530,16071,53055
2022-01-29 16:00:00,2022-01-29 17:00:00,42,0,4,8179,8696,16921,57295
2022-01-29 17:00:00,2022-01-29 18:00:00,41,0,4,8343,8616,17004,56560
2022-01-29 18:00:00,2022-01-29 19:00:00,44,0,4,8307,8484,16839,54793
2022-01-29 19:00:00,2022-01-29 20:00:00,40,0,4,8540,8614,17198,51836
2022-01-29 20:00:00,2022-01-29 21:00:00,42,0,4,8573,8449,17068,49617
2022-01-29 21:00:00,2022-01-29 22:00:00,42,0,4,8455,8338,16839,47890
2022-01-29 22:00:00,2022-01-29 23:00:00,40,0,4,8561,8280,16885,46072
2022-01-29 23:00:00,2022-01-30 00:00:00,44,0,4,8391,8081,16520,44413
2022-01-30 00:00:00,2022-01-30 01:00:00,40,0,4,8260,8040,16344,42894
2022-01-30 01:00:00,2022-01-30 02:00:00,43,0,4,7986,7902,15935,41660
2022-01-30 02:00:00,2022-01-30 03:00:00,41,0,4,7245,7846,15136,41158
2022-01-30 03:00:00,2022-01-30 04:00:00,42,0,4,6159,7668,13873,41047
2022-01-30 04:00:00,2022-01-30 05:00:00,41,0,4,6226,7190,13461,41767
2022-01-30 05:00:00,2022-01-30 06:00:00,40,0,4,5708,6439,12191,42888
2022-01-30 06:00:00,2022-01-30 07:00:00,40,0,4,5068,6259,11371,44430
2022-01-30 07:00:00,2022-01-30 08:00:00,40,0,25,4302,5821,10188,46282
2022-01-30 08:00:00,2022-01-30 09:00:00,40,0,170,3951,4865,9026,46175
2022-01-30 09:00:00,2022-01-30 10:00:00,40,0,387,3447,4161,8035,44612
2022-01-30 10:00:00,2022-01-30 11:00:00,40,0,503,3015,3688,7246,42959
2022-01-30 11:00:00,2022-01-30 12:00:00,40,0,520,2703,3344,6607,43269
2022-01-30 12:00:00,2022-01-30 13:00:00,40,0,424,2328,2741,5533,42780
2022-01-30 13:00:00,2022-01-30 14:00:00,40,0,358,2130,2163,4691,43901
2022-01-30 14:00:00,2022-01-30 15:00:00,40,0,205,1179,2009,3433,46968
2022-01-30 15:00:00,2022-01-30 16:00:00,40,0,61,1207,1726,3034,51234
2022-01-30 16:00:00,2022-01-30 17:00:00,40,0,8,2445,1622,4115,57484
2022-01-30 17:00:00,2022-01-30 18:00:00,40,0,8,3228,1989,5265,57541
2022-01-30 18:00:00,2022-01-30 19:00:00,40,0,8,4484,2613,7145,55724
2022-01-30 19:00:00,2022-01-30 20:00:00,40,0,8,6803,3068,9919,53179
2022-01-30 20:00:00,2022-01-30 21:00:00,40,0,7,8031,3586,11664,50514
2022-01-30 21:00:00,2022-01-30 22:00:00,40,0,4,8604,5257,13905,48135
2022-01-30 22:00:00,2022-01-30 23:00:00,40,0,4,8571,6548,15163,45680
2022-01-30 23:00:00,2022-01-31 00:00:00,40,0,4,8481,7299,15824,44072
2022-01-31 00:00:00,2022-01-31 01:00:00,40,0,4,8794,7850,16688,42925
2022-01-31 01:00:00,2022-01-31 02:00:00,40,0,4,8762,8222,17028,42546
2022-01-31 02:00:00,2022-01-31 03:00:00,40,0,4,8633,8408,17085,42279
2022-01-31 03:00:00,2022-01-31 04:00:00,40,0,4,8693,8490,17227,42903
2022-01-31 04:00:00,2022-01-31 05:00:00,40,0,4,8451,8338,16833,45407
2022-01-31 05:00:00,2022-01-31 06:00:00,40,0,4,7687,8531,16262,50873
2022-01-31 06:00:00,2022-01-31 07:00:00,39,0,4,6828,8005,14876,57147
2022-01-31 07:00:00,2022-01-31 08:00:00,40,0,19,6476,7601,14136,61559
2022-01-31 08:00:00,2022-01-31 09:00:00,40,0,111,6750,7694,14595,62448
2022-01-31 09:00:00,2022-01-31 10:00:00,39,0,267,6753,7650,14709,61623
2022-01-31 10:00:00,2022-01-31 11:00:00,40,0,422,6450,7782,14694,60985
2022-01-31 11:00:00,2022-01-31 12:00:00,40,0,313,6605,8004,14962,60378
2022-01-31 12:00:00,2022-01-31 13:00:00,40,0,275,6773,7986,15074,61177
2022-01-31 13:00:00,2022-01-31 14:00:00,39,0,132,7370,7823,15364,61397
2022-01-31 14:00:00,2022-01-31 15:00:00,39,0,56,7907,7804,15806,62197
2022-01-31 15:00:00,2022-01-31 16:00:00,40,0,19,8186,8076,16321,63451
2022-01-31 16:00:00,2022-01-31 17:00:00,37,0,4,8439,8266,16746,65752
2022-01-31 17:00:00,2022-01-31 18:00:00,40,0,4,7861,8208,16113,63403
2022-01-31 18:00:00,2022-01-31 19:00:00,40,0,4,8052,8253,16349,61063
2022-01-31 19:00:00,2022-01-31 20:00:00,40,0,4,8658,7993,16695,57770
2022-01-31 20:00:00,2022-01-31 21:00:00,40,0,4,8567,7383,15994,54960
2022-01-31 21:00:00,2022-01-31 22:00:00,40,0,4,8372,6675,15091,51735
2022-01-31 22:00:00,2022-01-31 23:00:00,40,0,4,7729,6030,13803,48776
2022-01-31 23:00:00,2022-02-01 00:00:00,40,0,4,6142,5492,11678,46055
2022-02-01 00:00:00,2022-02-01 01:00:00,40,0,4,5510,5092,10646,44520
2022-02-01 01:00:00,2022-02-01 02:00:00,40,0,4,5313,4315,9672,43622
2022-02-01 02:00:00,2022-02-01 03:00:00,40,0,4,5445,4607,10096,43412
2022-02-01 03:00:00,2022-02-01 04:00:00,40,0,4,6270,5134,11448,44041
2022-02-01 04:00:00,2022-02-01 05:00:00,39,0,4,7100,5896,13039,46474
2022-02-01 05:00:00,2022-02-01 06:00:00,40,0,4,8153,6649,14846,51668
2022-02-01 06:00:00,2022-02-01 07:00:00,37,0,4,8488,6637,15166,58117
2022-02-01 07:00:00,2022-02-01 08:00:00,39,0,14,8611,6872,15536,61990
2022-02-01 08:00:00,2022-02-01 09:00:00,40,0,45,8646,7392,16123,63360
2022-02-01 09:00:00,2022-02-01 10:00:00,37,0,93,8613,7652,16395,62844
2022-02-01 10:00:00,2022-02-01 11:00:00,39,0,111,8565,7769,16484,62780
2022-02-01 11:00:00,2022-02-01 12:00:00,38,0,103,8522,7896,16559,61979
2022-02-01 12:00:00,2022-02-01 13:00:00,36,0,142,8093,8000,16271,60755
2022-02-01 13:00:00,2022-02-01 14:00:00,40,0,140,7791,7995,15966,59900
2022-02-01 14:00:00,2022-02-01 15:00:00,38,0,78,8358,7820,16294,60526
2022-02-01 15:00:00,2022-02-01 16:00:00,40,0,16,8538,7777,16371,62026
2022-02-01 16:00:00,2022-02-01 17:00:00,40,0,4,8413,7908,16365,65320
2022-02-01 17:00:00,2022-02-01 18:00:00,40,0,4,8503,7963,16510,63436
2022-02-01 18:00:00,2022-02-01 19:00:00,40,0,4,8487,8108,16639,60877
2022-02-01 19:00:00,2022-02-01 20:00:00,40,0,4,8481,8177,16702,57560
2022-02-01 20:00:00,2022-02-01 21:00:00,40,0,4,8520,8152,16716,54234
2022-02-01 21:00:00,2022-02-01 22:00:00,40,0,4,8525,8126,16695,50874
2022-02-01 22:00:00,2022-02-01 23:00:00,39,0,4,8337,8097,16477,48003
2022-02-01 23:00:00,2022-02-02 00:00:00,40,0,4,8043,8017,16104,45624
2022-02-02 00:00:00,2022-02-02 01:00:00,40,0,4,7977,8100,16121,44165
2022-02-02 01:00:00,2022-02-02 02:00:00,40,0,4,8059,7977,16080,43831
2022-02-02 02:00:00,2022-02-02 03:00:00,40,0,4,7923,7916,15883,43573
2022-02-02 03:00:00,2022-02-02 04:00:00,40,0,4,8060,7586,15690,43946
2022-02-02 04:00:00,2022-02-02 05:00:00,39,0,4,8235,7155,15433,46292
2022-02-02 05:00:00,2022-02-02 06:00:00,37,0,4,7888,6736,14665,51190
2022-02-02 06:00:00,2022-02-02 07:00:00,36,0,3,5710,6550,12299,57767
2022-02-02 07:00:00,2022-02-02 08:00:00,37,0,39,4457,6017,10550,61002
2022-02-02 08:00:00,2022-02-02 09:00:00,38,0,190,4756,4983,9967,59497
2022-02-02 09:00:00,2022-02-02 10:00:00,37,0,296,6624,3777,10734,56762
2022-02-02 10:00:00,2022-02-02 11:00:00,40,0,443,7149,3188,10820,54914
2022-02-02 11:00:00,2022-02-02 12:00:00,40,0,550,5480,2660,8730,53469
2022-02-02 12:00:00,2022-02-02 13:00:00,40,0,453,3813,1626,5932,52647
2022-02-02 13:00:00,2022-02-02 14:00:00,40,0,349,2799,950,4138,53774
2022-02-02 14:00:00,2022-02-02 15:00:00,40,0,227,1951,769,2987,56648
2022-02-02 15:00:00,2022-02-02 16:00:00,36,0,73,1576,846,2531,60745
2022-02-02 16:00:00,2022-02-02 17:00:00,36,0,8,1607,1187,2838,64876
2022-02-02 17:00:00,2022-02-02 18:00:00,36,0,8,1850,1398,3292,63045
2022-02-02 18:00:00,2022-02-02 19:00:00,36,0,8,2345,1900,4289,60487
2022-02-02 19:00:00,2022-02-02 20:00:00,36,0,4,2582,2695,5317,57464
2022-02-02 20:00:00,2022-02-02 21:00:00,36,0,4,2622,4072,6734,54293
2022-02-02 21:00:00,2022-02-02 22:00:00,36,0,4,2734,4476,7250,50730
2022-02-02 22:00:00,2022-02-02 23:00:00,38,0,4,2728,4216,6986,47483
2022-02-02 23:00:00,2022-02-03 00:00:00,40,0,4,3212,4401,7657,45118
2022-02-03 00:00:00,2022-02-03 01:00:00,37,0,4,4608,4776,9425,43569
2022-02-03 01:00:00,2022-02-03 02:00:00,40,0,4,5956,4582,10582,42892
2022-02-03 02:00:00,2022-02-03 03:00:00,40,0,4,6537,4913,11494,42589
2022-02-03 03:00:00,2022-02-03 04:00:00,39,0,4,6886,4690,11619,42964
2022-02-03 04:00:00,2022-02-03 05:00:00,39,0,4,6710,5467,12220,45314
2022-02-03 05:00:00,2022-02-03 06:00:00,36,0,4,7052,5896,12988,50921
2022-02-03 06:00:00,2022-02-03 07:00:00,36,0,4,7052,5744,12836,57871
2022-02-03 07:00:00,2022-02-03 08:00:00,36,0,6,7209,5921,13172,61659
2022-02-03 08:00:00,2022-02-03 09:00:00,36,0,25,7632,6179,13872,62966
2022-02-03 09:00:00,2022-02-03 10:00:00,36,0,52,7353,6256,13697,62757
2022-02-03 10:00:00,2022-02-03 11:00:00,36,0,83,6214,5793,12126,62236
2022-02-03 11:00:00,2022-02-03 12:00:00,36,0,109,5422,5479,11046,61487
2022-02-03 12:00:00,2022-02-03 13:00:00,37,0,90,4606,5669,10402,61208
2022-02-03 13:00:00,2022-02-03 14:00:00,38,0,73,4396,5662,10169,60816
2022-02-03 14:00:00,2022-02-03 15:00:00,40,0,58,4219,5178,9495,61284
2022-02-03 15:00:00,2022-02-03 16:00:00,37,0,22,4063,4608,8730,62455
2022-02-03 16:00:00,2022-02-03 17:00:00,40,0,8,4116,4325,8489,65222
2022-02-03 17:00:00,2022-02-03 18:00:00,40,0,8,3946,4406,8400,63533
2022-02-03 18:00:00,2022-02-03 19:00:00,40,0,7,3461,4476,7984,61360
2022-02-03 19:00:00,2022-02-03 20:00:00,40,0,4,3684,4178,7906,58017
2022-02-03 20:00:00,2022-02-03 21:00:00,39,0,4,5295,4562,9900,54271
2022-02-03 21:00:00,2022-02-03 22:00:00,38,0,4,5677,4926,10645,50438
2022-02-03 22:00:00,2022-02-03 23:00:00,39,0,4,6527,5354,11924,47622
2022-02-03 23:00:00,2022-02-04 00:00:00,40,0,4,7994,5525,13563,45608
2022-02-04 00:00:00,2022-02-04 01:00:00,40,0,4,8562,6083,14689,44406
2022-02-04 01:00:00,2022-02-04 02:00:00,40,0,4,8712,6812,15568,43599
2022-02-04 02:00:00,2022-02-04 03:00:00,40,0,4,8765,7199,16008,43216
2022-02-04 03:00:00,2022-02-04 04:00:00,40,0,4,8759,7500,16303,43456
2022-02-04 04:00:00,2022-02-04 05:00:00,40,0,4,8758,7624,16426,45637
2022-02-04 05:00:00,2022-02-04 06:00:00,40,0,4,8764,7664,16472,50766
2022-02-04 06:00:00,2022-02-04 07:00:00,36,0,4,8766,7634,16440,57002
2022-02-04 07:00:00,2022-02-04 08:00:00,36,0,15,8726,7797,16574,60448
2022-02-04 08:00:00,2022-02-04 09:00:00,37,0,95,8667,8055,16854,60696
2022-02-04 09:00:00,2022-02-04 10:00:00,38,0,155,8568,8059,16820,59955
2022-02-04 10:00:00,2022-02-04 11:00:00,39,0,184,7798,8212,16233,59250
2022-02-04 11:00:00,2022-02-04 12:00:00,39,0,236,7498,8298,16071,59008
2022-02-04 12:00:00,2022-02-04 13:00:00,38,0,126,8386,8093,16643,60658
2022-02-04 13:00:00,2022-02-04 14:00:00,40,0,60,7891,7044,15035,61737
2022-02-04 14:00:00,2022-02-04 15:00:00,40,0,24,7520,6536,14120,61733
2022-02-04 15:00:00,2022-02-04 16:00:00,37,0,13,7939,6433,14422,62182
2022-02-04 16:00:00,2022-02-04 17:00:00,38,0,4,8554,6270,14866,64901
2022-02-04 17:00:00,2022-02-04 18:00:00,36,0,4,8520,6944,15504,62933
2022-02-04 18:00:00,2022-02-04 19:00:00,39,0,4,8599,7042,15684,60267
2022-02-04 19:00:00,2022-02-04 20:00:00,38,0,4,8480,7123,15645,57014
2022-02-04 20:00:00,2022-02-04 21:00:00,38,0,4,8604,7624,16270,53819
2022-02-04 21:00:00,2022-02-04 22:00:00,40,0,4,8643,7704,16391,50806
2022-02-04 22:00:00,2022-02-04 23:00:00,40,0,4,8519,7772,16335,48458
2022-02-04 23:00:00,2022-02-05 00:00:00,40,0,4,8577,7724,16345,45875
2022-02-05 00:00:00,2022-02-05 01:00:00,40,0,4,8505,7627,16176,44622
2022-02-05 01:00:00,2022-02-05 02:00:00,40,0,4,8599,7251,15894,43307
2022-02-05 02:00:00,2022-02-05 03:00:00,40,0,4,8434,6972,15450,42634
2022-02-05 03:00:00,2022-02-05 04:00:00,40,0,4,8155,6393,14592,42509
2022-02-05 04:00:00,2022-02-05 05:00:00,39,0,4,7874,6409,14326,43583
2022-02-05 05:00:00,2022-02-05 06:00:00,40,0,4,7552,5845,13441,45241
2022-02-05 06:00:00,2022-02-05 07:00:00,37,0,3,7118,5273,12431,47793
2022-02-05 07:00:00,2022-02-05 08:00:00,35,0,56,6760,5217,12068,50120
2022-02-05 08:00:00,2022-02-05 09:00:00,39,0,244,6073,5464,11820,49327
2022-02-05 09:00:00,2022-02-05 10:00:00,43,0,371,5649,5789,11852,46946
2022-02-05 10:00:00,2022-02-05 11:00:00,60,0,346,5964,6796,13166,45784
2022-02-05 11:00:00,2022-02-05 12:00:00,59,0,384,6905,7094,14442,44706
2022-02-05 12:00:00,2022-02-05 13:00:00,61,0,522,5588,7369,13540,43760
2022-02-05 13:00:00,2022-02-05 14:00:00,60,0,376,7050,8244,15730,45585
2022-02-05 14:00:00,2022-02-05 15:00:00,60,0,194,8577,8451,17282,49550
2022-02-05 15:00:00,2022-02-05 16:00:00,60,0,44,8482,8610,17196,53435
2022-02-05 16:00:00,2022-02-05 17:00:00,61,0,4,8594,8742,17401,58150
2022-02-05 17:00:00,2022-02-05 18:00:00,60,0,4,8571,8784,17419,57515
2022-02-05 18:00:00,2022-02-05 19:00:00,61,0,4,8461,8659,17185,55341
2022-02-05 19:00:00,2022-02-05 20:00:00,60,0,4,8344,8724,17132,52781
2022-02-05 20:00:00,2022-02-05 21:00:00,61,0,4,8206,8729,17000,50250
2022-02-05 21:00:00,2022-02-05 22:00:00,60,0,4,8211,8759,17034,48094
2022-02-05 22:00:00,2022-02-05 23:00:00,60,0,4,8211,8823,17098,45680
2022-02-05 23:00:00,2022-02-06 00:00:00,60,0,4,8286,8888,17238,43970
2022-02-06 00:00:00,2022-02-06 01:00:00,62,0,4,8335,8867,17268,42495
2022-02-06 01:00:00,2022-02-06 02:00:00,61,0,4,8360,8868,17293,41773
2022-02-06 02:00:00,2022-02-06 03:00:00,60,0,4,8288,8745,17097,41442
2022-02-06 03:00:00,2022-02-06 04:00:00,61,0,4,8509,8663,17237,41350
2022-02-06 04:00:00,2022-02-06 05:00:00,60,0,4,8459,8696,17219,41864
2022-02-06 05:00:00,2022-02-06 06:00:00,62,0,4,8368,8677,17111,42936
2022-02-06 06:00:00,2022-02-06 07:00:00,60,0,4,8387,8616,17067,44938
2022-02-06 07:00:00,2022-02-06 08:00:00,62,0,13,8419,8591,17085,47697
2022-02-06 08:00:00,2022-02-06 09:00:00,60,0,26,8456,8673,17215,50857
2022-02-06 09:00:00,2022-02-06 10:00:00,60,0,23,8521,8559,17163,52721
2022-02-06 10:00:00,2022-02-06 11:00:00,60,0,33,8332,7965,16390,53909
2022-02-06 11:00:00,2022-02-06 12:00:00,61,0,84,8420,7144,15709,54028
2022-02-06 12:00:00,2022-02-06 13:00:00,60,0,135,8356,7524,16075,52554
2022-02-06 13:00:00,2022-02-06 14:00:00,60,0,181,7979,8142,16362,51022
2022-02-06 14:00:00,2022-02-06 15:00:00,60,0,132,8344,8433,16969,50607
2022-02-06 15:00:00,2022-02-06 16:00:00,60,0,23,8403,8202,16688,53555
2022-02-06 16:00:00,2022-02-06 17:00:00,62,0,3,8427,7902,16394,58444
2022-02-06 17:00:00,2022-02-06 18:00:00,61,0,4,8347,7963,16375,57818
2022-02-06 18:00:00,2022-02-06 19:00:00,61,0,4,8362,8107,16534,55919
2022-02-06 19:00:00,2022-02-06 20:00:00,60,0,4,8433,8384,16881,53565
2022-02-06 20:00:00,2022-02-06 21:00:00,61,0,4,8182,8187,16434,51130
2022-02-06 21:00:00,2022-02-06 22:00:00,62,0,4,8469,8319,16854,48807
2022-02-06 22:00:00,2022-02-06 23:00:00,61,0,4,8486,8256,16807,46159
2022-02-06 23:00:00,2022-02-07 00:00:00,60,0,4,8425,8355,16844,44247
2022-02-07 00:00:00,2022-02-07 01:00:00,60,0,4,8508,8349,16921,43001
2022-02-07 01:00:00,2022-02-07 02:00:00,61,0,4,8508,8289,16862,42479
2022-02-07 02:00:00,2022-02-07 03:00:00,61,0,4,8492,8241,16798,42431
2022-02-07 03:00:00,2022-02-07 04:00:00,61,0,4,8379,8220,16664,43214
2022-02-07 04:00:00,2022-02-07 05:00:00,60,0,4,8303,7922,16289,45830
2022-02-07 05:00:00,2022-02-07 06:00:00,61,0,4,7713,6985,14763,50858
2022-02-07 06:00:00,2022-02-07 07:00:00,61,0,4,6236,5553,11854,57145
2022-02-07 07:00:00,2022-02-07 08:00:00,61,0,64,5008,5426,10559,59747
2022-02-07 08:00:00,2022-02-07 09:00:00,60,0,255,4723,5212,10250,57005
2022-02-07 09:00:00,2022-02-07 10:00:00,61,0,471,4853,5349,10734,53367
2022-02-07 10:00:00,2022-02-07 11:00:00,61,0,588,3981,5513,10143,51864
2022-02-07 11:00:00,2022-02-07 12:00:00,60,0,565,3835,5162,9622,49628
2022-02-07 12:00:00,2022-02-07 13:00:00,60,0,572,4326,5521,10479,49200
2022-02-07 13:00:00,2022-02-07 14:00:00,61,0,427,4424,5679,10591,49843
2022-02-07 14:00:00,2022-02-07 15:00:00,61,0,244,5154,5409,10868,52872
2022-02-07 15:00:00,2022-02-07 16:00:00,61,0,77,5483,5090,10711,58368
2022-02-07 16:00:00,2022-02-07 17:00:00,61,0,4,6378,4891,11334,63922
2022-02-07 17:00:00,2022-02-07 18:00:00,60,0,4,7556,4839,12459,63355
2022-02-07 18:00:00,2022-02-07 19:00:00,60,0,4,8043,5371,13478,61091
2022-02-07 19:00:00,2022-02-07 20:00:00,60,0,4,8300,5240,13604,57619
2022-02-07 20:00:00,2022-02-07 21:00:00,60,0,4,8302,5637,14003,54229
2022-02-07 21:00:00,2022-02-07 22:00:00,60,0,4,8109,6246,14419,50710
2022-02-07 22:00:00,2022-02-07 23:00:00,60,0,4,8153,6524,14741,47802
2022-02-07 23:00:00,2022-02-08 00:00:00,59,0,4,8514,6792,15369,45588
2022-02-08 00:00:00,2022-02-08 01:00:00,60,0,4,8511,6966,15541,43939
2022-02-08 01:00:00,2022-02-08 02:00:00,60,0,4,8430,7193,15687,43183
2022-02-08 02:00:00,2022-02-08 03:00:00,60,0,4,8351,7173,15588,42680
2022-02-08 03:00:00,2022-02-08 04:00:00,60,0,4,8229,7266,15559,43156
2022-02-08 04:00:00,2022-02-08 05:00:00,60,0,4,8237,7539,15840,45538
2022-02-08 05:00:00,2022-02-08 06:00:00,59,0,4,8224,7613,15900,50601
2022-02-08 06:00:00,2022-02-08 07:00:00,58,0,4,8298,7261,15621,57297
2022-02-08 07:00:00,2022-02-08 08:00:00,62,0,28,8376,7084,15550,60036
2022-02-08 08:00:00,2022-02-08 09:00:00,60,0,91,8373,7285,15809,59085
2022-02-08 09:00:00,2022-02-08 10:00:00,60,0,135,8372,7382,15949,57804
2022-02-08 10:00:00,2022-02-08 11:00:00,60,0,162,8407,7380,16009,56933
2022-02-08 11:00:00,2022-02-08 12:00:00,61,0,153,8338,7318,15870,55328
2022-02-08 12:00:00,2022-02-08 13:00:00,60,0,155,8278,7390,15883,55420
2022-02-08 13:00:00,2022-02-08 14:00:00,60,0,127,7866,7226,15279,55740
2022-02-08 14:00:00,2022-02-08 15:00:00,62,0,88,7181,6934,14265,57074
2022-02-08 15:00:00,2022-02-08 16:00:00,60,0,25,6818,6859,13762,59583
2022-02-08 16:00:00,2022-02-08 17:00:00,60,0,5,6545,6938,13548,63114
2022-02-08 17:00:00,2022-02-08 18:00:00,60,0,4,5817,6686,12567,62013
2022-02-08 18:00:00,2022-02-08 19:00:00,60,0,4,5810,6432,12306,60023
2022-02-08 19:00:00,2022-02-08 20:00:00,60,0,4,6491,6525,13080,57013
2022-02-08 20:00:00,2022-02-08 21:00:00,60,0,4,7139,6706,13909,53625
2022-02-08 21:00:00,2022-02-08 22:00:00,60,0,4,7875,6457,14396,50361
2022-02-08 22:00:00,2022-02-08 23:00:00,60,0,4,8099,6520,14683,47471
2022-02-08 23:00:00,2022-02-09 00:00:00,60,0,4,8136,6716,14916,45059
2022-02-09 00:00:00,2022-02-09 01:00:00,60,0,4,8335,6568,14967,43490
2022-02-09 01:00:00,2022-02-09 02:00:00,60,0,4,8254,6824,15142,42817
2022-02-09 02:00:00,2022-02-09 03:00:00,60,0,4,8318,6760,15142,42457
2022-02-09 03:00:00,2022-02-09 04:00:00,61,0,4,8293,6749,15107,42716
2022-02-09 04:00:00,2022-02-09 05:00:00,60,0,4,8189,6863,15116,45038
2022-02-09 05:00:00,2022-02-09 06:00:00,60,0,4,8125,6733,14922,50275
2022-02-09 06:00:00,2022-02-09 07:00:00,62,0,4,8143,6582,14791,56921
2022-02-09 07:00:00,2022-02-09 08:00:00,60,0,27,8234,6492,14813,60060
2022-02-09 08:00:00,2022-02-09 09:00:00,62,0,79,8260,6565,14966,60585
2022-02-09 09:00:00,2022-02-09 10:00:00,61,0,149,8172,6486,14868,59756
2022-02-09 10:00:00,2022-02-09 11:00:00,63,0,160,7851,6190,14264,58470
2022-02-09 11:00:00,2022-02-09 12:00:00,63,0,143,6974,6024,13204,57464
2022-02-09 12:00:00,2022-02-09 13:00:00,61,0,147,6714,5993,12915,58030
2022-02-09 13:00:00,2022-02-09 14:00:00,64,0,122,6113,5360,11659,58190
2022-02-09 14:00:00,2022-02-09 15:00:00,61,0,78,4753,4425,9317,59170
2022-02-09 15:00:00,2022-02-09 16:00:00,60,0,28,3339,3644,7071,61281
2022-02-09 16:00:00,2022-02-09 17:00:00,60,0,4,2469,2518,5051,64514
2022-02-09 17:00:00,2022-02-09 18:00:00,62,0,4,2596,1954,4616,62953
2022-02-09 18:00:00,2022-02-09 19:00:00,75,0,4,2231,1382,3692,60471
2022-02-09 19:00:00,2022-02-09 20:00:00,83,0,4,2181,1288,3556,57509
2022-02-09 20:00:00,2022-02-09 21:00:00,81,0,4,2433,1341,3859,54219
2022-02-09 21:00:00,2022-02-09 22:00:00,80,0,4,2354,1606,4044,50704
2022-02-09 22:00:00,2022-02-09 23:00:00,83,0,4,2335,1716,4138,47726
2022-02-09 23:00:00,2022-02-10 00:00:00,81,0,4,3091,1880,5056,45490
2022-02-10 00:00:00,2022-02-10 01:00:00,84,0,4,2365,1541,3994,43906
2022-02-10 01:00:00,2022-02-10 02:00:00,84,0,4,1627,1164,2879,43017
2022-02-10 02:00:00,2022-02-10 03:00:00,82,0,4,1096,1145,2327,42910
2022-02-10 03:00:00,2022-02-10 04:00:00,83,0,4,870,1113,2070,42973
2022-02-10 04:00:00,2022-02-10 05:00:00,82,0,4,943,1185,2214,45375
2022-02-10 05:00:00,2022-02-10 06:00:00,80,0,4,1102,1174,2360,50543
2022-02-10 06:00:00,2022-02-10 07:00:00,83,0,4,867,1286,2240,57628
2022-02-10 07:00:00,2022-02-10 08:00:00,81,0,21,1049,1097,2248,61454
2022-02-10 08:00:00,2022-02-10 09:00:00,83,0,114,1506,1250,2953,61652
2022-02-10 09:00:00,2022-02-10 10:00:00,84,0,243,2207,1441,3975,59508
2022-02-10 10:00:00,2022-02-10 11:00:00,84,0,448,2601,1901,5034,56385
2022-02-10 11:00:00,2022-02-10 12:00:00,84,0,415,3130,2447,6076,55428
2022-02-10 12:00:00,2022-02-10 13:00:00,84,0,376,3216,2547,6223,56344
2022-02-10 13:00:00,2022-02-10 14:00:00,84,0,241,2978,2863,6166,56954
2022-02-10 14:00:00,2022-02-10 15:00:00,84,0,161,3023,3170,6438,58336
2022-02-10 15:00:00,2022-02-10 16:00:00,84,0,48,3554,2969,6655,60914
2022-02-10 16:00:00,2022-02-10 17:00:00,84,0,5,4170,2990,7249,64753
2022-02-10 17:00:00,2022-02-10 18:00:00,84,0,4,5268,3245,8601,63797
2022-02-10 18:00:00,2022-02-10 19:00:00,84,0,4,6079,3494,9661,61641
2022-02-10 19:00:00,2022-02-10 20:00:00,84,0,4,7037,3707,10832,58436
2022-02-10 20:00:00,2022-02-10 21:00:00,84,0,4,7945,4426,12459,55003
2022-02-10 21:00:00,2022-02-10 22:00:00,84,0,4,8260,4942,13290,51355
2022-02-10 22:00:00,2022-02-10 23:00:00,84,0,4,8455,5829,14372,48199
2022-02-10 23:00:00,2022-02-11 00:00:00,83,0,4,8385,6075,14547,46028
2022-02-11 00:00:00,2022-02-11 01:00:00,84,0,4,8573,6670,15331,44434
2022-02-11 01:00:00,2022-02-11 02:00:00,84,0,4,8618,7060,15766,43552
2022-02-11 02:00:00,2022-02-11 03:00:00,84,0,4,8573,7644,16305,43190
2022-02-11 03:00:00,2022-02-11 04:00:00,84,0,4,8333,7911,16332,43494
2022-02-11 04:00:00,2022-02-11 05:00:00,83,0,4,7909,8073,16069,45280
2022-02-11 05:00:00,2022-02-11 06:00:00,82,0,4,6799,8003,14888,50115
2022-02-11 06:00:00,2022-02-11 07:00:00,84,0,4,7611,7740,15439,56869
2022-02-11 07:00:00,2022-02-11 08:00:00,83,0,34,7358,7422,14897,59835
2022-02-11 08:00:00,2022-02-11 09:00:00,84,0,159,6756,7298,14297,58073
2022-02-11 09:00:00,2022-02-11 10:00:00,84,0,296,6684,6606,13670,53961
2022-02-11 10:00:00,2022-02-11 11:00:00,84,0,421,4842,6036,11383,50971
2022-02-11 11:00:00,2022-02-11 12:00:00,84,0,420,3905,4645,9054,49484
2022-02-11 12:00:00,2022-02-11 13:00:00,84,0,321,2858,3282,6545,49518
2022-02-11 13:00:00,2022-02-11 14:00:00,84,0,383,1336,2497,4300,51123
2022-02-11 14:00:00,2022-02-11 15:00:00,84,0,246,1180,1757,3267,53715
2022-02-11 15:00:00,2022-02-11 16:00:00,84,0,94,522,1119,1819,58042
2022-02-11 16:00:00,2022-02-11 17:00:00,83,0,8,290,659,1040,63405
2022-02-11 17:00:00,2022-02-11 18:00:00,83,0,4,145,474,706,63321
2022-02-11 18:00:00,2022-02-11 19:00:00,79,0,4,129,382,594,60959
2022-02-11 19:00:00,2022-02-11 20:00:00,65,0,4,148,365,582,57940
2022-02-11 20:00:00,2022-02-11 21:00:00,62,0,4,362,347,775,54533
2022-02-11 21:00:00,2022-02-11 22:00:00,64,0,4,921,426,1415,51154
2022-02-11 22:00:00,2022-02-11 23:00:00,63,0,4,1730,887,2684,48509
2022-02-11 23:00:00,2022-02-12 00:00:00,64,0,4,2803,1485,4356,45953
2022-02-12 00:00:00,2022-02-12 01:00:00,64,0,4,3566,2181,5815,44164
2022-02-12 01:00:00,2022-02-12 02:00:00,64,0,4,4170,2860,7098,43058
2022-02-12 02:00:00,2022-02-12 03:00:00,64,0,4,4955,3601,8624,42747
2022-02-12 03:00:00,2022-02-12 04:00:00,62,0,4,5603,4267,9936,42857
2022-02-12 04:00:00,2022-02-12 05:00:00,61,0,4,6039,5150,11254,43797
2022-02-12 05:00:00,2022-02-12 06:00:00,62,0,4,6089,5501,11656,46053
2022-02-12 06:00:00,2022-02-12 07:00:00,63,0,4,6853,5712,12632,49135
2022-02-12 07:00:00,2022-02-12 08:00:00,61,0,82,7476,5481,13100,50597
2022-02-12 08:00:00,2022-02-12 09:00:00,60,0,354,7673,5153,13240,48617
2022-02-12 09:00:00,2022-02-12 10:00:00,60,0,594,7066,5033,12753,44792
2022-02-12 10:00:00,2022-02-12 11:00:00,60,0,740,6972,4569,12341,42063
2022-02-12 11:00:00,2022-02-12 12:00:00,61,0,784,6887,5112,12844,40105
2022-02-12 12:00:00,2022-02-12 13:00:00,60,0,709,6557,5424,12750,39604
2022-02-12 13:00:00,2022-02-12 14:00:00,60,0,592,7471,5915,14038,41412
2022-02-12 14:00:00,2022-02-12 15:00:00,60,0,420,7997,5386,13863,44327
2022-02-12 15:00:00,2022-02-12 16:00:00,61,0,118,7782,4330,12291,50303
2022-02-12 16:00:00,2022-02-12 17:00:00,62,0,8,7943,5327,13340,56832
2022-02-12 17:00:00,2022-02-12 18:00:00,64,0,4,7939,5584,13591,57614
2022-02-12 18:00:00,2022-02-12 19:00:00,64,0,4,7961,5904,13933,55850
2022-02-12 19:00:00,2022-02-12 20:00:00,64,0,4,7989,6446,14503,53220
2022-02-12 20:00:00,2022-02-12 21:00:00,64,0,4,8667,6736,15471,50845
2022-02-12 21:00:00,2022-02-12 22:00:00,64,0,4,8470,6672,15210,48459
2022-02-12 22:00:00,2022-02-12 23:00:00,62,0,4,8480,6780,15326,45945
2022-02-12 23:00:00,2022-02-13 00:00:00,63,0,4,8737,7010,15814,43811
2022-02-13 00:00:00,2022-02-13 01:00:00,63,0,4,8706,7012,15785,42341
2022-02-13 01:00:00,2022-02-13 02:00:00,62,0,4,8382,7183,15631,41708
2022-02-13 02:00:00,2022-02-13 03:00:00,62,0,4,8199,6911,15176,40915
2022-02-13 03:00:00,2022-02-13 04:00:00,60,0,4,8070,6367,14501,41438
2022-02-13 04:00:00,2022-02-13 05:00:00,60,0,4,8076,6325,14465,42057
2022-02-13 05:00:00,2022-02-13 06:00:00,60,0,4,8184,6781,15029,43020
2022-02-13 06:00:00,2022-02-13 07:00:00,59,0,6,8434,6656,15155,44384
2022-02-13 07:00:00,2022-02-13 08:00:00,60,0,104,8625,6603,15392,46029
2022-02-13 08:00:00,2022-02-13 09:00:00,59,0,234,8484,6735,15512,46518
2022-02-13 09:00:00,2022-02-13 10:00:00,60,0,374,7673,6733,14840,44149
2022-02-13 10:00:00,2022-02-13 11:00:00,59,0,433,6678,6696,13866,41881
2022-02-13 11:00:00,2022-02-13 12:00:00,60,0,589,6620,6937,14206,41081
2022-02-13 12:00:00,2022-02-13 13:00:00,59,0,589,6756,7344,14748,42275
2022-02-13 13:00:00,2022-02-13 14:00:00,58,0,437,6752,7207,14454,43425
2022-02-13 14:00:00,2022-02-13 15:00:00,60,0,214,7270,7624,15168,46142
2022-02-13 15:00:00,2022-02-13 16:00:00,60,0,86,8703,7686,16535,50385
2022-02-13 16:00:00,2022-02-13 17:00:00,64,0,7,8699,8091,16861,56119
2022-02-13 17:00:00,2022-02-13 18:00:00,64,0,4,8738,8241,17047,56666
2022-02-13 18:00:00,2022-02-13 19:00:00,64,0,4,8703,8296,17067,54623
2022-02-13 19:00:00,2022-02-13 20:00:00,64,0,4,8687,8343,17098,52287
2022-02-13 20:00:00,2022-02-13 21:00:00,64,0,4,8704,8237,17009,49662
2022-02-13 21:00:00,2022-02-13 22:00:00,63,0,4,8651,8149,16867,47020
2022-02-13 22:00:00,2022-02-13 23:00:00,59,0,4,8601,8184,16848,44038
2022-02-13 23:00:00,2022-02-14 00:00:00,61,0,4,8602,8278,16945,41961
2022-02-14 00:00:00,2022-02-14 01:00:00,61,0,4,8614,8220,16899,40983
2022-02-14 01:00:00,2022-02-14 02:00:00,62,0,4,8611,8207,16884,40464
2022-02-14 02:00:00,2022-02-14 03:00:00,62,0,4,8596,8136,16798,40396
2022-02-14 03:00:00,2022-02-14 04:00:00,61,0,4,8590,8280,16935,41056
2022-02-14 04:00:00,2022-02-14 05:00:00,60,0,4,8607,8282,16953,43754
2022-02-14 05:00:00,2022-02-14 06:00:00,60,0,4,8402,8069,16535,48711
2022-02-14 06:00:00,2022-02-14 07:00:00,60,0,4,8482,7936,16482,55608
2022-02-14 07:00:00,2022-02-14 08:00:00,60,0,46,8509,7693,16308,59497
2022-02-14 08:00:00,2022-02-14 09:00:00,60,0,59,8528,7647,16294,59187
2022-02-14 09:00:00,2022-02-14 10:00:00,61,0,143,8590,7863,16657,57000
2022-02-14 10:00:00,2022-02-14 11:00:00,62,0,405,8563,7810,16840,54610
2022-02-14 11:00:00,2022-02-14 12:00:00,60,0,372,8629,7823,16884,52173
2022-02-14 12:00:00,2022-02-14 13:00:00,60,0,337,8655,7885,16937,50987
2022-02-14 13:00:00,2022-02-14 14:00:00,60,0,320,8677,7851,16908,51021
2022-02-14 14:00:00,2022-02-14 15:00:00,60,0,255,8647,7812,16774,52973
2022-02-14 15:00:00,2022-02-14 16:00:00,61,0,113,8542,7477,16193,56837
2022-02-14 16:00:00,2022-02-14 17:00:00,63,0,14,8476,7924,16477,62313
2022-02-14 17:00:00,2022-02-14 18:00:00,63,0,4,8252,7749,16068,62173
2022-02-14 18:00:00,2022-02-14 19:00:00,63,0,4,8182,7945,16194,60049
2022-02-14 19:00:00,2022-02-14 20:00:00,63,0,4,7972,7914,15953,57053
2022-02-14 20:00:00,2022-02-14 21:00:00,64,0,4,5222,7592,12882,53688
2022-02-14 21:00:00,2022-02-14 22:00:00,64,0,4,4722,5914,10704,50057
2022-02-14 22:00:00,2022-02-14 23:00:00,62,0,4,5056,4558,9680,46694
2022-02-14 23:00:00,2022-02-15 00:00:00,62,0,4,5372,4486,9924,44712
2022-02-15 00:00:00,2022-02-15 01:00:00,64,0,4,5266,4517,9851,43219
2022-02-15 01:00:00,2022-02-15 02:00:00,64,0,4,4969,4381,9418,42339
2022-02-15 02:00:00,2022-02-15 03:00:00,64,0,4,4780,3901,8749,41894
2022-02-15 03:00:00,2022-02-15 04:00:00,64,0,4,5753,3279,9100,42326
2022-02-15 04:00:00,2022-02-15 05:00:00,65,0,4,4897,3310,8276,44489
2022-02-15 05:00:00,2022-02-15 06:00:00,62,0,4,4533,3545,8144,50106
2022-02-15 06:00:00,2022-02-15 07:00:00,64,0,3,3831,3444,7342,57195
2022-02-15 07:00:00,2022-02-15 08:00:00,62,0,50,3797,3551,7460,59494
2022-02-15 08:00:00,2022-02-15 09:00:00,65,0,168,4298,4074,8605,57417
2022-02-15 09:00:00,2022-02-15 10:00:00,58,0,320,6611,4752,11741,52659
2022-02-15 10:00:00,2022-02-15 11:00:00,59,0,429,8147,6045,14680,49151
2022-02-15 11:00:00,2022-02-15 12:00:00,56,0,406,7664,6999,15125,47992
2022-02-15 12:00:00,2022-02-15 13:00:00,57,0,534,8525,7535,16651,50542
2022-02-15 13:00:00,2022-02-15 14:00:00,57,0,370,8826,7903,17156,54189
2022-02-15 14:00:00,2022-02-15 15:00:00,58,0,130,8820,8154,17162,57538
2022-02-15 15:00:00,2022-02-15 16:00:00,56,0,25,8759,8597,17437,60844
2022-02-15 16:00:00,2022-02-15 17:00:00,57,0,7,8707,8725,17496,64199
2022-02-15 17:00:00,2022-02-15 18:00:00,58,0,8,8276,8721,17063,62750
2022-02-15 18:00:00,2022-02-15 19:00:00,58,0,8,8612,8620,17298,60228
2022-02-15 19:00:00,2022-02-15 20:00:00,60,0,8,8140,8206,16414,57016
2022-02-15 20:00:00,2022-02-15 21:00:00,60,0,8,7754,7338,15160,53542
2022-02-15 21:00:00,2022-02-15 22:00:00,60,0,8,7828,6405,14301,50011
2022-02-15 22:00:00,2022-02-15 23:00:00,60,0,8,7172,5583,12823,46904
2022-02-15 23:00:00,2022-02-16 00:00:00,61,0,8,7501,4857,12427,44540
2022-02-16 00:00:00,2022-02-16 01:00:00,60,0,8,7761,4904,12733,43036
2022-02-16 01:00:00,2022-02-16 02:00:00,60,0,8,7180,5551,12799,42378
2022-02-16 02:00:00,2022-02-16 03:00:00,60,0,8,7634,5781,13483,42578
2022-02-16 03:00:00,2022-02-16 04:00:00,60,0,8,8130,6876,15074,42925
2022-02-16 04:00:00,2022-02-16 05:00:00,60,0,8,8303,7707,16078,44874
2022-02-16 05:00:00,2022-02-16 06:00:00,60,0,8,8633,8159,16860,50005
2022-02-16 06:00:00,2022-02-16 07:00:00,61,0,8,8634,8523,17226,56618
2022-02-16 07:00:00,2022-02-16 08:00:00,59,0,27,8643,8281,17010,60314
2022-02-16 08:00:00,2022-02-16 09:00:00,60,0,96,8634,8420,17210,60396
2022-02-16 09:00:00,2022-02-16 10:00:00,60,0,162,8627,8339,17188,58179
2022-02-16 10:00:00,2022-02-16 11:00:00,60,0,277,8560,8430,17327,58183
2022-02-16 11:00:00,2022-02-16 12:00:00,60,0,196,8411,8547,17214,58189
2022-02-16 12:00:00,2022-02-16 13:00:00,60,0,142,8521,8644,17367,58524
2022-02-16 13:00:00,2022-02-16 14:00:00,60,0,120,8525,8651,17356,58496
2022-02-16 14:00:00,2022-02-16 15:00:00,60,0,53,8542,8596,17251,59312
2022-02-16 15:00:00,2022-02-16 16:00:00,66,0,25,8322,8607,17020,60861
2022-02-16 16:00:00,2022-02-16 17:00:00,64,0,7,7713,8435,16219,63684
2022-02-16 17:00:00,2022-02-16 18:00:00,60,0,4,5517,8097,13678,62239
2022-02-16 18:00:00,2022-02-16 19:00:00,61,0,4,4355,7575,11995,59762
2022-02-16 19:00:00,2022-02-16 20:00:00,61,0,4,3937,6555,10557,56401
2022-02-16 20:00:00,2022-02-16 21:00:00,60,0,4,4631,5969,10664,53133
2022-02-16 21:00:00,2022-02-16 22:00:00,61,0,4,5709,7061,12835,49915
2022-02-16 22:00:00,2022-02-16 23:00:00,61,0,4,6341,7683,14089,46958
2022-02-16 23:00:00,2022-02-17 00:00:00,62,0,4,7204,7714,14984,44930
2022-02-17 00:00:00,2022-02-17 01:00:00,61,0,4,6941,7855,14861,42892
2022-02-17 01:00:00,2022-02-17 02:00:00,62,0,4,6767,7228,14061,41679
2022-02-17 02:00:00,2022-02-17 03:00:00,61,0,4,6392,6773,13230,41157
2022-02-17 03:00:00,2022-02-17 04:00:00,61,0,4,6314,5889,12268,41330
2022-02-17 04:00:00,2022-02-17 05:00:00,60,0,4,6217,5816,12097,43875
2022-02-17 05:00:00,2022-02-17 06:00:00,60,0,4,7507,5995,13566,49398
2022-02-17 06:00:00,2022-02-17 07:00:00,60,0,5,8188,6215,14468,56100
2022-02-17 07:00:00,2022-02-17 08:00:00,60,0,51,8290,6817,15218,57659
2022-02-17 08:00:00,2022-02-17 09:00:00,61,0,144,8253,7599,16057,55169
2022-02-17 09:00:00,2022-02-17 10:00:00,60,0,258,7843,7879,16040,50915
2022-02-17 10:00:00,2022-02-17 11:00:00,60,0,458,7811,7961,16290,46935
2022-02-17 11:00:00,2022-02-17 12:00:00,60,0,648,8230,8153,17091,46359
2022-02-17 12:00:00,2022-02-17 13:00:00,60,0,578,8379,8160,17177,47441
2022-02-17 13:00:00,2022-02-17 14:00:00,60,0,415,8366,8362,17203,49786
2022-02-17 14:00:00,2022-02-17 15:00:00,61,0,221,8411,8426,17119,53842
2022-02-17 15:00:00,2022-02-17 16:00:00,61,0,83,7535,8208,15887,57718
2022-02-17 16:00:00,2022-02-17 17:00:00,60,0,18,6088,8150,14316,61817
2022-02-17 17:00:00,2022-02-17 18:00:00,60,0,4,7679,7511,15254,62542
2022-02-17 18:00:00,2022-02-17 19:00:00,60,0,4,8445,6210,14719,60793
2022-02-17 19:00:00,2022-02-17 20:00:00,60,0,4,7973,5507,13544,57577
2022-02-17 20:00:00,2022-02-17 21:00:00,60,0,4,7454,6084,13602,53866
2022-02-17 21:00:00,2022-02-17 22:00:00,60,0,4,6212,5806,12082,50268
2022-02-17 22:00:00,2022-02-17 23:00:00,60,0,4,5800,4625,10489,47040
2022-02-17 23:00:00,2022-02-18 00:00:00,62,0,4,5262,4462,9790,44670
2022-02-18 00:00:00,2022-02-18 01:00:00,60,0,4,5256,3754,9074,43174
2022-02-18 01:00:00,2022-02-18 02:00:00,60,0,4,4391,3067,7522,42218
2022-02-18 02:00:00,2022-02-18 03:00:00,61,0,4,5119,2526,7710,41930
2022-02-18 03:00:00,2022-02-18 04:00:00,60,0,4,6059,3342,9465,43081
2022-02-18 04:00:00,2022-02-18 05:00:00,60,0,4,6526,3357,9947,45273
2022-02-18 05:00:00,2022-02-18 06:00:00,60,0,4,7627,5006,12697,50141
2022-02-18 06:00:00,2022-02-18 07:00:00,62,0,4,8159,6631,14856,56383
2022-02-18 07:00:00,2022-02-18 08:00:00,61,0,17,7505,7575,15158,59811
2022-02-18 08:00:00,2022-02-18 09:00:00,64,0,40,8487,8176,16767,61334
2022-02-18 09:00:00,2022-02-18 10:00:00,64,0,60,8439,8421,16984,61141
2022-02-18 10:00:00,2022-02-18 11:00:00,64,0,104,8130,8386,16684,60160
2022-02-18 11:00:00,2022-02-18 12:00:00,64,0,116,7863,8140,16183,58582
2022-02-18 12:00:00,2022-02-18 13:00:00,64,0,106,4120,8054,12344,57568
2022-02-18 13:00:00,2022-02-18 14:00:00,64,0,106,2169,6287,8626,55331
2022-02-18 14:00:00,2022-02-18 15:00:00,62,0,161,2378,3016,5617,53848
2022-02-18 15:00:00,2022-02-18 16:00:00,63,0,47,2701,1858,4669,56350
2022-02-18 16:00:00,2022-02-18 17:00:00,60,0,6,2577,1888,4531,60421
2022-02-18 17:00:00,2022-02-18 18:00:00,62,0,4,2287,2081,4434,59940
2022-02-18 18:00:00,2022-02-18 19:00:00,63,0,4,2369,2764,5200,57159
2022-02-18 19:00:00,2022-02-18 20:00:00,60,0,4,2220,3190,5474,54111
2022-02-18 20:00:00,2022-02-18 21:00:00,61,0,4,2442,3188,5695,50651
2022-02-18 21:00:00,2022-02-18 22:00:00,61,0,4,2554,3570,6189,47714
2022-02-18 22:00:00,2022-02-18 23:00:00,61,0,4,2949,4225,7239,44956
2022-02-18 23:00:00,2022-02-19 00:00:00,60,0,4,6257,4871,11192,42649
2022-02-19 00:00:00,2022-02-19 01:00:00,60,0,4,7514,5232,12810,41293
2022-02-19 01:00:00,2022-02-19 02:00:00,60,0,4,8047,6140,14251,40498
2022-02-19 02:00:00,2022-02-19 03:00:00,61,0,4,8174,7040,15279,40634
2022-02-19 03:00:00,2022-02-19 04:00:00,61,0,4,8295,7093,15453,40583
2022-02-19 04:00:00,2022-02-19 05:00:00,61,0,4,8351,7097,15513,41188
2022-02-19 05:00:00,2022-02-19 06:00:00,60,0,4,8459,7112,15635,43531
2022-02-19 06:00:00,2022-02-19 07:00:00,61,0,7,8459,7452,15979,46579
2022-02-19 07:00:00,2022-02-19 08:00:00,60,0,108,8444,7416,16028,48362
2022-02-19 08:00:00,2022-02-19 09:00:00,61,0,259,8411,7198,15929,46482
2022-02-19 09:00:00,2022-02-19 10:00:00,60,0,494,8142,7419,16115,44497
2022-02-19 10:00:00,2022-02-19 11:00:00,60,0,392,7683,7173,15308,43219
2022-02-19 11:00:00,2022-02-19 12:00:00,60,0,407,7267,6132,13866,41988
2022-02-19 12:00:00,2022-02-19 13:00:00,61,0,501,7335,6719,14616,43752
2022-02-19 13:00:00,2022-02-19 14:00:00,60,0,405,8315,7661,16441,47269
2022-02-19 14:00:00,2022-02-19 15:00:00,60,0,184,8400,7397,16041,50563
2022-02-19 15:00:00,2022-02-19 16:00:00,61,0,53,8415,7352,15881,53247
2022-02-19 16:00:00,2022-02-19 17:00:00,60,0,5,8253,6687,15005,56528
2022-02-19 17:00:00,2022-02-19 18:00:00,59,0,4,7789,7287,15139,56541
2022-02-19 18:00:00,2022-02-19 19:00:00,60,0,4,7333,7294,14691,54731
2022-02-19 19:00:00,2022-02-19 20:00:00,60,0,4,6880,7239,14183,52176
2022-02-19 20:00:00,2022-02-19 21:00:00,60,0,4,6322,6565,12951,49519
2022-02-19 21:00:00,2022-02-19 22:00:00,60,0,4,6312,5714,12090,47314
2022-02-19 22:00:00,2022-02-19 23:00:00,61,0,4,5639,5794,11498,44890
2022-02-19 23:00:00,2022-02-20 00:00:00,62,0,4,3238,6085,9389,43380
2022-02-20 00:00:00,2022-02-20 01:00:00,61,0,4,2263,5031,7359,42027
2022-02-20 01:00:00,2022-02-20 02:00:00,64,0,4,1631,2899,4598,41243
2022-02-20 02:00:00,2022-02-20 03:00:00,63,0,4,3371,1774,5212,40475
2022-02-20 03:00:00,2022-02-20 04:00:00,62,0,4,6560,3017,9643,41415
2022-02-20 04:00:00,2022-02-20 05:00:00,62,0,4,7481,5195,12742,41585
2022-02-20 05:00:00,2022-02-20 06:00:00,60,0,4,8108,6344,14516,42590
2022-02-20 06:00:00,2022-02-20 07:00:00,63,0,3,8464,7531,16061,44227
2022-02-20 07:00:00,2022-02-20 08:00:00,61,0,16,8469,7793,16339,46729
2022-02-20 08:00:00,2022-02-20 09:00:00,60,0,60,8449,7898,16467,48909
2022-02-20 09:00:00,2022-02-20 10:00:00,60,0,119,8419,7956,16554,49930
2022-02-20 10:00:00,2022-02-20 11:00:00,60,0,132,8416,7884,16492,51148
2022-02-20 11:00:00,2022-02-20 12:00:00,60,0,117,8409,7873,16459,51810
2022-02-20 12:00:00,2022-02-20 13:00:00,61,0,88,8310,7913,16372,52185
2022-02-20 13:00:00,2022-02-20 14:00:00,61,0,51,8210,7961,16283,52092
2022-02-20 14:00:00,2022-02-20 15:00:00,60,0,29,8204,7869,16162,52167
2022-02-20 15:00:00,2022-02-20 16:00:00,60,0,9,8052,7777,15898,53451
2022-02-20 16:00:00,2022-02-20 17:00:00,62,0,3,6497,7614,14176,56437
2022-02-20 17:00:00,2022-02-20 18:00:00,62,0,4,5039,7447,12552,56425
2022-02-20 18:00:00,2022-02-20 19:00:00,61,0,4,3918,6818,10801,54531
2022-02-20 19:00:00,2022-02-20 20:00:00,62,0,4,3093,6129,9288,52356
2022-02-20 20:00:00,2022-02-20 21:00:00,64,0,4,6383,5993,12444,50161
2022-02-20 21:00:00,2022-02-20 22:00:00,63,0,4,7490,7330,14887,48100
2022-02-20 22:00:00,2022-02-20 23:00:00,63,0,4,8221,7338,15626,45442
2022-02-20 23:00:00,2022-02-21 00:00:00,62,0,4,7720,7358,15144,42982
2022-02-21 00:00:00,2022-02-21 01:00:00,63,0,4,7682,7332,15081,41871
2022-02-21 01:00:00,2022-02-21 02:00:00,63,0,4,7518,7344,14929,41496
2022-02-21 02:00:00,2022-02-21 03:00:00,63,0,4,7709,7185,14961,41499
2022-02-21 03:00:00,2022-02-21 04:00:00,62,0,4,7952,7377,15395,41940
2022-02-21 04:00:00,2022-02-21 05:00:00,62,0,4,8108,7480,15654,44427
2022-02-21 05:00:00,2022-02-21 06:00:00,60,0,4,8181,7523,15768,50068
2022-02-21 06:00:00,2022-02-21 07:00:00,60,0,6,8154,7678,15898,56154
2022-02-21 07:00:00,2022-02-21 08:00:00,60,0,32,8227,7650,15969,59111
2022-02-21 08:00:00,2022-02-21 09:00:00,60,0,37,7905,7784,15786,61126
2022-02-21 09:00:00,2022-02-21 10:00:00,61,0,55,7362,7542,15020,62397
2022-02-21 10:00:00,2022-02-21 11:00:00,60,0,82,7216,7532,14890,62283
2022-02-21 11:00:00,2022-02-21 12:00:00,62,0,86,7196,7528,14872,60834
2022-02-21 12:00:00,2022-02-21 13:00:00,60,0,178,7746,7340,15324,58634
2022-02-21 13:00:00,2022-02-21 14:00:00,60,0,293,8208,7524,16085,56746
2022-02-21 14:00:00,2022-02-21 15:00:00,61,0,231,8399,7771,16462,56644
2022-02-21 15:00:00,2022-02-21 16:00:00,62,0,134,8363,7413,15972,58700
2022-02-21 16:00:00,2022-02-21 17:00:00,61,0,13,7808,7519,15401,62598
2022-02-21 17:00:00,2022-02-21 18:00:00,62,0,4,7317,7643,15026,62760
2022-02-21 18:00:00,2022-02-21 19:00:00,60,0,4,8295,7599,15958,60606
2022-02-21 19:00:00,2022-02-21 20:00:00,60,0,4,8179,7546,15789,57756
2022-02-21 20:00:00,2022-02-21 21:00:00,61,0,4,7316,7183,14564,54012
2022-02-21 21:00:00,2022-02-21 22:00:00,62,0,4,6158,6723,12947,50570
2022-02-21 22:00:00,2022-02-21 23:00:00,63,0,4,5280,6601,11948,47658
2022-02-21 23:00:00,2022-02-22 00:00:00,63,0,4,5340,6413,11820,45067
2022-02-22 00:00:00,2022-02-22 01:00:00,63,0,4,4325,6161,10553,43269
2022-02-22 01:00:00,2022-02-22 02:00:00,64,0,4,3805,5200,9073,42421
2022-02-22 02:00:00,2022-02-22 03:00:00,64,0,4,4276,4661,9005,42267
2022-02-22 03:00:00,2022-02-22 04:00:00,63,0,4,4117,4216,8400,42858
2022-02-22 04:00:00,2022-02-22 05:00:00,62,0,4,3408,3507,6981,45031
2022-02-22 05:00:00,2022-02-22 06:00:00,60,0,4,3014,3501,6579,50298
2022-02-22 06:00:00,2022-02-22 07:00:00,62,0,20,3441,3407,6930,56033
2022-02-22 07:00:00,2022-02-22 08:00:00,64,0,154,6453,4469,11140,57781
2022-02-22 08:00:00,2022-02-22 09:00:00,62,0,327,7100,5362,12851,56573
2022-02-22 09:00:00,2022-02-22 10:00:00,60,0,290,8126,5854,14330,57273
2022-02-22 10:00:00,2022-02-22 11:00:00,60,0,280,8363,6726,15429,58348
2022-02-22 11:00:00,2022-02-22 12:00:00,60,0,186,8384,7338,15968,58970
2022-02-22 12:00:00,2022-02-22 13:00:00,60,0,119,8384,7628,16191,58482
2022-02-22 13:00:00,2022-02-22 14:00:00,60,0,81,8384,7760,16285,58348
2022-02-22 14:00:00,2022-02-22 15:00:00,61,0,53,8368,7939,16421,59237
2022-02-22 15:00:00,2022-02-22 16:00:00,61,0,22,8360,8034,16477,60800
2022-02-22 16:00:00,2022-02-22 17:00:00,63,0,4,8055,8113,16235,63192
2022-02-22 17:00:00,2022-02-22 18:00:00,63,0,4,6755,7766,14588,62274
2022-02-22 18:00:00,2022-02-22 19:00:00,61,0,4,6500,6683,13248,60301
2022-02-22 19:00:00,2022-02-22 20:00:00,61,0,4,7181,6584,13830,57527
2022-02-22 20:00:00,2022-02-22 21:00:00,60,0,4,8082,7129,15275,54287
2022-02-22 21:00:00,2022-02-22 22:00:00,63,0,4,7648,7308,15023,50962
2022-02-22 22:00:00,2022-02-22 23:00:00,61,0,4,6626,7228,13919,47937
2022-02-22 23:00:00,2022-02-23 00:00:00,61,0,4,6089,6761,12915,45036
2022-02-23 00:00:00,2022-02-23 01:00:00,60,0,4,6056,6316,12436,43413
2022-02-23 01:00:00,2022-02-23 02:00:00,60,0,4,5706,5992,11762,42829
2022-02-23 02:00:00,2022-02-23 03:00:00,60,0,4,4945,5666,10675,42582
2022-02-23 03:00:00,2022-02-23 04:00:00,60,0,4,4172,5297,9533,42985
2022-02-23 04:00:00,2022-02-23 05:00:00,60,0,4,3633,4626,8323,45400
2022-02-23 05:00:00,2022-02-23 06:00:00,60,0,4,3036,4577,7677,50798
2022-02-23 06:00:00,2022-02-23 07:00:00,60,0,22,2776,4024,6882,56306
2022-02-23 07:00:00,2022-02-23 08:00:00,61,0,197,3153,4012,7423,55705
2022-02-23 08:00:00,2022-02-23 09:00:00,59,0,480,4592,3929,9060,50578
2022-02-23 09:00:00,2022-02-23 10:00:00,61,0,714,5567,4559,10901,45871
2022-02-23 10:00:00,2022-02-23 11:00:00,61,0,877,5475,5376,11789,42691
2022-02-23 11:00:00,2022-02-23 12:00:00,63,0,930,6121,6248,13362,40941
2022-02-23 12:00:00,2022-02-23 13:00:00,63,0,877,6400,7017,14357,41761
2022-02-23 13:00:00,2022-02-23 14:00:00,61,0,737,6130,7159,14087,43659
2022-02-23 14:00:00,2022-02-23 15:00:00,60,0,503,5850,6987,13400,47755
2022-02-23 15:00:00,2022-02-23 16:00:00,62,0,214,7124,6506,13906,54395
2022-02-23 16:00:00,2022-02-23 17:00:00,60,0,22,8274,5817,14173,60784
2022-02-23 17:00:00,2022-02-23 18:00:00,60,0,8,8060,5669,13797,61593
2022-02-23 18:00:00,2022-02-23 19:00:00,60,0,4,8249,5535,13848,59618
2022-02-23 19:00:00,2022-02-23 20:00:00,60,0,4,8410,5910,14384,57242
2022-02-23 20:00:00,2022-02-23 21:00:00,60,0,4,8419,6550,15033,53945
2022-02-23 21:00:00,2022-02-23 22:00:00,61,0,4,8332,6730,15127,50446
2022-02-23 22:00:00,2022-02-23 23:00:00,62,0,4,8341,6932,15339,47468
2022-02-23 23:00:00,2022-02-24 00:00:00,62,0,4,8234,7013,15313,44431
2022-02-24 00:00:00,2022-02-24 01:00:00,64,0,4,8329,7071,15468,42848
2022-02-24 01:00:00,2022-02-24 02:00:00,63,0,4,8091,7034,15192,42031
2022-02-24 02:00:00,2022-02-24 03:00:00,64,0,4,7846,6918,14832,41500
2022-02-24 03:00:00,2022-02-24 04:00:00,63,0,4,7990,6846,14903,41974
2022-02-24 04:00:00,2022-02-24 05:00:00,62,0,4,8182,6743,14991,44254
2022-02-24 05:00:00,2022-02-24 06:00:00,62,0,4,8339,6848,15253,49060
2022-02-24 06:00:00,2022-02-24 07:00:00,63,0,14,8417,6859,15353,55017
2022-02-24 07:00:00,2022-02-24 08:00:00,60,0,121,8453,6986,15620,57167
2022-02-24 08:00:00,2022-02-24 09:00:00,60,0,350,8126,7077,15613,55723
2022-02-24 09:00:00,2022-02-24 10:00:00,60,0,502,6402,7212,14176,52151
2022-02-24 10:00:00,2022-02-24 11:00:00,61,0,624,5502,7168,13355,50243
2022-02-24 11:00:00,2022-02-24 12:00:00,61,0,556,6567,7706,14890,52735
2022-02-24 12:00:00,2022-02-24 13:00:00,60,0,313,5337,8092,13802,55574
2022-02-24 13:00:00,2022-02-24 14:00:00,60,0,97,6199,7298,13654,58861
2022-02-24 14:00:00,2022-02-24 15:00:00,61,0,84,6767,5525,12437,59144
2022-02-24 15:00:00,2022-02-24 16:00:00,60,0,62,7418,6492,14032,59385
2022-02-24 16:00:00,2022-02-24 17:00:00,60,0,18,8296,6911,15285,62399
2022-02-24 17:00:00,2022-02-24 18:00:00,60,0,4,8321,7249,15634,63095
2022-02-24 18:00:00,2022-02-24 19:00:00,61,0,4,8554,6684,15303,61359
2022-02-24 19:00:00,2022-02-24 20:00:00,60,0,4,8505,6726,15295,58534
2022-02-24 20:00:00,2022-02-24 21:00:00,60,0,4,8495,6851,15410,54847
2022-02-24 21:00:00,2022-02-24 22:00:00,60,0,4,8407,7275,15746,51497
2022-02-24 22:00:00,2022-02-24 23:00:00,63,0,4,8508,7098,15673,48657
2022-02-24 23:00:00,2022-02-25 00:00:00,61,0,4,8416,7141,15622,46166
2022-02-25 00:00:00,2022-02-25 01:00:00,60,0,4,8513,7169,15746,44344
2022-02-25 01:00:00,2022-02-25 02:00:00,61,0,4,8487,7242,15794,43405
2022-02-25 02:00:00,2022-02-25 03:00:00,63,0,4,8469,7344,15880,42959
2022-02-25 03:00:00,2022-02-25 04:00:00,63,0,4,8508,7449,16024,43336
2022-02-25 04:00:00,2022-02-25 05:00:00,64,0,4,8464,7263,15795,45229
2022-02-25 05:00:00,2022-02-25 06:00:00,62,0,4,8345,7237,15648,49943
2022-02-25 06:00:00,2022-02-25 07:00:00,61,0,14,8503,7149,15727,55544
2022-02-25 07:00:00,2022-02-25 08:00:00,60,0,129,8509,6830,15528,57004
2022-02-25 08:00:00,2022-02-25 09:00:00,64,0,401,8455,7044,15964,55197
2022-02-25 09:00:00,2022-02-25 10:00:00,63,0,426,8357,7227,16073,54020
2022-02-25 10:00:00,2022-02-25 11:00:00,64,0,461,8181,7270,15976,52702
2022-02-25 11:00:00,2022-02-25 12:00:00,63,0,624,7674,6947,15308,50529
2022-02-25 12:00:00,2022-02-25 13:00:00,64,0,708,7598,6991,15361,49380
2022-02-25 13:00:00,2022-02-25 14:00:00,64,0,547,7138,6650,14399,48679
2022-02-25 14:00:00,2022-02-25 15:00:00,64,0,438,5537,6083,12122,49747
2022-02-25 15:00:00,2022-02-25 16:00:00,63,0,206,4679,5617,10565,53223
2022-02-25 16:00:00,2022-02-25 17:00:00,63,0,30,3784,4887,8764,58682
2022-02-25 17:00:00,2022-02-25 18:00:00,63,0,4,3280,4176,7523,60357
2022-02-25 18:00:00,2022-02-25 19:00:00,64,0,4,2851,3938,6857,58452
2022-02-25 19:00:00,2022-02-25 20:00:00,64,0,4,2428,3263,5759,55587
2022-02-25 20:00:00,2022-02-25 21:00:00,64,0,4,2113,2556,4737,52414
2022-02-25 21:00:00,2022-02-25 22:00:00,65,0,4,1749,2106,3924,49777
2022-02-25 22:00:00,2022-02-25 23:00:00,64,0,4,1370,2166,3604,47278
2022-02-25 23:00:00,2022-02-26 00:00:00,63,0,4,1155,1619,2841,45002
2022-02-26 00:00:00,2022-02-26 01:00:00,61,0,4,826,1245,2136,43368
2022-02-26 01:00:00,2022-02-26 02:00:00,61,0,4,440,756,1261,42601
2022-02-26 02:00:00,2022-02-26 03:00:00,60,0,4,368,579,1011,42473
2022-02-26 03:00:00,2022-02-26 04:00:00,61,0,4,293,634,992,42217
2022-02-26 04:00:00,2022-02-26 05:00:00,59,0,4,283,570,916,42870
2022-02-26 05:00:00,2022-02-26 06:00:00,60,0,4,271,546,881,45265
2022-02-26 06:00:00,2022-02-26 07:00:00,60,0,35,381,494,970,47346
2022-02-26 07:00:00,2022-02-26 08:00:00,62,0,240,432,461,1195,46665
2022-02-26 08:00:00,2022-02-26 09:00:00,61,0,505,357,525,1448,43550
2022-02-26 09:00:00,2022-02-26 10:00:00,62,0,717,475,574,1828,39910
2022-02-26 10:00:00,2022-02-26 11:00:00,63,0,895,716,528,2202,37720
2022-02-26 11:00:00,2022-02-26 12:00:00,64,0,930,697,503,2194,36347
2022-02-26 12:00:00,2022-02-26 13:00:00,62,0,899,702,526,2189,35901
2022-02-26 13:00:00,2022-02-26 14:00:00,63,0,754,706,724,2247,36758
2022-02-26 14:00:00,2022-02-26 15:00:00,61,0,539,836,826,2262,39467
2022-02-26 15:00:00,2022-02-26 16:00:00,64,0,257,1108,978,2407,44784
2022-02-26 16:00:00,2022-02-26 17:00:00,63,0,57,1924,1404,3448,52009
2022-02-26 17:00:00,2022-02-26 18:00:00,63,0,4,2553,1528,4148,55286
2022-02-26 18:00:00,2022-02-26 19:00:00,63,0,4,2869,2244,5180,54211
2022-02-26 19:00:00,2022-02-26 20:00:00,64,0,4,4485,2543,7096,51943
2022-02-26 20:00:00,2022-02-26 21:00:00,62,0,4,3919,2995,6980,49309
2022-02-26 21:00:00,2022-02-26 22:00:00,64,0,4,5275,4109,9452,47369
2022-02-26 22:00:00,2022-02-26 23:00:00,62,0,4,5769,4692,10527,45378
2022-02-26 23:00:00,2022-02-27 00:00:00,63,0,4,5432,4682,10181,43204
2022-02-27 00:00:00,2022-02-27 01:00:00,64,0,4,5997,4312,10377,41751
2022-02-27 01:00:00,2022-02-27 02:00:00,62,0,4,6610,4040,10716,40940
2022-02-27 02:00:00,2022-02-27 03:00:00,63,0,4,6057,4229,10353,40588
2022-02-27 03:00:00,2022-02-27 04:00:00,63,0,4,6255,4146,10468,40510
2022-02-27 04:00:00,2022-02-27 05:00:00,62,0,4,5871,3736,9673,40891
2022-02-27 05:00:00,2022-02-27 06:00:00,61,0,4,5218,3561,8844,42090
2022-02-27 06:00:00,2022-02-27 07:00:00,62,0,35,4709,3960,8766,42912
2022-02-27 07:00:00,2022-02-27 08:00:00,60,0,253,4265,3826,8404,41283
2022-02-27 08:00:00,2022-02-27 09:00:00,61,0,550,4400,2954,7965,38013
2022-02-27 09:00:00,2022-02-27 10:00:00,60,0,792,4070,2861,7783,34469
2022-02-27 10:00:00,2022-02-27 11:00:00,63,0,942,4802,3354,9161,32307
2022-02-27 11:00:00,2022-02-27 12:00:00,63,0,999,4743,4163,9968,31224
2022-02-27 12:00:00,2022-02-27 13:00:00,61,0,953,4415,3716,9145,30953
2022-02-27 13:00:00,2022-02-27 14:00:00,62,0,817,3953,4324,9156,32322
2022-02-27 14:00:00,2022-02-27 15:00:00,60,0,597,3216,3985,7858,35681
2022-02-27 15:00:00,2022-02-27 16:00:00,64,0,301,3759,3695,7819,41964
2022-02-27 16:00:00,2022-02-27 17:00:00,64,0,51,4317,3152,7584,50131
2022-02-27 17:00:00,2022-02-27 18:00:00,64,0,4,6137,3337,9542,53872
2022-02-27 18:00:00,2022-02-27 19:00:00,60,0,4,7966,4591,12621,53393
2022-02-27 19:00:00,2022-02-27 20:00:00,113,0,4,8353,5713,14183,51476
2022-02-27 20:00:00,2022-02-27 21:00:00,132,0,4,8175,6140,14451,49470
2022-02-27 21:00:00,2022-02-27 22:00:00,140,0,4,7182,6248,13574,47061
2022-02-27 22:00:00,2022-02-27 23:00:00,139,0,4,6610,6343,13096,44378
2022-02-27 23:00:00,2022-02-28 00:00:00,139,0,4,6368,6095,12606,42467
2022-02-28 00:00:00,2022-02-28 01:00:00,139,0,4,6436,5676,12255,41201
2022-02-28 01:00:00,2022-02-28 02:00:00,138,0,4,7350,4826,12318,40876
2022-02-28 02:00:00,2022-02-28 03:00:00,138,0,4,7636,4302,12080,41183
2022-02-28 03:00:00,2022-02-28 04:00:00,140,0,4,7718,4263,12125,41770
2022-02-28 04:00:00,2022-02-28 05:00:00,138,0,4,7405,4225,11772,44029
2022-02-28 05:00:00,2022-02-28 06:00:00,136,0,4,6487,4155,10782,49132
2022-02-28 06:00:00,2022-02-28 07:00:00,128,0,45,5126,3729,9028,53783
2022-02-28 07:00:00,2022-02-28 08:00:00,132,0,277,3739,3000,7148,52556
2022-02-28 08:00:00,2022-02-28 09:00:00,138,0,569,3725,2637,7069,47979
2022-02-28 09:00:00,2022-02-28 10:00:00,137,0,809,3094,2409,6449,43305
2022-02-28 10:00:00,2022-02-28 11:00:00,138,0,957,2845,1975,5915,40087
2022-02-28 11:00:00,2022-02-28 12:00:00,138,0,1011,2642,1748,5539,38371
2022-02-28 12:00:00,2022-02-28 13:00:00,138,0,956,2756,2086,5936,38348
2022-02-28 13:00:00,2022-02-28 14:00:00,137,0,823,2656,2594,6210,40022
2022-02-28 14:00:00,2022-02-28 15:00:00,136,0,608,2294,2915,5953,43522
2022-02-28 15:00:00,2022-02-28 16:00:00,136,0,260,2354,2866,5616,49584
2022-02-28 16:00:00,2022-02-28 17:00:00,136,0,49,3011,3097,6293,57366
2022-02-28 17:00:00,2022-02-28 18:00:00,136,0,4,3173,3651,6964,59755
2022-02-28 18:00:00,2022-02-28 19:00:00,137,0,4,3539,4181,7861,58525
2022-02-28 19:00:00,2022-02-28 20:00:00,136,0,4,3625,3985,7750,56083
2022-02-28 20:00:00,2022-02-28 21:00:00,138,0,4,3983,3898,8023,52931
2022-02-28 21:00:00,2022-02-28 22:00:00,138,0,4,3654,4533,8329,49702
2022-02-28 22:00:00,2022-02-28 23:00:00,137,0,4,3187,4360,7688,46647
2022-02-28 23:00:00,2022-03-01 00:00:00,131,0,4,2660,3862,6657,44130
2022-03-01 00:00:00,2022-03-01 01:00:00,134,0,4,2184,3386,5708,42310
2022-03-01 01:00:00,2022-03-01 02:00:00,137,0,4,1756,2520,4417,41592
2022-03-01 02:00:00,2022-03-01 03:00:00,136,0,4,1110,2207,3457,41250
2022-03-01 03:00:00,2022-03-01 04:00:00,138,0,4,682,2103,2927,41791
2022-03-01 04:00:00,2022-03-01 05:00:00,138,0,4,405,1951,2498,44224
2022-03-01 05:00:00,2022-03-01 06:00:00,136,0,4,234,1771,2145,49345
2022-03-01 06:00:00,2022-03-01 07:00:00,130,0,28,159,1381,1698,55010
2022-03-01 07:00:00,2022-03-01 08:00:00,135,0,178,123,991,1427,56941
2022-03-01 08:00:00,2022-03-01 09:00:00,136,0,288,94,687,1205,57173
2022-03-01 09:00:00,2022-03-01 10:00:00,137,0,489,101,535,1262,55359
2022-03-01 10:00:00,2022-03-01 11:00:00,136,0,659,122,431,1348,53959
2022-03-01 11:00:00,2022-03-01 12:00:00,136,0,604,120,390,1250,52157
2022-03-01 12:00:00,2022-03-01 13:00:00,136,0,417,112,388,1053,53737
2022-03-01 13:00:00,2022-03-01 14:00:00,136,0,336,227,381,1080,54920
2022-03-01 14:00:00,2022-03-01 15:00:00,136,0,182,171,362,851,56156
2022-03-01 15:00:00,2022-03-01 16:00:00,137,0,93,99,358,687,57864
2022-03-01 16:00:00,2022-03-01 17:00:00,136,0,15,161,403,715,61291
2022-03-01 17:00:00,2022-03-01 18:00:00,136,0,4,277,530,947,61492
2022-03-01 18:00:00,2022-03-01 19:00:00,136,0,4,341,716,1197,59549
2022-03-01 19:00:00,2022-03-01 20:00:00,136,0,4,550,918,1608,56594
2022-03-01 20:00:00,2022-03-01 21:00:00,138,0,4,738,976,1856,53117
2022-03-01 21:00:00,2022-03-01 22:00:00,136,0,4,704,1130,1974,49756
2022-03-01 22:00:00,2022-03-01 23:00:00,137,0,4,1058,1221,2420,46810
2022-03-01 23:00:00,2022-03-02 00:00:00,137,0,4,1184,1206,2531,43870
2022-03-02 00:00:00,2022-03-02 01:00:00,134,0,4,964,1183,2285,42255
2022-03-02 01:00:00,2022-03-02 02:00:00,134,0,4,988,1067,2193,41574
2022-03-02 02:00:00,2022-03-02 03:00:00,134,0,4,1421,1182,2741,41603
2022-03-02 03:00:00,2022-03-02 04:00:00,134,0,4,1314,1551,3003,42113
2022-03-02 04:00:00,2022-03-02 05:00:00,136,0,4,1593,2083,3816,44015
2022-03-02 05:00:00,2022-03-02 06:00:00,136,0,4,1918,2149,4207,49629
2022-03-02 06:00:00,2022-03-02 07:00:00,136,0,43,1969,2082,4230,54389
2022-03-02 07:00:00,2022-03-02 08:00:00,136,0,241,2029,1969,4375,53405
2022-03-02 08:00:00,2022-03-02 09:00:00,136,0,515,2180,1427,4258,49153
2022-03-02 09:00:00,2022-03-02 10:00:00,136,0,777,2154,1112,4179,44413
2022-03-02 10:00:00,2022-03-02 11:00:00,137,0,930,2007,1073,4147,40950
2022-03-02 11:00:00,2022-03-02 12:00:00,137,0,992,1777,956,3862,39437
2022-03-02 12:00:00,2022-03-02 13:00:00,136,0,926,1358,957,3377,40032
2022-03-02 13:00:00,2022-03-02 14:00:00,137,0,804,1366,1188,3495,41594
2022-03-02 14:00:00,2022-03-02 15:00:00,131,0,589,1527,1409,3656,45065
2022-03-02 15:00:00,2022-03-02 16:00:00,132,0,280,1775,1631,3818,50870
2022-03-02 16:00:00,2022-03-02 17:00:00,137,0,50,1720,1708,3615,57998
2022-03-02 17:00:00,2022-03-02 18:00:00,136,0,4,1971,2203,4314,59790
2022-03-02 18:00:00,2022-03-02 19:00:00,137,0,4,2198,2941,5280,58714
2022-03-02 19:00:00,2022-03-02 20:00:00,136,0,4,2388,3509,6037,56000
2022-03-02 20:00:00,2022-03-02 21:00:00,124,0,4,2157,3762,6047,52894
2022-03-02 21:00:00,2022-03-02 22:00:00,110,0,4,2001,3741,5856,49479
2022-03-02 22:00:00,2022-03-02 23:00:00,113,0,4,1813,3519,5449,46577
2022-03-02 23:00:00,2022-03-03 00:00:00,116,0,4,1619,3355,5094,43766
2022-03-03 00:00:00,2022-03-03 01:00:00,116,0,4,1589,3354,5063,42123
2022-03-03 01:00:00,2022-03-03 02:00:00,116,0,4,1638,2863,4621,41462
2022-03-03 02:00:00,2022-03-03 03:00:00,116,0,4,1421,2459,4000,41235
2022-03-03 03:00:00,2022-03-03 04:00:00,116,0,4,1317,2282,3719,41849
2022-03-03 04:00:00,2022-03-03 05:00:00,116,0,4,1131,2088,3339,44253
2022-03-03 05:00:00,2022-03-03 06:00:00,114,0,3,1251,2452,3820,49724
2022-03-03 06:00:00,2022-03-03 07:00:00,113,0,51,1705,2789,4658,54169
2022-03-03 07:00:00,2022-03-03 08:00:00,112,0,261,1936,2508,4817,52715
2022-03-03 08:00:00,2022-03-03 09:00:00,113,0,565,1684,2044,4406,47644
2022-03-03 09:00:00,2022-03-03 10:00:00,112,0,805,1472,1297,3686,42811
2022-03-03 10:00:00,2022-03-03 11:00:00,112,0,957,1561,1464,4094,39771
2022-03-03 11:00:00,2022-03-03 12:00:00,113,0,1017,1759,2043,4932,38250
2022-03-03 12:00:00,2022-03-03 13:00:00,113,0,973,1428,1871,4385,38169
2022-03-03 13:00:00,2022-03-03 14:00:00,112,0,827,1309,1719,3967,39710
2022-03-03 14:00:00,2022-03-03 15:00:00,113,0,611,1206,1778,3708,43176
2022-03-03 15:00:00,2022-03-03 16:00:00,108,0,323,1735,2040,4206,49298
2022-03-03 16:00:00,2022-03-03 17:00:00,110,0,66,2234,2283,4693,56967
2022-03-03 17:00:00,2022-03-03 18:00:00,116,0,3,2981,3187,6287,59801
2022-03-03 18:00:00,2022-03-03 19:00:00,116,0,4,4040,4334,8494,59037
2022-03-03 19:00:00,2022-03-03 20:00:00,116,0,4,3789,4741,8650,56236
2022-03-03 20:00:00,2022-03-03 21:00:00,116,0,4,3577,4703,8400,52598
2022-03-03 21:00:00,2022-03-03 22:00:00,116,0,4,4499,4926,9545,49529
2022-03-03 22:00:00,2022-03-03 23:00:00,115,0,4,4407,4562,9088,46488
2022-03-03 23:00:00,2022-03-04 00:00:00,113,0,4,3547,4094,7758,43855
2022-03-04 00:00:00,2022-03-04 01:00:00,114,0,4,2983,3702,6803,42171
2022-03-04 01:00:00,2022-03-04 02:00:00,116,0,4,2327,3136,5583,41313
2022-03-04 02:00:00,2022-03-04 03:00:00,116,0,4,2003,2836,4959,41102
2022-03-04 03:00:00,2022-03-04 04:00:00,116,0,4,1978,2638,4736,41595
2022-03-04 04:00:00,2022-03-04 05:00:00,116,0,4,2194,2659,4973,44097
2022-03-04 05:00:00,2022-03-04 06:00:00,116,0,4,2024,2874,5018,49396
2022-03-04 06:00:00,2022-03-04 07:00:00,115,0,36,2032,2505,4688,53857
2022-03-04 07:00:00,2022-03-04 08:00:00,116,0,189,2018,1969,4292,52996
2022-03-04 08:00:00,2022-03-04 09:00:00,115,0,439,1523,1558,3635,48514
2022-03-04 09:00:00,2022-03-04 10:00:00,112,0,822,1629,1237,3800,43494
2022-03-04 10:00:00,2022-03-04 11:00:00,115,0,1018,1585,1165,3883,39819
2022-03-04 11:00:00,2022-03-04 12:00:00,116,0,1075,1409,1156,3756,37959
2022-03-04 12:00:00,2022-03-04 13:00:00,115,0,1031,1554,1162,3862,37845
2022-03-04 13:00:00,2022-03-04 14:00:00,114,0,892,1861,1461,4328,39244
2022-03-04 14:00:00,2022-03-04 15:00:00,113,0,662,1679,1487,3941,42639
2022-03-04 15:00:00,2022-03-04 16:00:00,114,0,344,1500,1798,3756,48424
2022-03-04 16:00:00,2022-03-04 17:00:00,117,0,75,1963,2096,4251,55939
2022-03-04 17:00:00,2022-03-04 18:00:00,117,0,3,2441,2648,5209,58921
2022-03-04 18:00:00,2022-03-04 19:00:00,117,0,4,2355,3135,5611,58064
2022-03-04 19:00:00,2022-03-04 20:00:00,116,0,4,2646,4292,7058,55039
2022-03-04 20:00:00,2022-03-04 21:00:00,117,0,4,3111,4826,8058,51841
2022-03-04 21:00:00,2022-03-04 22:00:00,115,0,4,3200,4153,7472,49052
2022-03-04 22:00:00,2022-03-04 23:00:00,109,0,4,3431,3653,7197,46431
2022-03-04 23:00:00,2022-03-05 00:00:00,111,0,4,3104,3330,6549,44125
2022-03-05 00:00:00,2022-03-05 01:00:00,113,0,4,2718,2805,5640,42118
2022-03-05 01:00:00,2022-03-05 02:00:00,114,0,4,2252,2132,4502,41190
2022-03-05 02:00:00,2022-03-05 03:00:00,112,0,4,2013,1685,3814,41003
2022-03-05 03:00:00,2022-03-05 04:00:00,112,0,4,1591,1489,3196,41018
2022-03-05 04:00:00,2022-03-05 05:00:00,114,0,4,1491,1696,3305,41798
2022-03-05 05:00:00,2022-03-05 06:00:00,114,0,3,1394,2117,3628,43829
2022-03-05 06:00:00,2022-03-05 07:00:00,112,0,69,1423,1831,3435,45164
2022-03-05 07:00:00,2022-03-05 08:00:00,113,0,324,1437,1509,3383,43680
2022-03-05 08:00:00,2022-03-05 09:00:00,112,0,642,1261,1051,3066,40843
2022-03-05 09:00:00,2022-03-05 10:00:00,112,0,888,1072,721,2793,37482
2022-03-05 10:00:00,2022-03-05 11:00:00,112,0,1050,756,730,2648,34485
2022-03-05 11:00:00,2022-03-05 12:00:00,112,0,1103,641,687,2543,32811
2022-03-05 12:00:00,2022-03-05 13:00:00,114,0,1049,531,645,2339,32355
2022-03-05 13:00:00,2022-03-05 14:00:00,113,0,872,868,688,2541,33409
2022-03-05 14:00:00,2022-03-05 15:00:00,114,0,595,1310,983,3002,36993
2022-03-05 15:00:00,2022-03-05 16:00:00,114,0,322,2380,1275,4091,43299
2022-03-05 16:00:00,2022-03-05 17:00:00,113,0,70,3918,1618,5719,51111
2022-03-05 17:00:00,2022-03-05 18:00:00,114,0,4,4220,2934,7272,54759
2022-03-05 18:00:00,2022-03-05 19:00:00,115,0,4,4340,3794,8253,54111
2022-03-05 19:00:00,2022-03-05 20:00:00,113,0,4,4548,4375,9040,51622
2022-03-05 20:00:00,2022-03-05 21:00:00,114,0,4,4504,4520,9142,49076
2022-03-05 21:00:00,2022-03-05 22:00:00,114,0,4,4841,4432,9391,46859
2022-03-05 22:00:00,2022-03-05 23:00:00,111,0,4,5541,4418,10074,44648
2022-03-05 23:00:00,2022-03-06 00:00:00,110,0,4,6684,4643,11441,42559
2022-03-06 00:00:00,2022-03-06 01:00:00,114,0,4,6934,4494,11546,40931
2022-03-06 01:00:00,2022-03-06 02:00:00,114,0,4,7050,4118,11286,39804
2022-03-06 02:00:00,2022-03-06 03:00:00,112,0,4,6640,4046,10802,39273
2022-03-06 03:00:00,2022-03-06 04:00:00,115,0,4,6361,4018,10498,39260
2022-03-06 04:00:00,2022-03-06 05:00:00,114,0,4,6439,4136,10693,39672
2022-03-06 05:00:00,2022-03-06 06:00:00,113,0,3,6407,4270,10793,40814
2022-03-06 06:00:00,2022-03-06 07:00:00,113,0,63,6062,4028,10266,41253
2022-03-06 07:00:00,2022-03-06 08:00:00,113,0,301,5660,3880,9954,40054
2022-03-06 08:00:00,2022-03-06 09:00:00,113,0,657,5266,3087,9123,37363
2022-03-06 09:00:00,2022-03-06 10:00:00,113,0,923,4941,2942,8919,34166
2022-03-06 10:00:00,2022-03-06 11:00:00,112,0,1084,4393,2581,8170,31573
2022-03-06 11:00:00,2022-03-06 12:00:00,113,0,1099,5012,2604,8828,31544
2022-03-06 12:00:00,2022-03-06 13:00:00,112,0,926,4929,2956,8923,32369
2022-03-06 13:00:00,2022-03-06 14:00:00,113,0,743,5508,3275,9639,34400
2022-03-06 14:00:00,2022-03-06 15:00:00,113,0,489,6070,3226,9898,37272
2022-03-06 15:00:00,2022-03-06 16:00:00,114,0,249,6449,3046,9858,42997
2022-03-06 16:00:00,2022-03-06 17:00:00,113,0,73,6663,2957,9806,50927
2022-03-06 17:00:00,2022-03-06 18:00:00,115,0,4,6787,2804,9710,54554
2022-03-06 18:00:00,2022-03-06 19:00:00,112,0,4,6652,2330,9098,54047
2022-03-06 19:00:00,2022-03-06 20:00:00,113,0,4,6182,1933,8232,51860
2022-03-06 20:00:00,2022-03-06 21:00:00,114,0,4,5206,1770,7094,49391
2022-03-06 21:00:00,2022-03-06 22:00:00,113,0,4,4493,1500,6110,47053
2022-03-06 22:00:00,2022-03-06 23:00:00,108,0,4,3555,1323,4990,44249
2022-03-06 23:00:00,2022-03-07 00:00:00,106,0,4,2936,1135,4181,42406
2022-03-07 00:00:00,2022-03-07 01:00:00,115,0,4,2403,861,3383,41240
2022-03-07 01:00:00,2022-03-07 02:00:00,113,0,4,1595,872,2584,40875
2022-03-07 02:00:00,2022-03-07 03:00:00,113,0,4,1542,800,2459,40882
2022-03-07 03:00:00,2022-03-07 04:00:00,113,0,4,1930,668,2715,41527
2022-03-07 04:00:00,2022-03-07 05:00:00,113,0,4,1981,615,2713,44206
2022-03-07 05:00:00,2022-03-07 06:00:00,113,0,4,2010,740,2867,49987
2022-03-07 06:00:00,2022-03-07 07:00:00,112,0,81,2113,867,3173,54554
2022-03-07 07:00:00,2022-03-07 08:00:00,112,0,339,2128,865,3444,52611
2022-03-07 08:00:00,2022-03-07 09:00:00,112,0,671,2338,882,4003,47960
2022-03-07 09:00:00,2022-03-07 10:00:00,115,0,840,2276,1217,4448,43352
2022-03-07 10:00:00,2022-03-07 11:00:00,119,0,985,2474,1359,4937,40626
2022-03-07 11:00:00,2022-03-07 12:00:00,124,0,1119,2356,1486,5085,39111
2022-03-07 12:00:00,2022-03-07 13:00:00,124,0,1061,2246,1651,5082,39048
2022-03-07 13:00:00,2022-03-07 14:00:00,124,0,907,3012,1912,5955,40306
2022-03-07 14:00:00,2022-03-07 15:00:00,124,0,706,4661,2427,7918,43962
2022-03-07 15:00:00,2022-03-07 16:00:00,123,0,385,5664,2722,8894,49949
2022-03-07 16:00:00,2022-03-07 17:00:00,120,0,93,6073,2507,8793,57563
2022-03-07 17:00:00,2022-03-07 18:00:00,120,0,4,6171,2494,8789,60346
2022-03-07 18:00:00,2022-03-07 19:00:00,121,0,4,6081,3262,9468,59882
2022-03-07 19:00:00,2022-03-07 20:00:00,122,0,4,5960,4094,10180,56972
2022-03-07 20:00:00,2022-03-07 21:00:00,124,0,4,5852,4644,10624,53519
2022-03-07 21:00:00,2022-03-07 22:00:00,124,0,4,5623,4934,10685,49950
2022-03-07 22:00:00,2022-03-07 23:00:00,124,0,4,5710,4978,10816,46837
2022-03-07 23:00:00,2022-03-08 00:00:00,124,0,4,6322,4640,11090,43912
2022-03-08 00:00:00,2022-03-08 01:00:00,124,0,4,6254,4575,10957,42048
2022-03-08 01:00:00,2022-03-08 02:00:00,124,0,4,6613,4777,11518,41355
2022-03-08 02:00:00,2022-03-08 03:00:00,124,0,4,6727,4179,11034,41290
2022-03-08 03:00:00,2022-03-08 04:00:00,124,0,4,6676,3905,10709,41929
2022-03-08 04:00:00,2022-03-08 05:00:00,124,0,4,6597,3881,10606,44331
2022-03-08 05:00:00,2022-03-08 06:00:00,124,0,5,6170,4380,10679,49612
2022-03-08 06:00:00,2022-03-08 07:00:00,120,0,98,5405,4480,10103,53249
2022-03-08 07:00:00,2022-03-08 08:00:00,117,0,378,5912,4267,10674,51363
2022-03-08 08:00:00,2022-03-08 09:00:00,117,0,705,5935,4111,10868,46788
2022-03-08 09:00:00,2022-03-08 10:00:00,117,0,962,5772,4235,11086,42396
2022-03-08 10:00:00,2022-03-08 11:00:00,117,0,1117,5020,4984,11238,39268
2022-03-08 11:00:00,2022-03-08 12:00:00,116,0,1174,4270,5067,10627,37214
2022-03-08 12:00:00,2022-03-08 13:00:00,117,0,1132,3770,4892,9911,37534
2022-03-08 13:00:00,2022-03-08 14:00:00,120,0,963,4120,4552,9755,39224
2022-03-08 14:00:00,2022-03-08 15:00:00,124,0,714,3873,4285,8996,43035
2022-03-08 15:00:00,2022-03-08 16:00:00,124,0,388,3625,4078,8215,48835
2022-03-08 16:00:00,2022-03-08 17:00:00,125,0,94,4505,3887,8611,56256
2022-03-08 17:00:00,2022-03-08 18:00:00,124,0,4,5467,3727,9322,59507
2022-03-08 18:00:00,2022-03-08 19:00:00,125,0,4,5513,3630,9272,59196
2022-03-08 19:00:00,2022-03-08 20:00:00,124,0,4,4954,3739,8821,56149
2022-03-08 20:00:00,2022-03-08 21:00:00,125,0,4,4812,4113,9054,52689
2022-03-08 21:00:00,2022-03-08 22:00:00,127,0,4,5447,4089,9667,49560
2022-03-08 22:00:00,2022-03-08 23:00:00,123,0,4,5124,3899,9150,46726
2022-03-08 23:00:00,2022-03-09 00:00:00,123,0,4,4392,4293,8812,43531
2022-03-09 00:00:00,2022-03-09 01:00:00,124,0,4,3570,4419,8117,41762
2022-03-09 01:00:00,2022-03-09 02:00:00,124,0,4,2950,4347,7425,40828
2022-03-09 02:00:00,2022-03-09 03:00:00,124,0,4,3327,3809,7264,40739
2022-03-09 03:00:00,2022-03-09 04:00:00,124,0,4,3270,3428,6826,41331
2022-03-09 04:00:00,2022-03-09 05:00:00,124,0,4,3014,3100,6242,43709
2022-03-09 05:00:00,2022-03-09 06:00:00,124,0,5,2392,2924,5445,48990
2022-03-09 06:00:00,2022-03-09 07:00:00,124,0,100,2207,2785,5216,52698
2022-03-09 07:00:00,2022-03-09 08:00:00,123,0,383,2117,2301,4924,50991
2022-03-09 08:00:00,2022-03-09 09:00:00,124,0,731,2090,1770,4715,46519
2022-03-09 09:00:00,2022-03-09 10:00:00,124,0,987,1466,1353,3930,41748
2022-03-09 10:00:00,2022-03-09 11:00:00,126,0,1135,1263,1305,3829,38742
2022-03-09 11:00:00,2022-03-09 12:00:00,127,0,1186,1671,1496,4480,36993
2022-03-09 12:00:00,2022-03-09 13:00:00,125,0,1147,2026,1508,4806,37339
2022-03-09 13:00:00,2022-03-09 14:00:00,124,0,980,2313,1439,4856,38926
2022-03-09 14:00:00,2022-03-09 15:00:00,124,0,724,2662,1230,4740,42302
2022-03-09 15:00:00,2022-03-09 16:00:00,124,0,400,2832,1143,4499,48280
2022-03-09 16:00:00,2022-03-09 17:00:00,125,0,106,3144,1288,4663,56050
2022-03-09 17:00:00,2022-03-09 18:00:00,124,0,5,3393,2076,5598,58771
2022-03-09 18:00:00,2022-03-09 19:00:00,126,0,4,3454,3092,6676,58415
2022-03-09 19:00:00,2022-03-09 20:00:00,126,0,4,3173,3121,6424,55441
2022-03-09 20:00:00,2022-03-09 21:00:00,126,0,4,3163,2988,6281,52142
2022-03-09 21:00:00,2022-03-09 22:00:00,126,0,4,3438,2930,6498,48710
2022-03-09 22:00:00,2022-03-09 23:00:00,124,0,4,3392,3098,6618,45862
2022-03-09 23:00:00,2022-03-10 00:00:00,125,0,4,2826,2535,5490,43335
2022-03-10 00:00:00,2022-03-10 01:00:00,124,0,4,3019,2164,5311,41620
2022-03-10 01:00:00,2022-03-10 02:00:00,126,0,4,3028,2385,5543,41017
2022-03-10 02:00:00,2022-03-10 03:00:00,125,0,4,2477,2238,4844,40933
2022-03-10 03:00:00,2022-03-10 04:00:00,126,0,4,1825,1945,3900,41382
2022-03-10 04:00:00,2022-03-10 05:00:00,125,0,4,1522,1902,3553,43580
2022-03-10 05:00:00,2022-03-10 06:00:00,124,0,6,1655,1960,3745,48548
2022-03-10 06:00:00,2022-03-10 07:00:00,124,0,112,1641,2150,4027,52657
2022-03-10 07:00:00,2022-03-10 08:00:00,120,0,382,1796,2185,4483,51223
2022-03-10 08:00:00,2022-03-10 09:00:00,122,0,719,1962,1906,4709,46467
2022-03-10 09:00:00,2022-03-10 10:00:00,124,0,968,1952,1377,4421,41535
2022-03-10 10:00:00,2022-03-10 11:00:00,124,0,1117,2225,1209,4675,38464
2022-03-10 11:00:00,2022-03-10 12:00:00,125,0,1170,2464,1485,5244,36709
2022-03-10 12:00:00,2022-03-10 13:00:00,124,0,1123,3139,2246,6632,36785
2022-03-10 13:00:00,2022-03-10 14:00:00,125,0,960,3468,2500,7053,38595
2022-03-10 14:00:00,2022-03-10 15:00:00,125,0,707,3338,2503,6673,42539
2022-03-10 15:00:00,2022-03-10 16:00:00,124,0,382,3194,2630,6330,48388
2022-03-10 16:00:00,2022-03-10 17:00:00,125,0,104,3523,3265,7017,55524
2022-03-10 17:00:00,2022-03-10 18:00:00,125,0,5,4435,3606,8171,58369
2022-03-10 18:00:00,2022-03-10 19:00:00,124,0,4,4724,4142,8994,58431
2022-03-10 19:00:00,2022-03-10 20:00:00,125,0,4,4930,5288,10347,55979
2022-03-10 20:00:00,2022-03-10 21:00:00,126,0,4,4721,6117,10968,52268
2022-03-10 21:00:00,2022-03-10 22:00:00,128,0,4,4965,6396,11493,49092
2022-03-10 22:00:00,2022-03-10 23:00:00,126,0,4,5299,6438,11867,46205
2022-03-10 23:00:00,2022-03-11 00:00:00,128,0,4,5916,6544,12592,43816
2022-03-11 00:00:00,2022-03-11 01:00:00,128,0,4,7495,6783,14410,42284
2022-03-11 01:00:00,2022-03-11 02:00:00,128,0,4,7442,6867,14441,41238
2022-03-11 02:00:00,2022-03-11 03:00:00,128,0,4,7348,7121,14601,40856
2022-03-11 03:00:00,2022-03-11 04:00:00,128,0,4,8303,7158,15593,41275
2022-03-11 04:00:00,2022-03-11 05:00:00,127,0,4,8240,7122,15493,43417
2022-03-11 05:00:00,2022-03-11 06:00:00,128,0,5,8476,7062,15671,48203
2022-03-11 06:00:00,2022-03-11 07:00:00,123,0,104,8585,6121,14933,51566
2022-03-11 07:00:00,2022-03-11 08:00:00,122,0,406,8525,5603,14656,49738
2022-03-11 08:00:00,2022-03-11 09:00:00,128,0,763,7920,5518,14329,45940
2022-03-11 09:00:00,2022-03-11 10:00:00,128,0,1006,7725,5165,14024,41659
2022-03-11 10:00:00,2022-03-11 11:00:00,127,0,1145,8010,5341,14623,38889
2022-03-11 11:00:00,2022-03-11 12:00:00,128,0,1188,7876,5795,14987,37419
2022-03-11 12:00:00,2022-03-11 13:00:00,128,0,1140,7893,6301,15462,37687
2022-03-11 13:00:00,2022-03-11 14:00:00,128,0,973,8135,6620,15856,39341
2022-03-11 14:00:00,2022-03-11 15:00:00,125,0,690,8516,6895,16226,43364
2022-03-11 15:00:00,2022-03-11 16:00:00,124,0,382,8874,6669,16049,49835
2022-03-11 16:00:00,2022-03-11 17:00:00,126,0,95,8872,6598,15691,55747
2022-03-11 17:00:00,2022-03-11 18:00:00,125,0,4,9203,6890,16222,57202
2022-03-11 18:00:00,2022-03-11 19:00:00,127,0,4,9056,6614,15801,56274
2022-03-11 19:00:00,2022-03-11 20:00:00,128,0,4,9032,6577,15741,53304
2022-03-11 20:00:00,2022-03-11 21:00:00,127,0,4,8645,6864,15640,50405
2022-03-11 21:00:00,2022-03-11 22:00:00,129,0,4,8883,6786,15802,47465
2022-03-11 22:00:00,2022-03-11 23:00:00,125,0,4,8850,6489,15468,45009
2022-03-11 23:00:00,2022-03-12 00:00:00,124,0,4,8946,6605,15679,42160
2022-03-12 00:00:00,2022-03-12 01:00:00,124,0,4,9024,6973,16125,40494
2022-03-12 01:00:00,2022-03-12 02:00:00,126,0,4,9068,7007,16205,39655
2022-03-12 02:00:00,2022-03-12 03:00:00,127,0,4,9055,6944,16130,39409
2022-03-12 03:00:00,2022-03-12 04:00:00,128,0,4,9081,6657,15870,39356
2022-03-12 04:00:00,2022-03-12 05:00:00,128,0,4,8992,6321,15445,39824
2022-03-12 05:00:00,2022-03-12 06:00:00,128,0,5,8816,6275,15224,41591
2022-03-12 06:00:00,2022-03-12 07:00:00,121,0,44,8545,5981,14691,42737
2022-03-12 07:00:00,2022-03-12 08:00:00,122,0,298,8034,5492,13946,42705
2022-03-12 08:00:00,2022-03-12 09:00:00,127,0,589,7005,5280,13001,41399
2022-03-12 09:00:00,2022-03-12 10:00:00,128,0,795,6636,5461,13020,40449
2022-03-12 10:00:00,2022-03-12 11:00:00,128,0,930,5923,4846,11827,38534
2022-03-12 11:00:00,2022-03-12 12:00:00,128,0,937,4788,3932,9785,36155
2022-03-12 12:00:00,2022-03-12 13:00:00,128,0,777,3536,3278,7719,35285
2022-03-12 13:00:00,2022-03-12 14:00:00,126,0,615,2326,2469,5536,37433
2022-03-12 14:00:00,2022-03-12 15:00:00,124,0,458,2372,1763,4717,40040
2022-03-12 15:00:00,2022-03-12 16:00:00,124,0,236,3248,1464,5072,43807
2022-03-12 16:00:00,2022-03-12 17:00:00,125,0,99,3860,1807,5891,49633
2022-03-12 17:00:00,2022-03-12 18:00:00,126,0,5,3087,2893,6111,52514
2022-03-12 18:00:00,2022-03-12 19:00:00,126,0,4,3114,4126,7370,51797
2022-03-12 19:00:00,2022-03-12 20:00:00,125,0,4,4155,4625,8909,49528
2022-03-12 20:00:00,2022-03-12 21:00:00,126,0,4,6083,4901,11114,47233
2022-03-12 21:00:00,2022-03-12 22:00:00,127,0,4,7923,5292,13346,45243
2022-03-12 22:00:00,2022-03-12 23:00:00,128,0,4,7466,5348,12946,42668
2022-03-12 23:00:00,2022-03-13 00:00:00,172,0,4,7644,5427,13247,40375
2022-03-13 00:00:00,2022-03-13 01:00:00,180,0,4,7357,5063,12604,38986
2022-03-13 01:00:00,2022-03-13 02:00:00,180,0,4,7974,5166,13324,38129
2022-03-13 02:00:00,2022-03-13 03:00:00,180,0,4,8563,4594,13341,38213
2022-03-13 03:00:00,2022-03-13 04:00:00,180,0,4,8320,4192,12696,38054
2022-03-13 04:00:00,2022-03-13 05:00:00,180,0,4,7756,4289,12229,38106
2022-03-13 05:00:00,2022-03-13 06:00:00,179,0,16,7023,4501,11719,38730
2022-03-13 06:00:00,2022-03-13 07:00:00,175,0,119,7042,4848,12184,39814
2022-03-13 07:00:00,2022-03-13 08:00:00,173,0,242,7460,4228,12103,40244
2022-03-13 08:00:00,2022-03-13 09:00:00,178,0,563,7199,3596,11536,38365
2022-03-13 09:00:00,2022-03-13 10:00:00,176,0,853,6090,3400,10519,33962
2022-03-13 10:00:00,2022-03-13 11:00:00,176,0,918,4923,3210,9227,31392
2022-03-13 11:00:00,2022-03-13 12:00:00,176,0,917,3844,3179,8116,30412
2022-03-13 12:00:00,2022-03-13 13:00:00,174,0,1089,3286,3383,7932,30337
2022-03-13 13:00:00,2022-03-13 14:00:00,176,0,883,3397,3633,8089,32166
2022-03-13 14:00:00,2022-03-13 15:00:00,176,0,620,2989,4088,7873,35394
2022-03-13 15:00:00,2022-03-13 16:00:00,175,0,304,3486,3589,7554,40992
2022-03-13 16:00:00,2022-03-13 17:00:00,172,0,74,3992,3375,7613,48290
2022-03-13 17:00:00,2022-03-13 18:00:00,173,0,5,5051,3480,8709,51632
2022-03-13 18:00:00,2022-03-13 19:00:00,158,0,4,5266,3994,9422,51428
2022-03-13 19:00:00,2022-03-13 20:00:00,130,0,4,5241,4681,10056,49291
2022-03-13 20:00:00,2022-03-13 21:00:00,127,0,4,5023,4268,9422,46770
2022-03-13 21:00:00,2022-03-13 22:00:00,128,0,4,4736,3434,8302,44214
2022-03-13 22:00:00,2022-03-13 23:00:00,127,0,4,3917,3297,7345,41927
2022-03-13 23:00:00,2022-03-14 00:00:00,124,0,4,3719,2704,6551,40202
2022-03-14 00:00:00,2022-03-14 01:00:00,124,0,4,3408,2354,5890,38967
2022-03-14 01:00:00,2022-03-14 02:00:00,126,0,4,1763,2361,4254,37733
2022-03-14 02:00:00,2022-03-14 03:00:00,127,0,4,1314,2552,3997,37816
2022-03-14 03:00:00,2022-03-14 04:00:00,125,0,4,1579,3003,4711,38595
2022-03-14 04:00:00,2022-03-14 05:00:00,126,0,4,1266,2855,4251,41010
2022-03-14 05:00:00,2022-03-14 06:00:00,125,0,4,912,2197,3238,46176
2022-03-14 06:00:00,2022-03-14 07:00:00,120,0,24,1018,2775,3937,51858
2022-03-14 07:00:00,2022-03-14 08:00:00,121,0,80,1158,2939,4298,54273
2022-03-14 08:00:00,2022-03-14 09:00:00,125,0,145,989,2154,3413,53903
2022-03-14 09:00:00,2022-03-14 10:00:00,126,0,216,1017,2282,3641,52000
2022-03-14 10:00:00,2022-03-14 11:00:00,150,0,260,774,2797,3981,48955
2022-03-14 11:00:00,2022-03-14 12:00:00,179,0,318,1051,2825,4373,45858
2022-03-14 12:00:00,2022-03-14 13:00:00,177,0,410,1053,2885,4525,43849
2022-03-14 13:00:00,2022-03-14 14:00:00,176,0,557,842,3100,4675,43141
2022-03-14 14:00:00,2022-03-14 15:00:00,173,0,517,1124,2479,4293,43704
2022-03-14 15:00:00,2022-03-14 16:00:00,173,0,418,1387,1891,3869,47973
2022-03-14 16:00:00,2022-03-14 17:00:00,177,0,126,1177,1353,2833,55290
2022-03-14 17:00:00,2022-03-14 18:00:00,176,0,6,799,1333,2314,57774
2022-03-14 18:00:00,2022-03-14 19:00:00,176,0,4,955,1085,2220,57916
2022-03-14 19:00:00,2022-03-14 20:00:00,176,0,4,960,812,1952,55521
2022-03-14 20:00:00,2022-03-14 21:00:00,176,0,4,937,547,1664,52402
2022-03-14 21:00:00,2022-03-14 22:00:00,176,0,4,690,528,1398,48715
2022-03-14 22:00:00,2022-03-14 23:00:00,176,0,4,643,596,1419,45761
2022-03-14 23:00:00,2022-03-15 00:00:00,176,0,4,663,642,1485,43159
2022-03-15 00:00:00,2022-03-15 01:00:00,176,0,4,445,840,1465,41483
2022-03-15 01:00:00,2022-03-15 02:00:00,176,0,4,432,784,1396,40686
2022-03-15 02:00:00,2022-03-15 03:00:00,176,0,4,449,721,1350,40722
2022-03-15 03:00:00,2022-03-15 04:00:00,177,0,4,576,680,1437,41016
2022-03-15 04:00:00,2022-03-15 05:00:00,176,0,4,590,662,1432,42980
2022-03-15 05:00:00,2022-03-15 06:00:00,176,0,5,417,672,1270,47932
2022-03-15 06:00:00,2022-03-15 07:00:00,176,0,51,568,684,1479,53390
2022-03-15 07:00:00,2022-03-15 08:00:00,176,0,109,883,612,1780,55636
2022-03-15 08:00:00,2022-03-15 09:00:00,176,0,132,345,448,1101,54884
2022-03-15 09:00:00,2022-03-15 10:00:00,176,0,239,237,394,1046,52399
2022-03-15 10:00:00,2022-03-15 11:00:00,176,0,380,311,422,1289,49869
2022-03-15 11:00:00,2022-03-15 12:00:00,176,0,454,382,397,1409,46398
2022-03-15 12:00:00,2022-03-15 13:00:00,176,0,541,119,388,1224,44131
2022-03-15 13:00:00,2022-03-15 14:00:00,177,0,729,178,392,1476,44823
2022-03-15 14:00:00,2022-03-15 15:00:00,172,0,437,485,514,1608,46729
2022-03-15 15:00:00,2022-03-15 16:00:00,173,0,283,379,577,1412,49680
2022-03-15 16:00:00,2022-03-15 17:00:00,176,0,78,340,597,1191,56510
2022-03-15 17:00:00,2022-03-15 18:00:00,176,0,4,428,850,1458,58201
2022-03-15 18:00:00,2022-03-15 19:00:00,176,0,4,687,1124,1991,57729
2022-03-15 19:00:00,2022-03-15 20:00:00,176,0,4,1169,1265,2614,55042
2022-03-15 20:00:00,2022-03-15 21:00:00,176,0,4,1958,1426,3564,52170
2022-03-15 21:00:00,2022-03-15 22:00:00,176,0,4,2257,1643,4080,48979
2022-03-15 22:00:00,2022-03-15 23:00:00,175,0,4,1916,1713,3808,46018
2022-03-15 23:00:00,2022-03-16 00:00:00,176,0,4,1464,1475,3119,43276
2022-03-16 00:00:00,2022-03-16 01:00:00,176,0,4,1606,1357,3143,41381
2022-03-16 01:00:00,2022-03-16 02:00:00,177,0,4,1949,1347,3477,40878
2022-03-16 02:00:00,2022-03-16 03:00:00,177,0,4,1953,1320,3454,40711
2022-03-16 03:00:00,2022-03-16 04:00:00,178,0,4,2773,1613,4568,40978
2022-03-16 04:00:00,2022-03-16 05:00:00,177,0,4,3421,2117,5719,42988
2022-03-16 05:00:00,2022-03-16 06:00:00,179,0,8,2595,2832,5614,47255
2022-03-16 06:00:00,2022-03-16 07:00:00,177,0,90,1937,3320,5524,50731
2022-03-16 07:00:00,2022-03-16 08:00:00,177,0,293,2140,3479,6089,49332
2022-03-16 08:00:00,2022-03-16 09:00:00,178,0,628,2312,3130,6248,45289
2022-03-16 09:00:00,2022-03-16 10:00:00,178,0,951,2174,3006,6309,41041
2022-03-16 10:00:00,2022-03-16 11:00:00,179,0,981,1744,3319,6223,39125
2022-03-16 11:00:00,2022-03-16 12:00:00,177,0,1048,1933,3539,6697,40763
2022-03-16 12:00:00,2022-03-16 13:00:00,173,0,1045,2828,3539,7585,45000
2022-03-16 13:00:00,2022-03-16 14:00:00,177,0,732,4966,3821,9696,48156
2022-03-16 14:00:00,2022-03-16 15:00:00,178,0,359,6459,4281,11277,50938
2022-03-16 15:00:00,2022-03-16 16:00:00,176,0,213,6829,4317,11535,54759
2022-03-16 16:00:00,2022-03-16 17:00:00,169,0,68,7228,4195,11660,58615
2022-03-16 17:00:00,2022-03-16 18:00:00,172,0,4,6775,4317,11268,58589
2022-03-16 18:00:00,2022-03-16 19:00:00,172,0,4,6512,4491,11179,57728
2022-03-16 19:00:00,2022-03-16 20:00:00,157,0,4,5770,4784,10715,54967
2022-03-16 20:00:00,2022-03-16 21:00:00,172,0,4,5964,5087,11227,51705
2022-03-16 21:00:00,2022-03-16 22:00:00,171,0,4,6806,5364,12345,48290
2022-03-16 22:00:00,2022-03-16 23:00:00,169,0,4,6748,5393,12314,45465
2022-03-16 23:00:00,2022-03-17 00:00:00,171,0,4,6883,5287,12345,42822
2022-03-17 00:00:00,2022-03-17 01:00:00,170,0,4,8887,5654,14715,41270
2022-03-17 01:00:00,2022-03-17 02:00:00,167,0,4,8766,5946,14883,40376
2022-03-17 02:00:00,2022-03-17 03:00:00,167,0,4,8607,6065,14843,40017
2022-03-17 03:00:00,2022-03-17 04:00:00,140,0,4,8724,6361,15229,40410
2022-03-17 04:00:00,2022-03-17 05:00:00,125,0,4,8678,6119,14926,42549
2022-03-17 05:00:00,2022-03-17 06:00:00,103,0,3,7511,6534,14151,47285
2022-03-17 06:00:00,2022-03-17 07:00:00,94,0,31,5444,6293,11862,52400
2022-03-17 07:00:00,2022-03-17 08:00:00,32,0,96,4239,5442,9809,54784
2022-03-17 08:00:00,2022-03-17 09:00:00,12,0,187,3752,4339,8290,53079
2022-03-17 09:00:00,2022-03-17 10:00:00,10,0,356,3630,3886,7882,48851
2022-03-17 10:00:00,2022-03-17 11:00:00,8,0,710,3103,3758,7579,45053
2022-03-17 11:00:00,2022-03-17 12:00:00,8,0,978,2516,3730,7232,41540
2022-03-17 12:00:00,2022-03-17 13:00:00,8,0,1108,2033,2859,6008,39887
2022-03-17 13:00:00,2022-03-17 14:00:00,8,0,1070,1526,2052,4656,39781
2022-03-17 14:00:00,2022-03-17 15:00:00,8,0,833,1291,1546,3678,42192
2022-03-17 15:00:00,2022-03-17 16:00:00,8,0,508,1258,1287,3061,47437
2022-03-17 16:00:00,2022-03-17 17:00:00,8,0,162,1350,1159,2679,54618
2022-03-17 17:00:00,2022-03-17 18:00:00,8,0,11,1349,889,2257,58080
2022-03-17 18:00:00,2022-03-17 19:00:00,8,0,4,1817,817,2646,58924
2022-03-17 19:00:00,2022-03-17 20:00:00,8,0,4,1647,968,2627,56350
2022-03-17 20:00:00,2022-03-17 21:00:00,8,0,4,1703,983,2698,53392
2022-03-17 21:00:00,2022-03-17 22:00:00,8,0,4,1537,1003,2552,49885
2022-03-17 22:00:00,2022-03-17 23:00:00,8,0,4,1633,1077,2722,46771
2022-03-17 23:00:00,2022-03-18 00:00:00,8,0,4,1677,1293,2982,44295
2022-03-18 00:00:00,2022-03-18 01:00:00,8,0,4,1419,1299,2730,42362
2022-03-18 01:00:00,2022-03-18 02:00:00,8,0,4,1098,1232,2342,41519
2022-03-18 02:00:00,2022-03-18 03:00:00,8,0,4,757,1243,2012,41464
2022-03-18 03:00:00,2022-03-18 04:00:00,8,0,4,623,1129,1764,41845
2022-03-18 04:00:00,2022-03-18 05:00:00,8,0,4,485,763,1260,44054
2022-03-18 05:00:00,2022-03-18 06:00:00,8,0,14,266,580,868,48460
2022-03-18 06:00:00,2022-03-18 07:00:00,8,0,173,245,493,919,50580
2022-03-18 07:00:00,2022-03-18 08:00:00,8,0,483,496,509,1496,48429
2022-03-18 08:00:00,2022-03-18 09:00:00,8,0,807,429,451,1695,44294
2022-03-18 09:00:00,2022-03-18 10:00:00,5,0,1052,350,408,1815,40120
2022-03-18 10:00:00,2022-03-18 11:00:00,4,0,1187,299,431,1921,37210
2022-03-18 11:00:00,2022-03-18 12:00:00,4,0,1208,375,552,2139,35117
2022-03-18 12:00:00,2022-03-18 13:00:00,4,0,1094,518,897,2513,35742
2022-03-18 13:00:00,2022-03-18 14:00:00,4,0,904,481,1463,2852,37001
2022-03-18 14:00:00,2022-03-18 15:00:00,4,0,761,827,1855,3447,39986
2022-03-18 15:00:00,2022-03-18 16:00:00,4,0,471,2215,2089,4779,45273
2022-03-18 16:00:00,2022-03-18 17:00:00,4,0,157,4477,2428,7066,52387
2022-03-18 17:00:00,2022-03-18 18:00:00,4,0,11,5898,2985,8898,55413
2022-03-18 18:00:00,2022-03-18 19:00:00,4,0,4,6094,4050,10152,55887
2022-03-18 19:00:00,2022-03-18 20:00:00,4,0,4,6325,4892,11225,53279
2022-03-18 20:00:00,2022-03-18 21:00:00,4,0,4,6859,5391,12258,49999
2022-03-18 21:00:00,2022-03-18 22:00:00,4,0,4,6652,5543,12203,46916
2022-03-18 22:00:00,2022-03-18 23:00:00,4,0,4,6620,5124,11752,44486
2022-03-18 23:00:00,2022-03-19 00:00:00,4,0,4,6790,5252,12050,42105
2022-03-19 00:00:00,2022-03-19 01:00:00,4,0,4,6823,5346,12177,40326
2022-03-19 01:00:00,2022-03-19 02:00:00,4,0,4,6339,5322,11669,39349
2022-03-19 02:00:00,2022-03-19 03:00:00,4,0,4,6407,5056,11471,38847
2022-03-19 03:00:00,2022-03-19 04:00:00,4,0,4,6129,4987,11124,38528
2022-03-19 04:00:00,2022-03-19 05:00:00,4,0,4,6011,4832,10851,39026
2022-03-19 05:00:00,2022-03-19 06:00:00,4,0,17,6332,5093,11446,40452
2022-03-19 06:00:00,2022-03-19 07:00:00,4,0,182,6300,4941,11427,40128
2022-03-19 07:00:00,2022-03-19 08:00:00,4,0,531,6116,4274,10925,38192
2022-03-19 08:00:00,2022-03-19 09:00:00,4,0,819,5966,4200,10989,35669
2022-03-19 09:00:00,2022-03-19 10:00:00,4,0,1050,4988,4833,10875,32599
2022-03-19 10:00:00,2022-03-19 11:00:00,4,0,1022,3391,4791,9208,30276
2022-03-19 11:00:00,2022-03-19 12:00:00,4,0,987,1061,4415,6467,28953
2022-03-19 12:00:00,2022-03-19 13:00:00,4,0,970,1415,4745,7134,28902
2022-03-19 13:00:00,2022-03-19 14:00:00,4,0,860,2912,5085,8861,30320
2022-03-19 14:00:00,2022-03-19 15:00:00,4,0,669,5190,5778,11641,33545
2022-03-19 15:00:00,2022-03-19 16:00:00,4,0,498,7133,6969,14604,39154
2022-03-19 16:00:00,2022-03-19 17:00:00,4,0,169,8069,7477,15719,46589
2022-03-19 17:00:00,2022-03-19 18:00:00,4,0,12,8817,7124,15957,50642
2022-03-19 18:00:00,2022-03-19 19:00:00,4,0,4,8896,6889,15793,51419
2022-03-19 19:00:00,2022-03-19 20:00:00,4,0,4,8968,7066,16042,49680
2022-03-19 20:00:00,2022-03-19 21:00:00,4,0,4,8968,7078,16054,47656
2022-03-19 21:00:00,2022-03-19 22:00:00,4,0,4,8871,7044,15923,45243
2022-03-19 22:00:00,2022-03-19 23:00:00,4,0,4,8594,7302,15904,42771
2022-03-19 23:00:00,2022-03-20 00:00:00,4,0,4,7548,7023,14579,40544
2022-03-20 00:00:00,2022-03-20 01:00:00,4,0,4,7169,6735,13912,39005
2022-03-20 01:00:00,2022-03-20 02:00:00,4,0,4,7379,6754,14141,38313
2022-03-20 02:00:00,2022-03-20 03:00:00,4,0,4,7305,6658,13971,37944
2022-03-20 03:00:00,2022-03-20 04:00:00,4,0,4,7907,6491,14406,37848
2022-03-20 04:00:00,2022-03-20 05:00:00,4,0,4,8007,6373,14388,38295
2022-03-20 05:00:00,2022-03-20 06:00:00,4,0,17,7105,5948,13074,38606
2022-03-20 06:00:00,2022-03-20 07:00:00,4,0,157,6341,5380,11882,38561
2022-03-20 07:00:00,2022-03-20 08:00:00,4,0,424,5851,5237,11516,38597
2022-03-20 08:00:00,2022-03-20 09:00:00,4,0,710,4643,5235,10592,39600
2022-03-20 09:00:00,2022-03-20 10:00:00,4,0,908,3467,4007,8386,39974
2022-03-20 10:00:00,2022-03-20 11:00:00,4,0,1020,2704,2896,6624,39635
2022-03-20 11:00:00,2022-03-20 12:00:00,4,0,1013,2527,2796,6340,41539
2022-03-20 12:00:00,2022-03-20 13:00:00,4,0,810,2673,2709,6196,41167
2022-03-20 13:00:00,2022-03-20 14:00:00,4,0,702,2446,2731,5883,41253
2022-03-20 14:00:00,2022-03-20 15:00:00,4,0,292,2479,3923,6698,41737
2022-03-20 15:00:00,2022-03-20 16:00:00,4,0,138,2245,2882,5269,43950
2022-03-20 16:00:00,2022-03-20 17:00:00,4,0,41,1581,2245,3871,48810
2022-03-20 17:00:00,2022-03-20 18:00:00,4,0,8,1876,1842,3730,51688
2022-03-20 18:00:00,2022-03-20 19:00:00,4,0,4,2085,1932,4025,52340
2022-03-20 19:00:00,2022-03-20 20:00:00,4,0,4,847,2027,2882,50312
2022-03-20 20:00:00,2022-03-20 21:00:00,4,0,4,1001,2015,3024,48285
2022-03-20 21:00:00,2022-03-20 22:00:00,4,0,4,818,1614,2440,45585
2022-03-20 22:00:00,2022-03-20 23:00:00,4,0,4,943,1545,2496,42611
2022-03-20 23:00:00,2022-03-21 00:00:00,4,0,4,1024,1908,2940,40874
2022-03-21 00:00:00,2022-03-21 01:00:00,4,0,4,759,2051,2818,39759
2022-03-21 01:00:00,2022-03-21 02:00:00,4,0,4,1089,2107,3204,39356
2022-03-21 02:00:00,2022-03-21 03:00:00,4,0,4,1601,1962,3571,39199
2022-03-21 03:00:00,2022-03-21 04:00:00,4,0,4,1669,1970,3647,39724
2022-03-21 04:00:00,2022-03-21 05:00:00,4,0,4,1420,1943,3371,42256
2022-03-21 05:00:00,2022-03-21 06:00:00,4,0,20,1171,1735,2930,47003
2022-03-21 06:00:00,2022-03-21 07:00:00,4,0,200,1113,1486,2803,49662
2022-03-21 07:00:00,2022-03-21 08:00:00,4,0,534,1196,1237,2971,47525
2022-03-21 08:00:00,2022-03-21 09:00:00,4,0,838,1028,808,2678,43430
2022-03-21 09:00:00,2022-03-21 10:00:00,3,0,1068,742,572,2385,39352
2022-03-21 10:00:00,2022-03-21 11:00:00,3,0,1188,391,495,2077,36816
2022-03-21 11:00:00,2022-03-21 12:00:00,3,0,1217,180,401,1801,35261
2022-03-21 12:00:00,2022-03-21 13:00:00,2,0,1169,74,372,1617,35742
2022-03-21 13:00:00,2022-03-21 14:00:00,3,0,1015,102,388,1508,37835
2022-03-21 14:00:00,2022-03-21 15:00:00,4,0,769,103,423,1299,41533
2022-03-21 15:00:00,2022-03-21 16:00:00,2,0,461,129,467,1059,47087
2022-03-21 16:00:00,2022-03-21 17:00:00,1,0,155,289,501,946,54428
2022-03-21 17:00:00,2022-03-21 18:00:00,3,0,10,678,622,1313,56807
2022-03-21 18:00:00,2022-03-21 19:00:00,4,0,4,1068,1033,2109,57189
2022-03-21 19:00:00,2022-03-21 20:00:00,4,0,4,1199,1377,2584,54668
2022-03-21 20:00:00,2022-03-21 21:00:00,4,0,4,1666,1515,3189,51167
2022-03-21 21:00:00,2022-03-21 22:00:00,4,0,4,1331,1513,2852,47832
2022-03-21 22:00:00,2022-03-21 23:00:00,4,0,4,1466,1599,3073,44510
2022-03-21 23:00:00,2022-03-22 00:00:00,3,0,4,1434,1601,3042,41708
2022-03-22 00:00:00,2022-03-22 01:00:00,4,0,4,1004,1377,2389,40413
2022-03-22 01:00:00,2022-03-22 02:00:00,4,0,4,594,1208,1810,39631
2022-03-22 02:00:00,2022-03-22 03:00:00,4,0,4,441,915,1364,39488
2022-03-22 03:00:00,2022-03-22 04:00:00,4,0,4,187,776,971,40052
2022-03-22 04:00:00,2022-03-22 05:00:00,4,0,4,141,846,995,42213
2022-03-22 05:00:00,2022-03-22 06:00:00,4,0,15,186,915,1120,46642
2022-03-22 06:00:00,2022-03-22 07:00:00,4,0,149,257,829,1239,49525
2022-03-22 07:00:00,2022-03-22 08:00:00,4,0,439,245,686,1374,47355
2022-03-22 08:00:00,2022-03-22 09:00:00,4,0,743,168,467,1382,42899
2022-03-22 09:00:00,2022-03-22 10:00:00,3,0,977,102,397,1479,38929
2022-03-22 10:00:00,2022-03-22 11:00:00,0,0,1131,63,389,1583,36593
2022-03-22 11:00:00,2022-03-22 12:00:00,0,0,1175,93,375,1643,35169
2022-03-22 12:00:00,2022-03-22 13:00:00,0,0,1130,91,336,1557,35336
2022-03-22 13:00:00,2022-03-22 14:00:00,1,0,979,81,355,1416,36956
2022-03-22 14:00:00,2022-03-22 15:00:00,4,0,750,200,433,1387,40247
2022-03-22 15:00:00,2022-03-22 16:00:00,4,0,449,441,538,1432,45722
2022-03-22 16:00:00,2022-03-22 17:00:00,2,0,157,662,657,1478,53119
2022-03-22 17:00:00,2022-03-22 18:00:00,2,0,13,1003,857,1875,55666
2022-03-22 18:00:00,2022-03-22 19:00:00,4,0,4,1372,1050,2430,56394
2022-03-22 19:00:00,2022-03-22 20:00:00,4,0,4,1767,1268,3043,53442
2022-03-22 20:00:00,2022-03-22 21:00:00,4,0,4,2429,996,3433,50191
2022-03-22 21:00:00,2022-03-22 22:00:00,4,0,4,2503,1149,3660,47147
2022-03-22 22:00:00,2022-03-22 23:00:00,4,0,4,1204,1100,2312,44140
2022-03-22 23:00:00,2022-03-23 00:00:00,4,0,4,793,1065,1866,41791
2022-03-23 00:00:00,2022-03-23 01:00:00,4,0,4,371,889,1268,40391
2022-03-23 01:00:00,2022-03-23 02:00:00,4,0,4,233,687,928,39602
2022-03-23 02:00:00,2022-03-23 03:00:00,4,0,4,204,654,866,39459
2022-03-23 03:00:00,2022-03-23 04:00:00,4,0,4,249,678,935,39944
2022-03-23 04:00:00,2022-03-23 05:00:00,4,0,4,361,645,1014,42267
2022-03-23 05:00:00,2022-03-23 06:00:00,4,0,28,347,561,940,46077
2022-03-23 06:00:00,2022-03-23 07:00:00,4,0,207,364,519,1094,48023
2022-03-23 07:00:00,2022-03-23 08:00:00,4,0,532,374,519,1429,45594
2022-03-23 08:00:00,2022-03-23 09:00:00,4,0,854,364,495,1717,41490
2022-03-23 09:00:00,2022-03-23 10:00:00,3,0,1075,300,447,1825,37527
2022-03-23 10:00:00,2022-03-23 11:00:00,2,0,1191,185,455,1833,35238
2022-03-23 11:00:00,2022-03-23 12:00:00,1,0,1228,152,426,1807,34039
2022-03-23 12:00:00,2022-03-23 13:00:00,3,0,1188,133,433,1757,34761
2022-03-23 13:00:00,2022-03-23 14:00:00,2,0,1059,125,444,1630,36605
2022-03-23 14:00:00,2022-03-23 15:00:00,0,0,821,114,456,1391,39821
2022-03-23 15:00:00,2022-03-23 16:00:00,1,0,514,171,622,1308,45252
2022-03-23 16:00:00,2022-03-23 17:00:00,0,0,186,265,849,1300,52410
2022-03-23 17:00:00,2022-03-23 18:00:00,0,0,19,311,1036,1366,55110
2022-03-23 18:00:00,2022-03-23 19:00:00,2,0,4,311,1282,1599,56144
2022-03-23 19:00:00,2022-03-23 20:00:00,2,0,4,304,1281,1591,53607
2022-03-23 20:00:00,2022-03-23 21:00:00,2,0,4,245,1143,1394,50587
2022-03-23 21:00:00,2022-03-23 22:00:00,3,0,4,259,1016,1282,47463
2022-03-23 22:00:00,2022-03-23 23:00:00,1,0,4,204,805,1014,45046
2022-03-23 23:00:00,2022-03-24 00:00:00,2,0,4,184,572,762,42767
2022-03-24 00:00:00,2022-03-24 01:00:00,4,0,4,159,454,621,41112
2022-03-24 01:00:00,2022-03-24 02:00:00,4,0,4,140,404,552,40395
2022-03-24 02:00:00,2022-03-24 03:00:00,4,0,4,119,410,537,40204
2022-03-24 03:00:00,2022-03-24 04:00:00,3,0,4,113,405,525,40552
2022-03-24 04:00:00,2022-03-24 05:00:00,2,0,4,92,399,497,42418
2022-03-24 05:00:00,2022-03-24 06:00:00,3,0,32,91,403,529,46468
2022-03-24 06:00:00,2022-03-24 07:00:00,1,0,217,93,396,707,48374
2022-03-24 07:00:00,2022-03-24 08:00:00,2,0,534,116,397,1049,45867
2022-03-24 08:00:00,2022-03-24 09:00:00,0,0,849,109,394,1352,41732
2022-03-24 09:00:00,2022-03-24 10:00:00,0,0,1067,94,392,1553,37863
2022-03-24 10:00:00,2022-03-24 11:00:00,0,0,1176,113,424,1713,35726
2022-03-24 11:00:00,2022-03-24 12:00:00,0,0,1208,114,438,1760,34867
2022-03-24 12:00:00,2022-03-24 13:00:00,0,0,1161,108,492,1761,35679
2022-03-24 13:00:00,2022-03-24 14:00:00,0,0,1018,86,653,1757,37670
2022-03-24 14:00:00,2022-03-24 15:00:00,0,0,671,96,855,1622,40861
2022-03-24 15:00:00,2022-03-24 16:00:00,0,0,430,179,1141,1750,46130
2022-03-24 16:00:00,2022-03-24 17:00:00,0,0,188,199,1206,1593,52913
2022-03-24 17:00:00,2022-03-24 18:00:00,0,0,21,186,1271,1478,55382
2022-03-24 18:00:00,2022-03-24 19:00:00,0,0,4,212,1319,1535,56724
2022-03-24 19:00:00,2022-03-24 20:00:00,0,0,4,329,1325,1658,54164
2022-03-24 20:00:00,2022-03-24 21:00:00,0,0,4,381,1179,1564,51049
2022-03-24 21:00:00,2022-03-24 22:00:00,0,0,4,467,1185,1656,47820
2022-03-24 22:00:00,2022-03-24 23:00:00,0,0,4,541,1251,1796,44847
2022-03-24 23:00:00,2022-03-25 00:00:00,0,0,4,624,1207,1835,42333
2022-03-25 00:00:00,2022-03-25 01:00:00,0,0,4,552,1088,1644,40917
2022-03-25 01:00:00,2022-03-25 02:00:00,0,0,4,584,1072,1660,39988
2022-03-25 02:00:00,2022-03-25 03:00:00,0,0,4,445,994,1443,39853
2022-03-25 03:00:00,2022-03-25 04:00:00,0,0,4,294,896,1194,40353
2022-03-25 04:00:00,2022-03-25 05:00:00,0,0,4,216,877,1097,42216
2022-03-25 05:00:00,2022-03-25 06:00:00,0,0,33,180,861,1074,45674
2022-03-25 06:00:00,2022-03-25 07:00:00,0,0,224,134,873,1231,47653
2022-03-25 07:00:00,2022-03-25 08:00:00,0,0,555,173,808,1536,45909
2022-03-25 08:00:00,2022-03-25 09:00:00,0,0,866,312,595,1773,42165
2022-03-25 09:00:00,2022-03-25 10:00:00,0,0,1071,394,629,2094,38368
2022-03-25 10:00:00,2022-03-25 11:00:00,0,0,1220,528,706,2454,35768
2022-03-25 11:00:00,2022-03-25 12:00:00,0,0,1255,573,861,2689,34482
2022-03-25 12:00:00,2022-03-25 13:00:00,0,0,1233,828,967,3028,34963
2022-03-25 13:00:00,2022-03-25 14:00:00,0,0,1093,1248,1116,3457,36751
2022-03-25 14:00:00,2022-03-25 15:00:00,0,0,840,2099,1241,4180,39880
2022-03-25 15:00:00,2022-03-25 16:00:00,0,0,520,2616,1296,4432,44591
2022-03-25 16:00:00,2022-03-25 17:00:00,0,0,203,2703,1335,4241,51339
2022-03-25 17:00:00,2022-03-25 18:00:00,0,0,25,2663,1534,4222,53800
2022-03-25 18:00:00,2022-03-25 19:00:00,0,0,4,2969,1994,4967,54919
2022-03-25 19:00:00,2022-03-25 20:00:00,0,0,4,3250,2145,5399,52556
2022-03-25 20:00:00,2022-03-25 21:00:00,0,0,4,3453,2050,5507,49451
2022-03-25 21:00:00,2022-03-25 22:00:00,0,0,4,3163,1840,5007,46890
2022-03-25 22:00:00,2022-03-25 23:00:00,0,0,4,2981,1668,4653,44507
2022-03-25 23:00:00,2022-03-26 00:00:00,0,0,4,2633,1518,4155,41987
2022-03-26 00:00:00,2022-03-26 01:00:00,0,0,4,1689,1263,2956,40161
2022-03-26 01:00:00,2022-03-26 02:00:00,0,0,4,1160,1138,2302,39289
2022-03-26 02:00:00,2022-03-26 03:00:00,0,0,4,1206,1197,2407,38847
2022-03-26 03:00:00,2022-03-26 04:00:00,0,0,4,1347,1086,2437,39236
2022-03-26 04:00:00,2022-03-26 05:00:00,3,0,4,1329,948,2284,39836
2022-03-26 05:00:00,2022-03-26 06:00:00,4,0,40,1271,849,2164,40183
2022-03-26 06:00:00,2022-03-26 07:00:00,2,0,239,1275,762,2278,39097
2022-03-26 07:00:00,2022-03-26 08:00:00,0,0,573,860,607,2040,37209
2022-03-26 08:00:00,2022-03-26 09:00:00,0,0,878,630,512,2020,34721
2022-03-26 09:00:00,2022-03-26 10:00:00,0,0,1109,752,579,2440,31750
2022-03-26 10:00:00,2022-03-26 11:00:00,0,0,1221,1001,798,3020,29699
2022-03-26 11:00:00,2022-03-26 12:00:00,0,0,1179,1473,985,3637,28580
2022-03-26 12:00:00,2022-03-26 13:00:00,0,0,983,1328,1146,3457,28679
2022-03-26 13:00:00,2022-03-26 14:00:00,0,0,930,1184,1470,3584,29810
2022-03-26 14:00:00,2022-03-26 15:00:00,0,0,730,1628,1754,4112,32912
2022-03-26 15:00:00,2022-03-26 16:00:00,0,0,441,2603,2110,5154,38025
2022-03-26 16:00:00,2022-03-26 17:00:00,0,0,197,3205,2346,5748,44833
2022-03-26 17:00:00,2022-03-26 18:00:00,0,0,19,3928,2525,6472,48807
2022-03-26 18:00:00,2022-03-26 19:00:00,0,0,4,5113,3048,8165,50281
2022-03-26 19:00:00,2022-03-26 20:00:00,3,0,4,6079,2835,8921,48658
2022-03-26 20:00:00,2022-03-26 21:00:00,4,0,4,5900,2395,8303,46469
2022-03-26 21:00:00,2022-03-26 22:00:00,4,0,4,4896,1649,6553,44134
2022-03-26 22:00:00,2022-03-26 23:00:00,4,0,4,2989,1316,4313,41802
2022-03-26 23:00:00,2022-03-27 00:00:00,4,0,4,2166,1063,3237,39841
2022-03-27 00:00:00,2022-03-27 01:00:00,4,0,4,1820,983,2811,37929
2022-03-27 01:00:00,2022-03-27 02:00:00,4,0,4,1721,910,2639,37273
2022-03-27 02:00:00,2022-03-27 03:00:00,4,0,4,1366,837,2211,37174
2022-03-27 03:00:00,2022-03-27 04:00:00,4,0,4,1277,888,2173,37145
2022-03-27 04:00:00,2022-03-27 05:00:00,3,0,4,1084,825,1916,37772
2022-03-27 05:00:00,2022-03-27 06:00:00,0,0,29,1238,845,2112,38394
2022-03-27 06:00:00,2022-03-27 07:00:00,0,0,165,911,778,1854,38556
2022-03-27 07:00:00,2022-03-27 08:00:00,0,0,364,662,700,1726,36920
2022-03-27 08:00:00,2022-03-27 09:00:00,0,0,727,402,556,1685,34104
2022-03-27 09:00:00,2022-03-27 10:00:00,0,0,1120,673,546,2339,31221
2022-03-27 10:00:00,2022-03-27 11:00:00,0,0,1247,724,527,2498,28801
2022-03-27 11:00:00,2022-03-27 12:00:00,0,0,1281,645,609,2535,26417
2022-03-27 12:00:00,2022-03-27 13:00:00,0,0,1260,640,812,2712,25363
2022-03-27 13:00:00,2022-03-27 14:00:00,0,0,1141,736,1181,3058,26775
2022-03-27 14:00:00,2022-03-27 15:00:00,0,0,889,1018,1407,3314,30572
2022-03-27 15:00:00,2022-03-27 16:00:00,0,0,577,1555,1476,3608,37620
2022-03-27 16:00:00,2022-03-27 17:00:00,0,0,227,1800,1409,3436,43116
2022-03-27 17:00:00,2022-03-27 18:00:00,0,0,24,2367,1334,3725,46588
2022-03-27 18:00:00,2022-03-27 19:00:00,3,0,4,2360,1498,3865,48082
2022-03-27 19:00:00,2022-03-27 20:00:00,4,0,4,2106,1852,3966,46475
2022-03-27 20:00:00,2022-03-27 21:00:00,4,0,4,2182,1743,3933,44260
2022-03-27 21:00:00,2022-03-27 22:00:00,4,0,4,1083,1404,2495,41670
2022-03-27 22:00:00,2022-03-27 23:00:00,4,0,4,801,1151,1960,40233
2022-03-27 23:00:00,2022-03-28 00:00:00,4,0,4,448,926,1382,38998
2022-03-28 00:00:00,2022-03-28 01:00:00,4,0,4,237,709,954,38473
2022-03-28 01:00:00,2022-03-28 02:00:00,4,0,4,191,605,804,38494
2022-03-28 02:00:00,2022-03-28 03:00:00,4,0,4,162,557,727,39056
2022-03-28 03:00:00,2022-03-28 04:00:00,4,0,4,121,495,624,41481
2022-03-28 04:00:00,2022-03-28 05:00:00,4,0,4,95,445,548,46415
2022-03-28 05:00:00,2022-03-28 06:00:00,4,0,13,118,413,548,51915
2022-03-28 06:00:00,2022-03-28 07:00:00,1,0,80,123,356,560,53912
2022-03-28 07:00:00,2022-03-28 08:00:00,0,0,194,109,344,647,51705
2022-03-28 08:00:00,2022-03-28 09:00:00,0,0,319,109,320,748,47684
2022-03-28 09:00:00,2022-03-28 10:00:00,0,0,456,94,342,892,42935
2022-03-28 10:00:00,2022-03-28 11:00:00,0,0,612,135,345,1092,38973
2022-03-28 11:00:00,2022-03-28 12:00:00,0,0,924,218,368,1510,35786
2022-03-28 12:00:00,2022-03-28 13:00:00,0,0,1090,241,369,1700,35119
2022-03-28 13:00:00,2022-03-28 14:00:00,0,0,877,296,373,1546,37131
2022-03-28 14:00:00,2022-03-28 15:00:00,0,0,625,250,380,1255,41401
2022-03-28 15:00:00,2022-03-28 16:00:00,0,0,378,365,492,1235,48140
2022-03-28 16:00:00,2022-03-28 17:00:00,0,0,144,507,507,1158,51717
2022-03-28 17:00:00,2022-03-28 18:00:00,0,0,19,588,594,1201,53787
2022-03-28 18:00:00,2022-03-28 19:00:00,0,0,4,485,783,1272,54489
2022-03-28 19:00:00,2022-03-28 20:00:00,0,0,4,611,821,1436,51865
2022-03-28 20:00:00,2022-03-28 21:00:00,0,0,4,770,828,1602,48484
2022-03-28 21:00:00,2022-03-28 22:00:00,0,0,4,774,759,1537,45239
2022-03-28 22:00:00,2022-03-28 23:00:00,0,0,4,311,603,918,42520
2022-03-28 23:00:00,2022-03-29 00:00:00,0,0,4,597,480,1081,40730
2022-03-29 00:00:00,2022-03-29 01:00:00,0,0,4,616,454,1074,40317
2022-03-29 01:00:00,2022-03-29 02:00:00,0,0,4,204,526,734,40036
2022-03-29 02:00:00,2022-03-29 03:00:00,0,0,4,422,636,1062,40293
2022-03-29 03:00:00,2022-03-29 04:00:00,0,0,4,247,593,844,42422
2022-03-29 04:00:00,2022-03-29 05:00:00,0,0,4,599,467,1070,47633
2022-03-29 05:00:00,2022-03-29 06:00:00,2,0,13,788,496,1299,53248
2022-03-29 06:00:00,2022-03-29 07:00:00,2,0,87,994,549,1632,55654
2022-03-29 07:00:00,2022-03-29 08:00:00,0,0,191,856,622,1669,54911
2022-03-29 08:00:00,2022-03-29 09:00:00,0,0,319,923,749,1991,52255
2022-03-29 09:00:00,2022-03-29 10:00:00,0,0,526,947,759,2232,47492
2022-03-29 10:00:00,2022-03-29 11:00:00,0,0,706,788,724,2218,43067
2022-03-29 11:00:00,2022-03-29 12:00:00,0,0,820,936,738,2494,40043
2022-03-29 12:00:00,2022-03-29 13:00:00,0,0,854,836,861,2551,38191
2022-03-29 13:00:00,2022-03-29 14:00:00,0,0,924,654,950,2528,39512
2022-03-29 14:00:00,2022-03-29 15:00:00,0,0,792,617,1152,2561,43677
2022-03-29 15:00:00,2022-03-29 16:00:00,0,0,501,876,1156,2533,49511
2022-03-29 16:00:00,2022-03-29 17:00:00,0,0,206,1401,1179,2786,51884
2022-03-29 17:00:00,2022-03-29 18:00:00,0,0,28,1530,1202,2760,53816
2022-03-29 18:00:00,2022-03-29 19:00:00,0,0,4,1843,1327,3174,54433
2022-03-29 19:00:00,2022-03-29 20:00:00,0,0,4,2185,1698,3887,51928
2022-03-29 20:00:00,2022-03-29 21:00:00,0,0,4,2690,1776,4470,48621
2022-03-29 21:00:00,2022-03-29 22:00:00,0,0,4,3517,1627,5148,45864
2022-03-29 22:00:00,2022-03-29 23:00:00,0,0,4,3097,1366,4467,43513
2022-03-29 23:00:00,2022-03-30 00:00:00,0,0,4,2519,980,3503,41793
2022-03-30 00:00:00,2022-03-30 01:00:00,0,0,4,2034,915,2953,40742
2022-03-30 01:00:00,2022-03-30 02:00:00,0,0,4,1836,1170,3010,40437
2022-03-30 02:00:00,2022-03-30 03:00:00,0,0,4,1610,1200,2814,40749
2022-03-30 03:00:00,2022-03-30 04:00:00,0,0,4,1976,1237,3217,42531
2022-03-30 04:00:00,2022-03-30 05:00:00,0,0,4,2374,1257,3635,47359
2022-03-30 05:00:00,2022-03-30 06:00:00,2,0,35,2312,1349,3698,52533
2022-03-30 06:00:00,2022-03-30 07:00:00,2,0,208,2647,1266,4123,53045
2022-03-30 07:00:00,2022-03-30 08:00:00,0,0,407,2387,1129,3923,50017
2022-03-30 08:00:00,2022-03-30 09:00:00,0,0,526,1951,1169,3646,45933
2022-03-30 09:00:00,2022-03-30 10:00:00,0,0,551,855,1109,2515,42530
2022-03-30 10:00:00,2022-03-30 11:00:00,0,0,709,553,832,2094,40767
2022-03-30 11:00:00,2022-03-30 12:00:00,0,0,711,396,809,1916,39963
2022-03-30 12:00:00,2022-03-30 13:00:00,0,0,666,259,885,1810,40490
2022-03-30 13:00:00,2022-03-30 14:00:00,0,0,601,269,982,1852,42862
2022-03-30 14:00:00,2022-03-30 15:00:00,0,0,439,335,1326,2100,47137
2022-03-30 15:00:00,2022-03-30 16:00:00,0,0,224,671,1473,2368,52129
2022-03-30 16:00:00,2022-03-30 17:00:00,0,0,79,1127,1956,3162,53010
2022-03-30 17:00:00,2022-03-30 18:00:00,0,0,13,1277,2479,3769,54353
2022-03-30 18:00:00,2022-03-30 19:00:00,0,0,4,1635,3143,4782,55202
2022-03-30 19:00:00,2022-03-30 20:00:00,2,0,4,1671,3190,4867,52455
2022-03-30 20:00:00,2022-03-30 21:00:00,0,0,4,4023,3057,7084,49238
2022-03-30 21:00:00,2022-03-30 22:00:00,1,0,4,6693,2792,9490,46443
2022-03-30 22:00:00,2022-03-30 23:00:00,2,0,4,7375,2764,10145,43800
2022-03-30 23:00:00,2022-03-31 00:00:00,2,0,4,7804,2978,10788,42011
2022-03-31 00:00:00,2022-03-31 01:00:00,1,0,4,7675,3180,10860,41067
2022-03-31 01:00:00,2022-03-31 02:00:00,2,0,4,6388,3046,9440,40564
2022-03-31 02:00:00,2022-03-31 03:00:00,0,0,4,6731,2771,9506,41028
2022-03-31 03:00:00,2022-03-31 04:00:00,2,0,4,7198,2996,10200,43689
2022-03-31 04:00:00,2022-03-31 05:00:00,2,0,4,6855,2829,9690,48867
2022-03-31 05:00:00,2022-03-31 06:00:00,4,0,17,7139,2741,9901,54713
2022-03-31 06:00:00,2022-03-31 07:00:00,4,0,65,6506,2165,8740,57570
2022-03-31 07:00:00,2022-03-31 08:00:00,0,0,118,7036,2261,9415,58136
2022-03-31 08:00:00,2022-03-31 09:00:00,2,0,133,5385,2563,8083,57627
2022-03-31 09:00:00,2022-03-31 10:00:00,2,0,163,4843,2919,7927,56257
2022-03-31 10:00:00,2022-03-31 11:00:00,0,0,145,5635,3291,9071,54919
2022-03-31 11:00:00,2022-03-31 12:00:00,1,0,145,8537,3805,12488,55569
2022-03-31 12:00:00,2022-03-31 13:00:00,0,0,148,9211,4114,13473,56659
2022-03-31 13:00:00,2022-03-31 14:00:00,3,0,186,9132,4694,14015,56958
2022-03-31 14:00:00,2022-03-31 15:00:00,3,0,146,9133,5624,14906,57996
2022-03-31 15:00:00,2022-03-31 16:00:00,0,0,99,9142,5982,15223,60194
2022-03-31 16:00:00,2022-03-31 17:00:00,0,0,48,9103,6278,15429,59321
2022-03-31 17:00:00,2022-03-31 18:00:00,0,0,7,9123,6699,15829,59160
2022-03-31 18:00:00,2022-03-31 19:00:00,3,0,4,9039,6576,15622,58399
2022-03-31 19:00:00,2022-03-31 20:00:00,2,0,4,8412,6700,15118,55057
2022-03-31 20:00:00,2022-03-31 21:00:00,2,0,4,8518,6895,15419,51197
2022-03-31 21:00:00,2022-03-31 22:00:00,4,0,4,9079,7072,16159,48004
2022-03-31 22:00:00,2022-03-31 23:00:00,0,0,4,9127,7313,16444,45315
2022-03-31 23:00:00,2022-04-01 00:00:00,0,0,4,9120,7327,16451,43551
2022-04-01 00:00:00,2022-04-01 01:00:00,3,0,4,9127,6812,15946,42624
2022-04-01 01:00:00,2022-04-01 02:00:00,1,0,4,9103,6737,15845,42226
2022-04-01 02:00:00,2022-04-01 03:00:00,0,0,4,9096,6429,15529,42347
2022-04-01 03:00:00,2022-04-01 04:00:00,0,0,4,9044,5789,14837,44303
2022-04-01 04:00:00,2022-04-01 05:00:00,1,0,4,9048,5514,14567,49418
2022-04-01 05:00:00,2022-04-01 06:00:00,4,0,14,9112,5215,14345,55210
2022-04-01 06:00:00,2022-04-01 07:00:00,4,0,89,9179,5267,14539,58846
2022-04-01 07:00:00,2022-04-01 08:00:00,4,0,250,9146,5682,15082,60042
2022-04-01 08:00:00,2022-04-01 09:00:00,4,0,364,9134,5969,15471,58594
2022-04-01 09:00:00,2022-04-01 10:00:00,3,0,519,9093,6353,15968,55676
2022-04-01 10:00:00,2022-04-01 11:00:00,4,0,553,9116,6609,16282,53210
2022-04-01 11:00:00,2022-04-01 12:00:00,4,0,591,9025,6823,16443,52418
2022-04-01 12:00:00,2022-04-01 13:00:00,4,0,562,8956,7011,16533,51608
2022-04-01 13:00:00,2022-04-01 14:00:00,4,0,435,8865,7196,16500,51354
2022-04-01 14:00:00,2022-04-01 15:00:00,4,0,378,8986,7254,16622,52511
2022-04-01 15:00:00,2022-04-01 16:00:00,4,0,257,8993,8035,17289,55401
2022-04-01 16:00:00,2022-04-01 17:00:00,4,0,129,9058,7659,16850,55318
2022-04-01 17:00:00,2022-04-01 18:00:00,4,0,27,8978,7457,16466,55455
2022-04-01 18:00:00,2022-04-01 19:00:00,1,0,4,8905,6926,15836,55864
2022-04-01 19:00:00,2022-04-01 20:00:00,0,0,4,8963,6566,15533,52904
2022-04-01 20:00:00,2022-04-01 21:00:00,0,0,4,9030,6438,15472,50017
2022-04-01 21:00:00,2022-04-01 22:00:00,0,0,4,8938,5419,14361,47203
2022-04-01 22:00:00,2022-04-01 23:00:00,0,0,4,8358,4841,13203,44893
2022-04-01 23:00:00,2022-04-02 00:00:00,0,0,4,7231,4371,11606,42762
2022-04-02 00:00:00,2022-04-02 01:00:00,0,0,4,6648,3749,10401,40974
2022-04-02 01:00:00,2022-04-02 02:00:00,0,0,4,6832,3192,10028,40399
2022-04-02 02:00:00,2022-04-02 03:00:00,0,0,4,5924,3194,9122,40449
2022-04-02 03:00:00,2022-04-02 04:00:00,0,0,4,6109,3488,9601,40993
2022-04-02 04:00:00,2022-04-02 05:00:00,0,0,3,5852,3629,9484,42765
2022-04-02 05:00:00,2022-04-02 06:00:00,0,0,72,5067,3922,9061,44659
2022-04-02 06:00:00,2022-04-02 07:00:00,0,0,311,4599,3424,8334,45054
2022-04-02 07:00:00,2022-04-02 08:00:00,0,0,574,4686,3375,8635,43077
2022-04-02 08:00:00,2022-04-02 09:00:00,0,0,727,3991,4396,9114,40638
2022-04-02 09:00:00,2022-04-02 10:00:00,0,0,503,4267,5118,9888,40277
2022-04-02 10:00:00,2022-04-02 11:00:00,0,0,553,4352,4722,9627,39811
2022-04-02 11:00:00,2022-04-02 12:00:00,0,0,652,5774,4569,10995,38962
2022-04-02 12:00:00,2022-04-02 13:00:00,0,0,669,6078,4803,11550,38196
2022-04-02 13:00:00,2022-04-02 14:00:00,0,0,825,6674,4762,12261,38837
2022-04-02 14:00:00,2022-04-02 15:00:00,0,0,664,6843,4974,12481,41733
2022-04-02 15:00:00,2022-04-02 16:00:00,0,0,501,6569,4950,12020,46196
2022-04-02 16:00:00,2022-04-02 17:00:00,0,0,283,6172,4877,11332,48227
2022-04-02 17:00:00,2022-04-02 18:00:00,0,0,44,5867,4239,10150,50373
2022-04-02 18:00:00,2022-04-02 19:00:00,0,0,6,5334,3506,8846,51257
2022-04-02 19:00:00,2022-04-02 20:00:00,0,0,4,3875,2606,6485,49289
2022-04-02 20:00:00,2022-04-02 21:00:00,0,0,4,3113,1761,4878,46792
2022-04-02 21:00:00,2022-04-02 22:00:00,0,0,4,2227,1193,3424,44763
2022-04-02 22:00:00,2022-04-02 23:00:00,0,0,4,1757,863,2624,42604
2022-04-02 23:00:00,2022-04-03 00:00:00,0,0,4,985,783,1772,41049
2022-04-03 00:00:00,2022-04-03 01:00:00,0,0,4,1067,520,1591,40052
2022-04-03 01:00:00,2022-04-03 02:00:00,0,0,4,1512,517,2033,39742
2022-04-03 02:00:00,2022-04-03 03:00:00,0,0,4,1064,537,1605,39529
2022-04-03 03:00:00,2022-04-03 04:00:00,0,0,4,1226,755,1985,39593
2022-04-03 04:00:00,2022-04-03 05:00:00,0,0,3,740,900,1643,39951
2022-04-03 05:00:00,2022-04-03 06:00:00,0,0,46,1002,1186,2234,40206
2022-04-03 06:00:00,2022-04-03 07:00:00,0,0,255,779,1132,2166,39330
2022-04-03 07:00:00,2022-04-03 08:00:00,0,0,630,1263,1032,2925,37211
2022-04-03 08:00:00,2022-04-03 09:00:00,0,0,856,1272,1266,3394,35586
2022-04-03 09:00:00,2022-04-03 10:00:00,0,0,788,1212,1072,3072,35756
2022-04-03 10:00:00,2022-04-03 11:00:00,0,0,800,1499,1028,3327,36647
2022-04-03 11:00:00,2022-04-03 12:00:00,0,0,673,1209,1553,3435,35993
2022-04-03 12:00:00,2022-04-03 13:00:00,0,0,650,1654,1424,3728,35675
2022-04-03 13:00:00,2022-04-03 14:00:00,0,0,741,1628,1500,3869,36056
2022-04-03 14:00:00,2022-04-03 15:00:00,0,0,728,1424,2053,4205,38452
2022-04-03 15:00:00,2022-04-03 16:00:00,0,0,424,1445,2011,3880,43391
2022-04-03 16:00:00,2022-04-03 17:00:00,0,0,185,1522,2241,3948,46429
2022-04-03 17:00:00,2022-04-03 18:00:00,0,0,38,1723,2071,3832,49100
2022-04-03 18:00:00,2022-04-03 19:00:00,0,0,4,1945,1893,3842,50416
2022-04-03 19:00:00,2022-04-03 20:00:00,0,0,4,2675,2055,4734,49185
2022-04-03 20:00:00,2022-04-03 21:00:00,0,0,4,4435,2819,7258,46835
2022-04-03 21:00:00,2022-04-03 22:00:00,0,0,4,5737,3786,9527,44071
2022-04-03 22:00:00,2022-04-03 23:00:00,0,0,4,6427,5510,11941,42234
2022-04-03 23:00:00,2022-04-04 00:00:00,0,0,4,7557,6460,14021,40840
2022-04-04 00:00:00,2022-04-04 01:00:00,0,0,4,8772,7233,16009,40317
2022-04-04 01:00:00,2022-04-04 02:00:00,0,0,4,8913,7787,16704,40220
2022-04-04 02:00:00,2022-04-04 03:00:00,0,0,4,8887,8062,16953,40647
2022-04-04 03:00:00,2022-04-04 04:00:00,0,0,4,7049,8475,15528,42717
2022-04-04 04:00:00,2022-04-04 05:00:00,0,0,4,6594,8771,15369,47804
2022-04-04 05:00:00,2022-04-04 06:00:00,3,0,24,6387,8853,15267,53423
2022-04-04 06:00:00,2022-04-04 07:00:00,4,0,70,6413,8955,15442,56503
2022-04-04 07:00:00,2022-04-04 08:00:00,3,0,132,6420,8955,15510,57025
2022-04-04 08:00:00,2022-04-04 09:00:00,0,0,162,6429,8951,15542,57467
2022-04-04 09:00:00,2022-04-04 10:00:00,0,0,213,6431,8929,15573,58010
2022-04-04 10:00:00,2022-04-04 11:00:00,3,0,263,6425,8998,15689,57866
2022-04-04 11:00:00,2022-04-04 12:00:00,4,0,270,6407,8945,15626,57788
2022-04-04 12:00:00,2022-04-04 13:00:00,4,0,207,6434,8910,15555,57852
2022-04-04 13:00:00,2022-04-04 14:00:00,4,0,207,6313,8747,15271,58063
2022-04-04 14:00:00,2022-04-04 15:00:00,4,0,166,6049,8357,14576,58477
2022-04-04 15:00:00,2022-04-04 16:00:00,4,0,150,6425,7449,14028,60236
2022-04-04 16:00:00,2022-04-04 17:00:00,4,0,72,6397,7296,13769,58918
2022-04-04 17:00:00,2022-04-04 18:00:00,4,0,10,6221,6583,12818,58374
2022-04-04 18:00:00,2022-04-04 19:00:00,4,0,4,6092,5655,11755,56617
2022-04-04 19:00:00,2022-04-04 20:00:00,4,0,4,5984,5366,11358,53491
2022-04-04 20:00:00,2022-04-04 21:00:00,4,0,4,5875,4643,10526,49750
2022-04-04 21:00:00,2022-04-04 22:00:00,4,0,4,5428,4352,9788,46612
2022-04-04 22:00:00,2022-04-04 23:00:00,4,0,4,5401,4024,9433,43659
2022-04-04 23:00:00,2022-04-05 00:00:00,4,0,4,4828,3893,8729,41681
2022-04-05 00:00:00,2022-04-05 01:00:00,4,0,4,4456,3641,8105,40679
2022-04-05 01:00:00,2022-04-05 02:00:00,4,0,4,4149,3423,7580,40183
2022-04-05 02:00:00,2022-04-05 03:00:00,4,0,4,3957,3483,7448,40809
2022-04-05 03:00:00,2022-04-05 04:00:00,4,0,4,3861,3241,7110,43172
2022-04-05 04:00:00,2022-04-05 05:00:00,4,0,3,4299,2888,7194,48267
2022-04-05 05:00:00,2022-04-05 06:00:00,4,0,37,4311,2633,6985,53998
2022-04-05 06:00:00,2022-04-05 07:00:00,4,0,128,4060,2941,7133,56557
2022-04-05 07:00:00,2022-04-05 08:00:00,4,0,220,4121,3556,7901,56577
2022-04-05 08:00:00,2022-04-05 09:00:00,4,0,342,4088,4115,8549,55565
2022-04-05 09:00:00,2022-04-05 10:00:00,4,0,424,4119,4763,9310,54083
2022-04-05 10:00:00,2022-04-05 11:00:00,4,0,417,3859,5756,10036,51794
2022-04-05 11:00:00,2022-04-05 12:00:00,4,0,470,3814,6555,10843,51379
2022-04-05 12:00:00,2022-04-05 13:00:00,4,0,328,3437,7079,10848,51599
2022-04-05 13:00:00,2022-04-05 14:00:00,4,0,265,3415,7412,11096,53092
2022-04-05 14:00:00,2022-04-05 15:00:00,4,0,175,2795,7406,10380,54754
2022-04-05 15:00:00,2022-04-05 16:00:00,4,0,125,2393,7230,9752,57519
2022-04-05 16:00:00,2022-04-05 17:00:00,4,0,56,2755,6824,9639,56913
2022-04-05 17:00:00,2022-04-05 18:00:00,4,0,8,4203,6771,10986,56861
2022-04-05 18:00:00,2022-04-05 19:00:00,4,0,4,4497,6203,10708,56229
2022-04-05 19:00:00,2022-04-05 20:00:00,4,0,4,4925,5865,10798,53001
2022-04-05 20:00:00,2022-04-05 21:00:00,4,0,4,4466,5695,10169,49113
2022-04-05 21:00:00,2022-04-05 22:00:00,4,0,4,4830,6007,10845,46042
2022-04-05 22:00:00,2022-04-05 23:00:00,4,0,4,6178,6512,12698,43125
2022-04-05 23:00:00,2022-04-06 00:00:00,4,0,4,6235,6942,13185,41485
2022-04-06 00:00:00,2022-04-06 01:00:00,4,0,4,6282,7056,13346,40574
2022-04-06 01:00:00,2022-04-06 02:00:00,4,0,4,6347,7504,13859,40075
2022-04-06 02:00:00,2022-04-06 03:00:00,4,0,4,6347,7810,14165,40452
2022-04-06 03:00:00,2022-04-06 04:00:00,4,0,4,6342,8159,14509,42640
2022-04-06 04:00:00,2022-04-06 05:00:00,4,0,4,6373,8257,14638,47668
2022-04-06 05:00:00,2022-04-06 06:00:00,4,0,39,6336,8179,14558,53075
2022-04-06 06:00:00,2022-04-06 07:00:00,4,0,101,6310,8306,14721,56231
2022-04-06 07:00:00,2022-04-06 08:00:00,4,0,161,6125,8360,14650,56586
2022-04-06 08:00:00,2022-04-06 09:00:00,4,0,222,6378,8269,14873,55615
2022-04-06 09:00:00,2022-04-06 10:00:00,4,0,303,6398,8370,15075,55142
2022-04-06 10:00:00,2022-04-06 11:00:00,4,0,238,6382,8504,15128,54254
2022-04-06 11:00:00,2022-04-06 12:00:00,4,0,336,6378,8632,15350,53967
2022-04-06 12:00:00,2022-04-06 13:00:00,4,0,401,6368,8649,15422,54288
2022-04-06 13:00:00,2022-04-06 14:00:00,4,0,267,6320,8818,15409,55040
2022-04-06 14:00:00,2022-04-06 15:00:00,4,0,134,6352,9026,15516,56437
2022-04-06 15:00:00,2022-04-06 16:00:00,4,0,104,6348,9085,15541,58433
2022-04-06 16:00:00,2022-04-06 17:00:00,4,0,109,6352,9060,15525,57288
2022-04-06 17:00:00,2022-04-06 18:00:00,4,0,19,6321,9139,15483,56969
2022-04-06 18:00:00,2022-04-06 19:00:00,4,0,5,6315,9126,15450,55868
2022-04-06 19:00:00,2022-04-06 20:00:00,4,0,4,6312,9147,15467,53262
2022-04-06 20:00:00,2022-04-06 21:00:00,4,0,4,6324,9057,15389,49508
2022-04-06 21:00:00,2022-04-06 22:00:00,4,0,4,6319,8966,15293,46449
2022-04-06 22:00:00,2022-04-06 23:00:00,4,0,4,6252,8958,15218,43486
2022-04-06 23:00:00,2022-04-07 00:00:00,4,0,4,6312,8947,15267,41676
2022-04-07 00:00:00,2022-04-07 01:00:00,4,0,4,6314,9011,15333,40731
2022-04-07 01:00:00,2022-04-07 02:00:00,4,0,4,6315,8929,15252,40395
2022-04-07 02:00:00,2022-04-07 03:00:00,4,0,4,6300,8914,15222,40923
2022-04-07 03:00:00,2022-04-07 04:00:00,4,0,4,6184,8919,15111,42904
2022-04-07 04:00:00,2022-04-07 05:00:00,4,0,4,6163,8873,15044,47962
2022-04-07 05:00:00,2022-04-07 06:00:00,4,0,5,5172,8284,13465,53643
2022-04-07 06:00:00,2022-04-07 07:00:00,4,0,24,6226,7711,13965,57939
2022-04-07 07:00:00,2022-04-07 08:00:00,4,0,113,6225,8053,14395,56691
2022-04-07 08:00:00,2022-04-07 09:00:00,4,0,643,5718,7691,14056,50070
2022-04-07 09:00:00,2022-04-07 10:00:00,4,0,808,6186,8574,15572,48298
2022-04-07 10:00:00,2022-04-07 11:00:00,4,0,705,6241,8835,15785,46424
2022-04-07 11:00:00,2022-04-07 12:00:00,4,0,757,6291,8606,15658,45259
2022-04-07 12:00:00,2022-04-07 13:00:00,4,0,584,6290,8365,15243,46701
2022-04-07 13:00:00,2022-04-07 14:00:00,4,0,563,6219,8642,15428,48927
2022-04-07 14:00:00,2022-04-07 15:00:00,4,0,411,6189,8803,15407,52143
2022-04-07 15:00:00,2022-04-07 16:00:00,4,0,423,6177,8914,15518,55371
2022-04-07 16:00:00,2022-04-07 17:00:00,4,0,158,6262,8665,15089,55715
2022-04-07 17:00:00,2022-04-07 18:00:00,4,0,44,6267,8593,14908,56683
2022-04-07 18:00:00,2022-04-07 19:00:00,4,0,4,6247,8849,15104,56577
2022-04-07 19:00:00,2022-04-07 20:00:00,4,0,4,6096,8813,14917,53733
2022-04-07 20:00:00,2022-04-07 21:00:00,4,0,4,6057,8819,14884,50190
2022-04-07 21:00:00,2022-04-07 22:00:00,4,0,4,5981,8773,14762,47188
2022-04-07 22:00:00,2022-04-07 23:00:00,4,0,4,5821,8417,14246,44499
2022-04-07 23:00:00,2022-04-08 00:00:00,4,0,4,5416,8057,13481,42625
2022-04-08 00:00:00,2022-04-08 01:00:00,4,0,4,5308,6958,12274,41469
2022-04-08 01:00:00,2022-04-08 02:00:00,4,0,4,5047,6399,11454,41164
2022-04-08 02:00:00,2022-04-08 03:00:00,4,0,4,4643,6570,11221,41547
2022-04-08 03:00:00,2022-04-08 04:00:00,4,0,4,4340,5392,9740,43758
2022-04-08 04:00:00,2022-04-08 05:00:00,4,0,5,4165,4911,9085,48401
2022-04-08 05:00:00,2022-04-08 06:00:00,4,0,102,4003,3617,7726,52245
2022-04-08 06:00:00,2022-04-08 07:00:00,4,0,364,3049,3409,6826,52468
2022-04-08 07:00:00,2022-04-08 08:00:00,4,0,637,2214,2980,5835,51125
2022-04-08 08:00:00,2022-04-08 09:00:00,4,0,768,1706,2680,5158,48867
2022-04-08 09:00:00,2022-04-08 10:00:00,4,0,758,752,2131,3645,48802
2022-04-08 10:00:00,2022-04-08 11:00:00,4,0,864,2066,1774,4708,48185
2022-04-08 11:00:00,2022-04-08 12:00:00,4,0,857,1969,1859,4689,47834
2022-04-08 12:00:00,2022-04-08 13:00:00,4,0,949,1368,2112,4433,46499
2022-04-08 13:00:00,2022-04-08 14:00:00,4,0,788,1593,2330,4715,45977
2022-04-08 14:00:00,2022-04-08 15:00:00,4,0,695,1706,3089,5494,47821
2022-04-08 15:00:00,2022-04-08 16:00:00,4,0,435,2106,3810,6355,51807
2022-04-08 16:00:00,2022-04-08 17:00:00,4,0,217,3550,4328,8099,53115
2022-04-08 17:00:00,2022-04-08 18:00:00,4,0,60,4986,4693,9743,54384
2022-04-08 18:00:00,2022-04-08 19:00:00,4,0,3,4732,5000,9739,55117
2022-04-08 19:00:00,2022-04-08 20:00:00,4,0,4,4340,5161,9509,52632
2022-04-08 20:00:00,2022-04-08 21:00:00,4,0,4,3929,5499,9436,49541
2022-04-08 21:00:00,2022-04-08 22:00:00,4,0,4,5127,6109,11244,46831
2022-04-08 22:00:00,2022-04-08 23:00:00,4,0,4,4726,6352,11086,43942
2022-04-08 23:00:00,2022-04-09 00:00:00,4,0,4,4333,6790,11131,41959
2022-04-09 00:00:00,2022-04-09 01:00:00,4,0,4,4822,7069,11899,40855
2022-04-09 01:00:00,2022-04-09 02:00:00,4,0,4,4738,6967,11713,40271
2022-04-09 02:00:00,2022-04-09 03:00:00,4,0,4,5078,6451,11537,40106
2022-04-09 03:00:00,2022-04-09 04:00:00,4,0,4,4927,6176,11111,40421
2022-04-09 04:00:00,2022-04-09 05:00:00,4,0,7,5112,6780,11903,42392
2022-04-09 05:00:00,2022-04-09 06:00:00,4,0,108,5386,6720,12218,43479
2022-04-09 06:00:00,2022-04-09 07:00:00,4,0,321,4841,6338,11504,43227
2022-04-09 07:00:00,2022-04-09 08:00:00,4,0,679,4232,6172,11087,42565
2022-04-09 08:00:00,2022-04-09 09:00:00,4,0,721,3620,5904,10249,40219
2022-04-09 09:00:00,2022-04-09 10:00:00,4,0,759,3597,6562,10922,38857
2022-04-09 10:00:00,2022-04-09 11:00:00,4,0,934,3508,5793,10239,37168
2022-04-09 11:00:00,2022-04-09 12:00:00,4,0,609,3823,5157,9593,35828
2022-04-09 12:00:00,2022-04-09 13:00:00,4,0,566,3479,5088,9137,34557
2022-04-09 13:00:00,2022-04-09 14:00:00,4,0,794,3601,5122,9521,35310
2022-04-09 14:00:00,2022-04-09 15:00:00,4,0,765,4410,6962,12141,39675
2022-04-09 15:00:00,2022-04-09 16:00:00,4,0,457,3922,6921,11304,44844
2022-04-09 16:00:00,2022-04-09 17:00:00,4,0,230,3283,6435,9952,47327
2022-04-09 17:00:00,2022-04-09 18:00:00,4,0,50,3065,4379,7498,49430
2022-04-09 18:00:00,2022-04-09 19:00:00,4,0,3,2979,4264,7250,50752
2022-04-09 19:00:00,2022-04-09 20:00:00,4,0,4,2549,4095,6652,49243
2022-04-09 20:00:00,2022-04-09 21:00:00,4,0,4,2662,3376,6046,47135
2022-04-09 21:00:00,2022-04-09 22:00:00,4,0,4,2762,3551,6321,44388
2022-04-09 22:00:00,2022-04-09 23:00:00,4,0,4,2569,3579,6156,42125
2022-04-09 23:00:00,2022-04-10 00:00:00,4,0,4,2657,3559,6224,40865
2022-04-10 00:00:00,2022-04-10 01:00:00,4,0,4,2358,3482,5848,39645
2022-04-10 01:00:00,2022-04-10 02:00:00,4,0,4,2413,3149,5570,39114
2022-04-10 02:00:00,2022-04-10 03:00:00,4,0,4,2640,3081,5729,39080
2022-04-10 03:00:00,2022-04-10 04:00:00,4,0,4,2774,3344,6126,39511
2022-04-10 04:00:00,2022-04-10 05:00:00,4,0,8,2880,2870,5762,40441
2022-04-10 05:00:00,2022-04-10 06:00:00,4,0,100,2261,3264,5629,40054
2022-04-10 06:00:00,2022-04-10 07:00:00,4,0,338,2335,2666,5343,38611
2022-04-10 07:00:00,2022-04-10 08:00:00,4,0,697,2325,2131,5157,35959
2022-04-10 08:00:00,2022-04-10 09:00:00,4,0,946,1944,1843,4737,33416
2022-04-10 09:00:00,2022-04-10 10:00:00,4,0,959,1791,1420,4174,31518
2022-04-10 10:00:00,2022-04-10 11:00:00,4,0,1084,1411,1064,3563,29793
2022-04-10 11:00:00,2022-04-10 12:00:00,4,0,987,259,1010,2260,28124
2022-04-10 12:00:00,2022-04-10 13:00:00,4,0,970,416,898,2288,27560
2022-04-10 13:00:00,2022-04-10 14:00:00,4,0,894,1229,917,3044,28873
2022-04-10 14:00:00,2022-04-10 15:00:00,4,0,905,1074,748,2731,32970
2022-04-10 15:00:00,2022-04-10 16:00:00,4,0,586,992,541,2123,39461
2022-04-10 16:00:00,2022-04-10 17:00:00,4,0,329,831,447,1611,43826
2022-04-10 17:00:00,2022-04-10 18:00:00,4,0,62,1155,401,1622,47831
2022-04-10 18:00:00,2022-04-10 19:00:00,4,0,3,1121,409,1537,49827
2022-04-10 19:00:00,2022-04-10 20:00:00,4,0,4,1166,442,1616,48795
2022-04-10 20:00:00,2022-04-10 21:00:00,4,0,4,950,526,1484,46311
2022-04-10 21:00:00,2022-04-10 22:00:00,4,0,4,1015,701,1724,43491
2022-04-10 22:00:00,2022-04-10 23:00:00,4,0,4,1132,808,1948,41162
2022-04-10 23:00:00,2022-04-11 00:00:00,4,0,4,1092,868,1968,40018
2022-04-11 00:00:00,2022-04-11 01:00:00,4,0,4,830,721,1559,39452
2022-04-11 01:00:00,2022-04-11 02:00:00,4,0,4,629,710,1347,39405
2022-04-11 02:00:00,2022-04-11 03:00:00,4,0,4,605,694,1307,40033
2022-04-11 03:00:00,2022-04-11 04:00:00,4,0,4,915,794,1717,42630
2022-04-11 04:00:00,2022-04-11 05:00:00,4,0,6,1062,885,1957,47670
2022-04-11 05:00:00,2022-04-11 06:00:00,4,0,67,1020,855,1946,51734
2022-04-11 06:00:00,2022-04-11 07:00:00,4,0,212,1293,810,2319,50760
2022-04-11 07:00:00,2022-04-11 08:00:00,4,0,504,1545,683,2736,46030
2022-04-11 08:00:00,2022-04-11 09:00:00,4,0,1003,1505,742,3254,40446
2022-04-11 09:00:00,2022-04-11 10:00:00,4,0,1232,1220,1205,3661,36452
2022-04-11 10:00:00,2022-04-11 11:00:00,4,0,1316,1579,1795,4694,33775
2022-04-11 11:00:00,2022-04-11 12:00:00,4,0,1338,2537,2091,5970,32920
2022-04-11 12:00:00,2022-04-11 13:00:00,4,0,1313,3049,2139,6505,33185
2022-04-11 13:00:00,2022-04-11 14:00:00,4,0,1188,3198,2336,6726,35418
2022-04-11 14:00:00,2022-04-11 15:00:00,4,0,954,3252,3186,7396,40134
2022-04-11 15:00:00,2022-04-11 16:00:00,4,0,648,3581,3314,7547,46476
2022-04-11 16:00:00,2022-04-11 17:00:00,4,0,271,3968,3398,7641,49080
2022-04-11 17:00:00,2022-04-11 18:00:00,4,0,63,4338,3824,8229,51979
2022-04-11 18:00:00,2022-04-11 19:00:00,4,0,3,4792,5089,9888,53478
2022-04-11 19:00:00,2022-04-11 20:00:00,4,0,4,4859,5670,10537,51448
2022-04-11 20:00:00,2022-04-11 21:00:00,4,0,4,4958,6237,11203,48019
2022-04-11 21:00:00,2022-04-11 22:00:00,4,0,4,5050,6113,11171,44802
2022-04-11 22:00:00,2022-04-11 23:00:00,4,0,4,4977,5596,10581,42356
2022-04-11 23:00:00,2022-04-12 00:00:00,4,0,4,4628,5306,9942,40642
2022-04-12 00:00:00,2022-04-12 01:00:00,4,0,4,4386,5281,9675,39886
2022-04-12 01:00:00,2022-04-12 02:00:00,4,0,4,4387,4397,8792,39422
2022-04-12 02:00:00,2022-04-12 03:00:00,4,0,4,4187,4181,8376,39753
2022-04-12 03:00:00,2022-04-12 04:00:00,4,0,4,4087,4220,8315,41846
2022-04-12 04:00:00,2022-04-12 05:00:00,4,0,8,4050,4547,8609,46286
2022-04-12 05:00:00,2022-04-12 06:00:00,4,0,154,3894,4159,8211,49986
2022-04-12 06:00:00,2022-04-12 07:00:00,4,0,326,3989,3345,7664,48953
2022-04-12 07:00:00,2022-04-12 08:00:00,4,0,700,3860,2595,7159,44783
2022-04-12 08:00:00,2022-04-12 09:00:00,4,0,1055,3541,2121,6721,39958
2022-04-12 09:00:00,2022-04-12 10:00:00,4,0,1124,3068,1758,5954,36589
2022-04-12 10:00:00,2022-04-12 11:00:00,4,0,1254,2894,1728,5880,36233
2022-04-12 11:00:00,2022-04-12 12:00:00,4,0,1175,2823,2327,6329,37139
2022-04-12 12:00:00,2022-04-12 13:00:00,4,0,1090,2503,2618,6215,36489
2022-04-12 13:00:00,2022-04-12 14:00:00,4,0,806,2788,2488,6086,37762
2022-04-12 14:00:00,2022-04-12 15:00:00,4,0,799,1991,2487,5281,42105
2022-04-12 15:00:00,2022-04-12 16:00:00,4,0,447,2236,2199,4886,49132
2022-04-12 16:00:00,2022-04-12 17:00:00,4,0,195,2225,1765,4189,51090
2022-04-12 17:00:00,2022-04-12 18:00:00,4,0,43,2013,1459,3519,52329
2022-04-12 18:00:00,2022-04-12 19:00:00,4,0,3,1919,1160,3086,53217
2022-04-12 19:00:00,2022-04-12 20:00:00,4,0,4,2044,1194,3246,51172
2022-04-12 20:00:00,2022-04-12 21:00:00,4,0,4,1926,1279,3213,48218
2022-04-12 21:00:00,2022-04-12 22:00:00,4,0,4,2201,1037,3246,45033
2022-04-12 22:00:00,2022-04-12 23:00:00,4,0,4,2848,1159,4015,42373
2022-04-12 23:00:00,2022-04-13 00:00:00,4,0,4,2183,1231,3422,40654
2022-04-13 00:00:00,2022-04-13 01:00:00,4,0,4,1760,1815,3583,39801
2022-04-13 01:00:00,2022-04-13 02:00:00,4,0,4,2724,2116,4848,39687
2022-04-13 02:00:00,2022-04-13 03:00:00,4,0,4,2453,1781,4242,40243
2022-04-13 03:00:00,2022-04-13 04:00:00,4,0,4,1633,1380,3021,41783
2022-04-13 04:00:00,2022-04-13 05:00:00,4,0,8,1196,1447,2655,45930
2022-04-13 05:00:00,2022-04-13 06:00:00,4,0,102,1088,1328,2522,49563
2022-04-13 06:00:00,2022-04-13 07:00:00,4,0,327,791,972,2094,49826
2022-04-13 07:00:00,2022-04-13 08:00:00,4,0,587,748,783,2122,48156
2022-04-13 08:00:00,2022-04-13 09:00:00,4,0,619,931,665,2219,45719
2022-04-13 09:00:00,2022-04-13 10:00:00,4,0,947,1171,650,2772,45762
2022-04-13 10:00:00,2022-04-13 11:00:00,4,0,934,944,764,2646,47207
2022-04-13 11:00:00,2022-04-13 12:00:00,4,0,647,1074,784,2509,47094
2022-04-13 12:00:00,2022-04-13 13:00:00,4,0,523,1405,840,2772,44614
2022-04-13 13:00:00,2022-04-13 14:00:00,4,0,405,1564,877,2850,44977
2022-04-13 14:00:00,2022-04-13 15:00:00,4,0,308,1426,831,2569,47347
2022-04-13 15:00:00,2022-04-13 16:00:00,4,0,255,1286,684,2229,51396
2022-04-13 16:00:00,2022-04-13 17:00:00,4,0,110,1311,669,2094,52481
2022-04-13 17:00:00,2022-04-13 18:00:00,4,0,36,1320,804,2164,53263
2022-04-13 18:00:00,2022-04-13 19:00:00,4,0,5,1453,1055,2517,53442
2022-04-13 19:00:00,2022-04-13 20:00:00,4,0,4,2189,1473,3670,51653
2022-04-13 20:00:00,2022-04-13 21:00:00,4,0,4,2378,1685,4071,48821
2022-04-13 21:00:00,2022-04-13 22:00:00,4,0,4,2591,1841,4440,45730
2022-04-13 22:00:00,2022-04-13 23:00:00,4,0,4,1737,1875,3620,42917
2022-04-13 23:00:00,2022-04-14 00:00:00,4,0,4,1166,1659,2833,41160
2022-04-14 00:00:00,2022-04-14 01:00:00,4,0,4,1015,1623,2646,40364
2022-04-14 01:00:00,2022-04-14 02:00:00,4,0,4,958,1460,2426,40060
2022-04-14 02:00:00,2022-04-14 03:00:00,4,0,4,523,1080,1611,40313
2022-04-14 03:00:00,2022-04-14 04:00:00,4,0,4,590,784,1382,42528
2022-04-14 04:00:00,2022-04-14 05:00:00,4,0,7,990,683,1684,47314
2022-04-14 05:00:00,2022-04-14 06:00:00,4,0,124,894,632,1654,50670
2022-04-14 06:00:00,2022-04-14 07:00:00,4,0,433,561,535,1533,48380
2022-04-14 07:00:00,2022-04-14 08:00:00,4,0,784,383,391,1562,44178
2022-04-14 08:00:00,2022-04-14 09:00:00,4,0,981,530,380,1895,39846
2022-04-14 09:00:00,2022-04-14 10:00:00,4,0,1033,628,580,2245,36675
2022-04-14 10:00:00,2022-04-14 11:00:00,4,0,918,353,717,1992,36575
2022-04-14 11:00:00,2022-04-14 12:00:00,4,0,923,287,915,2129,36861
2022-04-14 12:00:00,2022-04-14 13:00:00,4,0,891,487,1063,2445,37751
2022-04-14 13:00:00,2022-04-14 14:00:00,4,0,635,747,1254,2640,39313
2022-04-14 14:00:00,2022-04-14 15:00:00,4,0,720,664,1334,2722,41795
2022-04-14 15:00:00,2022-04-14 16:00:00,4,0,612,707,1267,2590,46667
2022-04-14 16:00:00,2022-04-14 17:00:00,4,0,345,763,1048,2160,49429
2022-04-14 17:00:00,2022-04-14 18:00:00,4,0,81,772,810,1667,52760
2022-04-14 18:00:00,2022-04-14 19:00:00,4,0,5,768,804,1581,54670
2022-04-14 19:00:00,2022-04-14 20:00:00,4,0,4,735,683,1426,52972
2022-04-14 20:00:00,2022-04-14 21:00:00,4,0,4,663,631,1302,50048
2022-04-14 21:00:00,2022-04-14 22:00:00,4,0,4,537,697,1242,47021
2022-04-14 22:00:00,2022-04-14 23:00:00,4,0,4,402,687,1097,43840
2022-04-14 23:00:00,2022-04-15 00:00:00,4,0,4,295,667,970,42035
2022-04-15 00:00:00,2022-04-15 01:00:00,4,0,4,430,593,1031,41649
2022-04-15 01:00:00,2022-04-15 02:00:00,4,0,4,408,608,1024,41351
2022-04-15 02:00:00,2022-04-15 03:00:00,4,0,4,342,627,977,41636
2022-04-15 03:00:00,2022-04-15 04:00:00,4,0,4,384,603,995,43301
2022-04-15 04:00:00,2022-04-15 05:00:00,4,0,6,478,644,1132,46968
2022-04-15 05:00:00,2022-04-15 06:00:00,4,0,30,373,721,1128,50465
2022-04-15 06:00:00,2022-04-15 07:00:00,4,0,86,369,732,1191,52239
2022-04-15 07:00:00,2022-04-15 08:00:00,4,0,188,435,811,1438,51343
2022-04-15 08:00:00,2022-04-15 09:00:00,4,0,399,398,667,1468,48916
2022-04-15 09:00:00,2022-04-15 10:00:00,4,0,506,467,515,1492,46667
2022-04-15 10:00:00,2022-04-15 11:00:00,4,0,509,543,419,1475,43690
2022-04-15 11:00:00,2022-04-15 12:00:00,4,0,470,359,411,1244,41828
2022-04-15 12:00:00,2022-04-15 13:00:00,4,0,399,391,497,1291,40680
2022-04-15 13:00:00,2022-04-15 14:00:00,4,0,368,479,709,1560,41082
2022-04-15 14:00:00,2022-04-15 15:00:00,4,0,286,524,753,1567,43484
2022-04-15 15:00:00,2022-04-15 16:00:00,4,0,153,374,745,1276,47998
2022-04-15 16:00:00,2022-04-15 17:00:00,4,0,76,581,803,1464,50493
2022-04-15 17:00:00,2022-04-15 18:00:00,4,0,21,1151,883,2059,52258
2022-04-15 18:00:00,2022-04-15 19:00:00,4,0,5,1626,1108,2743,52519
2022-04-15 19:00:00,2022-04-15 20:00:00,4,0,4,1937,1264,3209,50469
2022-04-15 20:00:00,2022-04-15 21:00:00,4,0,4,2068,1234,3310,47889
2022-04-15 21:00:00,2022-04-15 22:00:00,4,0,4,2372,1221,3601,45340
2022-04-15 22:00:00,2022-04-15 23:00:00,4,0,4,1945,1100,3053,43171
2022-04-15 23:00:00,2022-04-16 00:00:00,5,0,4,1760,1090,2859,41309
2022-04-16 00:00:00,2022-04-16 01:00:00,6,0,4,1296,1061,2367,40322
2022-04-16 01:00:00,2022-04-16 02:00:00,4,0,4,1024,1003,2035,39887
2022-04-16 02:00:00,2022-04-16 03:00:00,4,0,4,911,1303,2222,39577
2022-04-16 03:00:00,2022-04-16 04:00:00,4,0,4,1068,1611,2687,39766
2022-04-16 04:00:00,2022-04-16 05:00:00,4,0,11,1924,2087,4026,40733
2022-04-16 05:00:00,2022-04-16 06:00:00,4,0,133,2280,2635,5052,40798
2022-04-16 06:00:00,2022-04-16 07:00:00,4,0,465,2873,2616,5958,39728
2022-04-16 07:00:00,2022-04-16 08:00:00,4,0,857,2435,1935,5231,37047
2022-04-16 08:00:00,2022-04-16 09:00:00,4,0,1152,2023,1434,4613,32742
2022-04-16 09:00:00,2022-04-16 10:00:00,4,0,1306,1492,1445,4247,29673
2022-04-16 10:00:00,2022-04-16 11:00:00,4,0,1357,1246,1480,4087,27522
2022-04-16 11:00:00,2022-04-16 12:00:00,4,0,1374,1007,1520,3905,25681
2022-04-16 12:00:00,2022-04-16 13:00:00,4,0,1362,1035,1463,3864,25223
2022-04-16 13:00:00,2022-04-16 14:00:00,4,0,1264,1503,1608,4379,26762
2022-04-16 14:00:00,2022-04-16 15:00:00,4,0,1103,1907,1930,4944,30617
2022-04-16 15:00:00,2022-04-16 16:00:00,4,0,754,2272,1978,5008,36999
2022-04-16 16:00:00,2022-04-16 17:00:00,4,0,378,2481,1754,4617,41581
2022-04-16 17:00:00,2022-04-16 18:00:00,4,0,98,2504,1766,4372,45550
2022-04-16 18:00:00,2022-04-16 19:00:00,4,0,5,2511,2292,4812,47954
2022-04-16 19:00:00,2022-04-16 20:00:00,4,0,4,3646,3172,6826,47180
2022-04-16 20:00:00,2022-04-16 21:00:00,4,0,4,5468,3853,9329,45207
2022-04-16 21:00:00,2022-04-16 22:00:00,4,0,4,5495,4458,9961,42864
2022-04-16 22:00:00,2022-04-16 23:00:00,4,0,4,4738,4426,9172,40801
2022-04-16 23:00:00,2022-04-17 00:00:00,4,0,4,3281,3795,7084,39371
2022-04-17 00:00:00,2022-04-17 01:00:00,4,0,4,2145,3274,5427,38215
2022-04-17 01:00:00,2022-04-17 02:00:00,4,0,4,1760,3055,4823,37990
2022-04-17 02:00:00,2022-04-17 03:00:00,4,0,4,1515,2832,4355,37775
2022-04-17 03:00:00,2022-04-17 04:00:00,4,0,4,1616,2514,4138,37928
2022-04-17 04:00:00,2022-04-17 05:00:00,4,0,21,1593,2557,4175,37749
2022-04-17 05:00:00,2022-04-17 06:00:00,4,0,176,1688,2234,4102,36571
2022-04-17 06:00:00,2022-04-17 07:00:00,4,0,519,1486,1642,3651,34570
2022-04-17 07:00:00,2022-04-17 08:00:00,4,0,882,1263,1180,3329,31825
2022-04-17 08:00:00,2022-04-17 09:00:00,4,0,1156,833,867,2860,28350
2022-04-17 09:00:00,2022-04-17 10:00:00,4,0,1300,488,713,2505,25221
2022-04-17 10:00:00,2022-04-17 11:00:00,4,0,1283,487,725,2499,22909
2022-04-17 11:00:00,2022-04-17 12:00:00,4,0,1146,299,864,2313,21592
2022-04-17 12:00:00,2022-04-17 13:00:00,4,0,1350,557,1119,3030,21697
2022-04-17 13:00:00,2022-04-17 14:00:00,4,0,1233,754,1403,3394,23540
2022-04-17 14:00:00,2022-04-17 15:00:00,4,0,1049,1185,1353,3591,27652
2022-04-17 15:00:00,2022-04-17 16:00:00,4,0,767,1780,1490,4041,34561
2022-04-17 16:00:00,2022-04-17 17:00:00,4,0,404,2081,1646,4135,39812
2022-04-17 17:00:00,2022-04-17 18:00:00,4,0,98,2298,1855,4255,43776
2022-04-17 18:00:00,2022-04-17 19:00:00,4,0,5,2652,2647,5308,46554
2022-04-17 19:00:00,2022-04-17 20:00:00,4,0,4,3559,3377,6944,46034
2022-04-17 20:00:00,2022-04-17 21:00:00,4,0,4,5153,4332,9493,44089
2022-04-17 21:00:00,2022-04-17 22:00:00,4,0,4,6727,4907,11642,41862
2022-04-17 22:00:00,2022-04-17 23:00:00,4,0,4,6827,4669,11504,40392
2022-04-17 23:00:00,2022-04-18 00:00:00,4,0,4,5189,4363,9560,38777
2022-04-18 00:00:00,2022-04-18 01:00:00,4,0,4,3817,4030,7855,37813
2022-04-18 01:00:00,2022-04-18 02:00:00,4,0,4,3424,3929,7361,37421
2022-04-18 02:00:00,2022-04-18 03:00:00,4,0,4,4013,3811,7832,37586
2022-04-18 03:00:00,2022-04-18 04:00:00,4,0,4,4388,3415,7811,38401
2022-04-18 04:00:00,2022-04-18 05:00:00,4,0,20,3636,3016,6676,38664
2022-04-18 05:00:00,2022-04-18 06:00:00,4,0,179,3028,2892,6103,37157
2022-04-18 06:00:00,2022-04-18 07:00:00,4,0,523,2755,2091,5373,35511
2022-04-18 07:00:00,2022-04-18 08:00:00,4,0,817,2279,1330,4430,33151
2022-04-18 08:00:00,2022-04-18 09:00:00,4,0,978,1996,1024,4002,30149
2022-04-18 09:00:00,2022-04-18 10:00:00,4,0,1287,1582,863,3736,27545
2022-04-18 10:00:00,2022-04-18 11:00:00,4,0,1347,1166,747,3264,25584
2022-04-18 11:00:00,2022-04-18 12:00:00,4,0,1361,958,630,2953,24081
2022-04-18 12:00:00,2022-04-18 13:00:00,4,0,1292,622,510,2428,24338
2022-04-18 13:00:00,2022-04-18 14:00:00,4,0,1265,497,433,2199,26118
2022-04-18 14:00:00,2022-04-18 15:00:00,4,0,1056,498,422,1980,30541
2022-04-18 15:00:00,2022-04-18 16:00:00,4,0,721,581,359,1665,37780
2022-04-18 16:00:00,2022-04-18 17:00:00,4,0,363,533,367,1267,42932
2022-04-18 17:00:00,2022-04-18 18:00:00,4,0,96,459,441,1000,46986
2022-04-18 18:00:00,2022-04-18 19:00:00,4,0,4,478,584,1070,48805
2022-04-18 19:00:00,2022-04-18 20:00:00,4,0,4,582,729,1319,47745
2022-04-18 20:00:00,2022-04-18 21:00:00,4,0,4,682,752,1442,45349
2022-04-18 21:00:00,2022-04-18 22:00:00,4,0,4,807,725,1540,42795
2022-04-18 22:00:00,2022-04-18 23:00:00,4,0,4,764,743,1515,40864
2022-04-18 23:00:00,2022-04-19 00:00:00,4,0,4,696,1214,1918,39564
2022-04-19 00:00:00,2022-04-19 01:00:00,4,0,4,740,1479,2227,39033
2022-04-19 01:00:00,2022-04-19 02:00:00,4,0,4,565,1430,2003,38820
2022-04-19 02:00:00,2022-04-19 03:00:00,4,0,4,505,980,1493,39154
2022-04-19 03:00:00,2022-04-19 04:00:00,4,0,4,981,786,1775,41272
2022-04-19 04:00:00,2022-04-19 05:00:00,4,0,23,1196,818,2041,45246
2022-04-19 05:00:00,2022-04-19 06:00:00,4,0,188,1352,926,2470,47571
2022-04-19 06:00:00,2022-04-19 07:00:00,4,0,516,1825,705,3050,46296
2022-04-19 07:00:00,2022-04-19 08:00:00,4,0,860,1981,535,3380,43219
2022-04-19 08:00:00,2022-04-19 09:00:00,4,0,1145,1965,741,3855,38927
2022-04-19 09:00:00,2022-04-19 10:00:00,4,0,1284,1829,1044,4161,35505
2022-04-19 10:00:00,2022-04-19 11:00:00,4,0,1358,753,1112,3227,33360
2022-04-19 11:00:00,2022-04-19 12:00:00,4,0,1358,480,1291,3133,32500
2022-04-19 12:00:00,2022-04-19 13:00:00,4,0,1347,586,1693,3630,32902
2022-04-19 13:00:00,2022-04-19 14:00:00,6,0,1277,1023,2086,4392,35508
2022-04-19 14:00:00,2022-04-19 15:00:00,8,0,1059,1903,2753,5723,39657
2022-04-19 15:00:00,2022-04-19 16:00:00,8,0,721,3102,3351,7182,45658
2022-04-19 16:00:00,2022-04-19 17:00:00,8,0,379,4290,3591,8268,48520
2022-04-19 17:00:00,2022-04-19 18:00:00,8,0,101,5450,3753,9312,51392
2022-04-19 18:00:00,2022-04-19 19:00:00,8,0,5,6692,4768,11473,52671
2022-04-19 19:00:00,2022-04-19 20:00:00,8,0,4,7351,5448,12811,51325
2022-04-19 20:00:00,2022-04-19 21:00:00,8,0,4,7816,5187,13015,48160
2022-04-19 21:00:00,2022-04-19 22:00:00,8,0,4,7813,4552,12377,45318
2022-04-19 22:00:00,2022-04-19 23:00:00,8,0,4,6890,4395,11297,42692
2022-04-19 23:00:00,2022-04-20 00:00:00,8,0,4,5778,4411,10201,40937
2022-04-20 00:00:00,2022-04-20 01:00:00,8,0,4,5182,4189,9383,40017
2022-04-20 01:00:00,2022-04-20 02:00:00,8,0,4,4912,3910,8834,39818
2022-04-20 02:00:00,2022-04-20 03:00:00,8,0,4,4519,3630,8161,40168
2022-04-20 03:00:00,2022-04-20 04:00:00,8,0,4,4001,3668,7681,42015
2022-04-20 04:00:00,2022-04-20 05:00:00,8,0,24,3806,3680,7518,45603
2022-04-20 05:00:00,2022-04-20 06:00:00,8,0,189,3734,2747,6678,47988
2022-04-20 06:00:00,2022-04-20 07:00:00,8,0,518,2933,1705,5164,46274
2022-04-20 07:00:00,2022-04-20 08:00:00,8,0,866,2436,1162,4472,42158
2022-04-20 08:00:00,2022-04-20 09:00:00,8,0,1148,2827,1409,5392,38008
2022-04-20 09:00:00,2022-04-20 10:00:00,8,0,1298,2353,1722,5381,34725
2022-04-20 10:00:00,2022-04-20 11:00:00,8,0,1343,2406,2000,5757,32434
2022-04-20 11:00:00,2022-04-20 12:00:00,8,0,1373,3485,1885,6751,31802
2022-04-20 12:00:00,2022-04-20 13:00:00,8,0,1366,4602,2160,8136,32353
2022-04-20 13:00:00,2022-04-20 14:00:00,8,0,1284,4977,2672,8941,34286
2022-04-20 14:00:00,2022-04-20 15:00:00,8,0,1072,5372,3540,9992,38287
2022-04-20 15:00:00,2022-04-20 16:00:00,8,0,749,5765,4004,10526,44376
2022-04-20 16:00:00,2022-04-20 17:00:00,8,0,383,5926,3863,10180,47567
2022-04-20 17:00:00,2022-04-20 18:00:00,8,0,82,6210,3677,9977,51191
2022-04-20 18:00:00,2022-04-20 19:00:00,8,0,5,6165,3926,10104,53138
2022-04-20 19:00:00,2022-04-20 20:00:00,8,0,2,6263,3965,10238,51939
2022-04-20 20:00:00,2022-04-20 21:00:00,8,0,4,6501,4054,10567,48913
2022-04-20 21:00:00,2022-04-20 22:00:00,8,0,4,5551,4359,9922,45740
2022-04-20 22:00:00,2022-04-20 23:00:00,10,0,4,4939,4066,9019,43103
2022-04-20 23:00:00,2022-04-21 00:00:00,6,0,4,4499,4057,8566,41484
2022-04-21 00:00:00,2022-04-21 01:00:00,4,0,4,3545,3788,7341,40493
2022-04-21 01:00:00,2022-04-21 02:00:00,7,0,4,3340,3501,6852,40024
2022-04-21 02:00:00,2022-04-21 03:00:00,8,0,4,3451,2651,6114,40471
2022-04-21 03:00:00,2022-04-21 04:00:00,8,0,4,3189,2646,5847,42379
2022-04-21 04:00:00,2022-04-21 05:00:00,8,0,26,2734,2723,5491,45530
2022-04-21 05:00:00,2022-04-21 06:00:00,8,0,189,3096,2134,5427,48158
2022-04-21 06:00:00,2022-04-21 07:00:00,8,0,459,3067,1568,5102,46269
2022-04-21 07:00:00,2022-04-21 08:00:00,8,0,813,2407,1320,4548,42049
2022-04-21 08:00:00,2022-04-21 09:00:00,8,0,1085,2027,2091,5211,37763
2022-04-21 09:00:00,2022-04-21 10:00:00,8,0,1248,2041,3023,6320,34638
2022-04-21 10:00:00,2022-04-21 11:00:00,8,0,1210,2765,3705,7688,32457
2022-04-21 11:00:00,2022-04-21 12:00:00,8,0,1221,3614,3887,8730,32360
2022-04-21 12:00:00,2022-04-21 13:00:00,8,0,1042,4321,3785,9156,33319
2022-04-21 13:00:00,2022-04-21 14:00:00,8,0,1111,5211,3875,10205,35231
2022-04-21 14:00:00,2022-04-21 15:00:00,8,0,884,6525,4278,11695,39597
2022-04-21 15:00:00,2022-04-21 16:00:00,8,0,481,7270,4661,12420,46098
2022-04-21 16:00:00,2022-04-21 17:00:00,8,0,212,7342,4391,11953,49787
2022-04-21 17:00:00,2022-04-21 18:00:00,8,0,57,7739,4273,12077,52567
2022-04-21 18:00:00,2022-04-21 19:00:00,8,0,5,8336,4646,12995,53702
2022-04-21 19:00:00,2022-04-21 20:00:00,8,0,4,8165,4776,12953,52045
2022-04-21 20:00:00,2022-04-21 21:00:00,8,0,4,8137,4827,12976,48912
2022-04-21 21:00:00,2022-04-21 22:00:00,8,0,4,8306,4842,13160,46066
2022-04-21 22:00:00,2022-04-21 23:00:00,8,0,4,8281,4558,12851,43581
2022-04-21 23:00:00,2022-04-22 00:00:00,8,0,4,8234,4599,12845,41866
2022-04-22 00:00:00,2022-04-22 01:00:00,8,0,4,7547,4678,12237,40635
2022-04-22 01:00:00,2022-04-22 02:00:00,8,0,4,7215,5122,12349,40293
2022-04-22 02:00:00,2022-04-22 03:00:00,8,0,4,7742,5049,12803,40513
2022-04-22 03:00:00,2022-04-22 04:00:00,10,0,4,7313,4987,12314,42259
2022-04-22 04:00:00,2022-04-22 05:00:00,12,0,32,7033,4675,11752,45533
2022-04-22 05:00:00,2022-04-22 06:00:00,12,0,190,6675,4458,11335,47820
2022-04-22 06:00:00,2022-04-22 07:00:00,13,0,524,6682,4086,11305,46676
2022-04-22 07:00:00,2022-04-22 08:00:00,16,0,871,6419,3648,10954,44384
2022-04-22 08:00:00,2022-04-22 09:00:00,16,0,1141,6414,4012,11583,40909
2022-04-22 09:00:00,2022-04-22 10:00:00,16,0,1238,6589,4594,12437,38535
2022-04-22 10:00:00,2022-04-22 11:00:00,16,0,1339,7063,5083,13501,38553
2022-04-22 11:00:00,2022-04-22 12:00:00,16,0,1310,7389,4819,13534,38939
2022-04-22 12:00:00,2022-04-22 13:00:00,16,0,1017,8264,5170,14467,39399
2022-04-22 13:00:00,2022-04-22 14:00:00,14,0,876,8819,5664,15373,41857
2022-04-22 14:00:00,2022-04-22 15:00:00,12,0,685,8921,5950,15568,45847
2022-04-22 15:00:00,2022-04-22 16:00:00,15,0,532,8995,5729,15271,48961
2022-04-22 16:00:00,2022-04-22 17:00:00,16,0,305,8874,5824,15019,49404
2022-04-22 17:00:00,2022-04-22 18:00:00,13,0,94,8008,5358,13473,50749
2022-04-22 18:00:00,2022-04-22 19:00:00,12,0,8,5950,4725,10695,51360
2022-04-22 19:00:00,2022-04-22 20:00:00,12,0,4,5157,5338,10511,49983
2022-04-22 20:00:00,2022-04-22 21:00:00,12,0,4,6626,5523,12165,47407
2022-04-22 21:00:00,2022-04-22 22:00:00,12,0,4,8355,5854,14225,45290
2022-04-22 22:00:00,2022-04-22 23:00:00,12,0,4,8808,5776,14600,42793
2022-04-22 23:00:00,2022-04-23 00:00:00,12,0,4,8907,6166,15089,40662
2022-04-23 00:00:00,2022-04-23 01:00:00,12,0,4,8936,6081,15033,39608
2022-04-23 01:00:00,2022-04-23 02:00:00,12,0,4,8837,5744,14597,38994
2022-04-23 02:00:00,2022-04-23 03:00:00,5,0,4,8636,6106,14751,38856
2022-04-23 03:00:00,2022-04-23 04:00:00,31,0,4,8659,6470,15164,39534
2022-04-23 04:00:00,2022-04-23 05:00:00,38,0,33,8375,6171,14617,39874
2022-04-23 05:00:00,2022-04-23 06:00:00,36,0,191,8374,5997,14598,39468
2022-04-23 06:00:00,2022-04-23 07:00:00,36,0,505,7945,6058,14544,38363
2022-04-23 07:00:00,2022-04-23 08:00:00,34,0,823,5919,6272,13048,35927
2022-04-23 08:00:00,2022-04-23 09:00:00,32,0,1030,3562,5819,10443,33243
2022-04-23 09:00:00,2022-04-23 10:00:00,32,0,1034,3302,5592,9960,31747
2022-04-23 10:00:00,2022-04-23 11:00:00,32,0,1090,2511,4760,8393,29636
2022-04-23 11:00:00,2022-04-23 12:00:00,31,0,1092,2593,4835,8551,28697
2022-04-23 12:00:00,2022-04-23 13:00:00,31,0,1088,2980,5006,9105,28974
2022-04-23 13:00:00,2022-04-23 14:00:00,30,0,1124,3879,5405,10438,30572
2022-04-23 14:00:00,2022-04-23 15:00:00,29,0,964,5623,5903,12519,33992
2022-04-23 15:00:00,2022-04-23 16:00:00,28,0,737,8217,6842,15824,39075
2022-04-23 16:00:00,2022-04-23 17:00:00,28,0,408,8254,6532,15222,42561
2022-04-23 17:00:00,2022-04-23 18:00:00,28,0,124,8566,5695,14413,45256
2022-04-23 18:00:00,2022-04-23 19:00:00,28,0,11,8748,6062,14849,47116
2022-04-23 19:00:00,2022-04-23 20:00:00,28,0,4,8704,6521,15257,46712
2022-04-23 20:00:00,2022-04-23 21:00:00,28,0,4,8845,6528,15405,44776
2022-04-23 21:00:00,2022-04-23 22:00:00,28,0,4,8832,6682,15546,42430
2022-04-23 22:00:00,2022-04-23 23:00:00,28,0,4,8696,6626,15354,40443
2022-04-23 23:00:00,2022-04-24 00:00:00,28,0,4,8277,6457,14766,39097
2022-04-24 00:00:00,2022-04-24 01:00:00,28,0,4,8102,6211,14345,38128
2022-04-24 01:00:00,2022-04-24 02:00:00,28,0,4,8194,6365,14591,37779
2022-04-24 02:00:00,2022-04-24 03:00:00,28,0,4,8534,6176,14742,37389
2022-04-24 03:00:00,2022-04-24 04:00:00,28,0,4,8457,6317,14806,37696
2022-04-24 04:00:00,2022-04-24 05:00:00,28,0,34,8309,6216,14587,37208
2022-04-24 05:00:00,2022-04-24 06:00:00,28,0,186,7818,5701,13733,35874
2022-04-24 06:00:00,2022-04-24 07:00:00,28,0,438,7287,5025,12778,34130
2022-04-24 07:00:00,2022-04-24 08:00:00,28,0,726,6973,4383,12110,31792
2022-04-24 08:00:00,2022-04-24 09:00:00,28,0,934,5206,3624,9792,28673
2022-04-24 09:00:00,2022-04-24 10:00:00,28,0,1061,3075,3735,7899,26401
2022-04-24 10:00:00,2022-04-24 11:00:00,28,0,1036,1665,3861,6590,25042
2022-04-24 11:00:00,2022-04-24 12:00:00,28,0,976,2005,4080,7089,24923
2022-04-24 12:00:00,2022-04-24 13:00:00,28,0,935,3081,4653,8697,26533
2022-04-24 13:00:00,2022-04-24 14:00:00,28,0,846,4058,5049,9981,28466
2022-04-24 14:00:00,2022-04-24 15:00:00,28,0,841,7050,6034,13953,31938
2022-04-24 15:00:00,2022-04-24 16:00:00,28,0,742,7766,6228,14764,38209
2022-04-24 16:00:00,2022-04-24 17:00:00,28,0,394,8619,6304,15345,41957
2022-04-24 17:00:00,2022-04-24 18:00:00,28,0,131,8606,6153,14918,45118
2022-04-24 18:00:00,2022-04-24 19:00:00,28,0,11,8269,5826,14134,47276
2022-04-24 19:00:00,2022-04-24 20:00:00,28,0,4,7971,5564,13567,47134
2022-04-24 20:00:00,2022-04-24 21:00:00,28,0,4,8038,4653,12723,45306
2022-04-24 21:00:00,2022-04-24 22:00:00,28,0,4,7547,4139,11718,42615
2022-04-24 22:00:00,2022-04-24 23:00:00,28,0,4,6891,3741,10664,40622
2022-04-24 23:00:00,2022-04-25 00:00:00,28,0,4,6255,3397,9684,39226
2022-04-25 00:00:00,2022-04-25 01:00:00,28,0,4,4814,3485,8331,38585
2022-04-25 01:00:00,2022-04-25 02:00:00,28,0,4,4897,3084,8013,38510
2022-04-25 02:00:00,2022-04-25 03:00:00,28,0,4,4697,2553,7282,38892
2022-04-25 03:00:00,2022-04-25 04:00:00,28,0,4,4306,2508,6846,40774
2022-04-25 04:00:00,2022-04-25 05:00:00,28,0,8,4723,2384,7143,44922
2022-04-25 05:00:00,2022-04-25 06:00:00,28,0,73,4644,2121,6866,49593
2022-04-25 06:00:00,2022-04-25 07:00:00,28,0,84,4473,1958,6543,52513
2022-04-25 07:00:00,2022-04-25 08:00:00,28,0,146,4974,2092,7240,53150
2022-04-25 08:00:00,2022-04-25 09:00:00,28,0,265,4794,2192,7279,52826
2022-04-25 09:00:00,2022-04-25 10:00:00,37,0,434,3238,1915,5624,51937
2022-04-25 10:00:00,2022-04-25 11:00:00,57,0,459,3030,1883,5429,51265
2022-04-25 11:00:00,2022-04-25 12:00:00,61,0,604,3112,2303,6080,50744
2022-04-25 12:00:00,2022-04-25 13:00:00,61,0,491,3248,2245,6045,49774
2022-04-25 13:00:00,2022-04-25 14:00:00,60,0,265,2945,1974,5244,49294
2022-04-25 14:00:00,2022-04-25 15:00:00,60,0,197,3385,2242,5884,50250
2022-04-25 15:00:00,2022-04-25 16:00:00,60,0,225,3826,2418,6529,52596
2022-04-25 16:00:00,2022-04-25 17:00:00,60,0,167,4739,2808,7774,52403
2022-04-25 17:00:00,2022-04-25 18:00:00,62,0,99,4529,2835,7525,52936
2022-04-25 18:00:00,2022-04-25 19:00:00,62,0,12,4794,2942,7810,53454
2022-04-25 19:00:00,2022-04-25 20:00:00,64,0,4,5578,3490,9136,51754
2022-04-25 20:00:00,2022-04-25 21:00:00,64,0,4,6223,3926,10217,48729
2022-04-25 21:00:00,2022-04-25 22:00:00,64,0,4,7039,3855,10962,45901
2022-04-25 22:00:00,2022-04-25 23:00:00,60,0,4,6942,3719,10725,43287
2022-04-25 23:00:00,2022-04-26 00:00:00,56,0,4,7135,3940,11135,41406
2022-04-26 00:00:00,2022-04-26 01:00:00,56,0,4,6450,3913,10423,40603
2022-04-26 01:00:00,2022-04-26 02:00:00,56,0,4,5836,3852,9748,40331
2022-04-26 02:00:00,2022-04-26 03:00:00,56,0,4,5699,3676,9435,40596
2022-04-26 03:00:00,2022-04-26 04:00:00,55,0,4,5680,3388,9127,42416
2022-04-26 04:00:00,2022-04-26 05:00:00,52,0,26,6085,3324,9487,46206
2022-04-26 05:00:00,2022-04-26 06:00:00,52,0,137,5068,3662,8919,49328
2022-04-26 06:00:00,2022-04-26 07:00:00,52,0,331,4624,3464,8471,49365
2022-04-26 07:00:00,2022-04-26 08:00:00,52,0,583,3859,3292,7786,45927
2022-04-26 08:00:00,2022-04-26 09:00:00,52,0,777,2763,3205,6797,41152
2022-04-26 09:00:00,2022-04-26 10:00:00,52,0,995,2299,3004,6350,37978
2022-04-26 10:00:00,2022-04-26 11:00:00,52,0,1051,1627,2678,5408,36327
2022-04-26 11:00:00,2022-04-26 12:00:00,53,0,1007,1287,2480,4827,35467
2022-04-26 12:00:00,2022-04-26 13:00:00,53,0,1052,1535,2885,5525,35085
2022-04-26 13:00:00,2022-04-26 14:00:00,52,0,1098,1418,2820,5388,36443
2022-04-26 14:00:00,2022-04-26 15:00:00,55,0,1029,1429,2659,5172,39579
2022-04-26 15:00:00,2022-04-26 16:00:00,59,0,672,1603,2289,4623,43870
2022-04-26 16:00:00,2022-04-26 17:00:00,60,0,429,1672,2179,4340,46453
2022-04-26 17:00:00,2022-04-26 18:00:00,60,0,134,1899,1946,4039,49584
2022-04-26 18:00:00,2022-04-26 19:00:00,60,0,15,1622,1749,3446,51679
2022-04-26 19:00:00,2022-04-26 20:00:00,60,0,4,1332,1252,2648,51151
2022-04-26 20:00:00,2022-04-26 21:00:00,60,0,4,1194,842,2100,48408
2022-04-26 21:00:00,2022-04-26 22:00:00,58,0,4,1249,856,2167,45922
2022-04-26 22:00:00,2022-04-26 23:00:00,56,0,4,1176,751,1987,43495
2022-04-26 23:00:00,2022-04-27 00:00:00,60,0,4,1001,583,1648,41827
2022-04-27 00:00:00,2022-04-27 01:00:00,64,0,4,1144,511,1723,40891
2022-04-27 01:00:00,2022-04-27 02:00:00,64,0,4,1159,463,1690,40473
2022-04-27 02:00:00,2022-04-27 03:00:00,64,0,4,822,483,1373,40396
2022-04-27 03:00:00,2022-04-27 04:00:00,64,0,4,796,397,1261,40801
2022-04-27 04:00:00,2022-04-27 05:00:00,64,0,23,501,376,964,40675
2022-04-27 05:00:00,2022-04-27 06:00:00,63,0,99,476,431,1069,39848
2022-04-27 06:00:00,2022-04-27 07:00:00,60,0,204,579,459,1302,38484
2022-04-27 07:00:00,2022-04-27 08:00:00,60,0,356,701,466,1583,36904
2022-04-27 08:00:00,2022-04-27 09:00:00,63,0,461,508,463,1495,35313
2022-04-27 09:00:00,2022-04-27 10:00:00,64,0,582,462,430,1538,33732
2022-04-27 10:00:00,2022-04-27 11:00:00,64,0,728,470,531,1793,32218
2022-04-27 11:00:00,2022-04-27 12:00:00,64,0,751,742,673,2230,30282
2022-04-27 12:00:00,2022-04-27 13:00:00,64,0,707,1217,737,2725,28860
2022-04-27 13:00:00,2022-04-27 14:00:00,64,0,688,1622,839,3213,29411
2022-04-27 14:00:00,2022-04-27 15:00:00,61,0,549,1750,1028,3388,32413
2022-04-27 15:00:00,2022-04-27 16:00:00,60,0,402,1653,1170,3285,37198
2022-04-27 16:00:00,2022-04-27 17:00:00,62,0,257,1516,1236,3071,41026
2022-04-27 17:00:00,2022-04-27 18:00:00,64,0,119,1139,1215,2537,44519
2022-04-27 18:00:00,2022-04-27 19:00:00,64,0,14,1289,1201,2568,47279
2022-04-27 19:00:00,2022-04-27 20:00:00,64,0,4,1607,1172,2847,47300
2022-04-27 20:00:00,2022-04-27 21:00:00,64,0,4,1480,1034,2582,45518
2022-04-27 21:00:00,2022-04-27 22:00:00,64,0,4,1539,968,2575,43399
2022-04-27 22:00:00,2022-04-27 23:00:00,64,0,4,1424,991,2483,41501
2022-04-27 23:00:00,2022-04-28 00:00:00,64,0,4,1564,1037,2669,40042
2022-04-28 00:00:00,2022-04-28 01:00:00,64,0,4,1401,1060,2529,39317
2022-04-28 01:00:00,2022-04-28 02:00:00,64,0,4,1345,1106,2519,39014
2022-04-28 02:00:00,2022-04-28 03:00:00,64,0,4,1460,1305,2833,39400
2022-04-28 03:00:00,2022-04-28 04:00:00,64,0,3,1253,1387,2707,41268
2022-04-28 04:00:00,2022-04-28 05:00:00,64,0,23,1222,1220,2529,44105
2022-04-28 05:00:00,2022-04-28 06:00:00,64,0,127,1177,876,2244,45922
2022-04-28 06:00:00,2022-04-28 07:00:00,63,0,336,1286,789,2474,45380
2022-04-28 07:00:00,2022-04-28 08:00:00,79,0,506,1269,872,2726,42777
2022-04-28 08:00:00,2022-04-28 09:00:00,103,0,653,1349,976,3081,39758
2022-04-28 09:00:00,2022-04-28 10:00:00,105,0,716,1457,1106,3384,36355
2022-04-28 10:00:00,2022-04-28 11:00:00,106,0,809,1201,1180,3296,33690
2022-04-28 11:00:00,2022-04-28 12:00:00,104,0,850,1471,1395,3820,32853
2022-04-28 12:00:00,2022-04-28 13:00:00,104,0,928,1923,1564,4519,32610
2022-04-28 13:00:00,2022-04-28 14:00:00,103,0,1006,2228,1744,5081,33988
2022-04-28 14:00:00,2022-04-28 15:00:00,103,0,890,2339,1855,5187,37797
2022-04-28 15:00:00,2022-04-28 16:00:00,121,0,766,2656,2153,5696,43738
2022-04-28 16:00:00,2022-04-28 17:00:00,131,0,384,2745,2352,5612,47629
2022-04-28 17:00:00,2022-04-28 18:00:00,131,0,99,3206,2368,5804,50803
2022-04-28 18:00:00,2022-04-28 19:00:00,134,0,11,3401,2312,5858,52393
2022-04-28 19:00:00,2022-04-28 20:00:00,135,0,4,3588,2515,6242,51225
2022-04-28 20:00:00,2022-04-28 21:00:00,135,0,4,3469,2644,6252,48402
2022-04-28 21:00:00,2022-04-28 22:00:00,135,0,4,3495,2408,6042,45796
2022-04-28 22:00:00,2022-04-28 23:00:00,134,0,4,3310,2123,5571,43203
2022-04-28 23:00:00,2022-04-29 00:00:00,136,0,4,2969,1963,5072,41443
2022-04-29 00:00:00,2022-04-29 01:00:00,135,0,4,2546,2060,4745,40512
2022-04-29 01:00:00,2022-04-29 02:00:00,136,0,4,2154,1902,4196,40180
2022-04-29 02:00:00,2022-04-29 03:00:00,136,0,4,1779,1501,3420,40315
2022-04-29 03:00:00,2022-04-29 04:00:00,134,0,3,1809,1491,3437,42017
2022-04-29 04:00:00,2022-04-29 05:00:00,132,0,51,1895,1537,3615,44988
2022-04-29 05:00:00,2022-04-29 06:00:00,131,0,230,1681,1421,3463,47918
2022-04-29 06:00:00,2022-04-29 07:00:00,129,0,288,1948,1366,3731,48877
2022-04-29 07:00:00,2022-04-29 08:00:00,131,0,391,2119,1452,4093,47760
2022-04-29 08:00:00,2022-04-29 09:00:00,131,0,632,1743,1330,3836,47002
2022-04-29 09:00:00,2022-04-29 10:00:00,108,0,660,2346,1506,4620,46310
2022-04-29 10:00:00,2022-04-29 11:00:00,108,0,639,2906,1743,5396,44564
2022-04-29 11:00:00,2022-04-29 12:00:00,109,0,615,3542,2216,6482,42591
2022-04-29 12:00:00,2022-04-29 13:00:00,110,0,671,4073,2396,7250,40637
2022-04-29 13:00:00,2022-04-29 14:00:00,110,0,751,4828,2642,8331,40072
2022-04-29 14:00:00,2022-04-29 15:00:00,109,0,550,6102,2974,9735,42378
2022-04-29 15:00:00,2022-04-29 16:00:00,108,0,385,5781,3348,9622,46213
2022-04-29 16:00:00,2022-04-29 17:00:00,108,0,228,5760,3564,9660,47739
2022-04-29 17:00:00,2022-04-29 18:00:00,108,0,117,6116,3457,9798,49767
2022-04-29 18:00:00,2022-04-29 19:00:00,108,0,14,6237,3175,9534,51349
2022-04-29 19:00:00,2022-04-29 20:00:00,109,0,4,6617,2961,9691,50449
2022-04-29 20:00:00,2022-04-29 21:00:00,111,0,4,6064,2809,8988,47830
2022-04-29 21:00:00,2022-04-29 22:00:00,112,0,4,5156,2579,7851,45202
2022-04-29 22:00:00,2022-04-29 23:00:00,112,0,4,4664,2342,7122,43194
2022-04-29 23:00:00,2022-04-30 00:00:00,116,0,4,3875,2238,6233,41732
2022-04-30 00:00:00,2022-04-30 01:00:00,115,0,4,3035,1852,5006,40787
2022-04-30 01:00:00,2022-04-30 02:00:00,116,0,4,2308,1585,4013,40253
2022-04-30 02:00:00,2022-04-30 03:00:00,115,0,4,1657,1171,2947,40002
2022-04-30 03:00:00,2022-04-30 04:00:00,116,0,4,1648,929,2697,40326
2022-04-30 04:00:00,2022-04-30 05:00:00,115,0,56,1359,1001,2531,40505
2022-04-30 05:00:00,2022-04-30 06:00:00,112,0,163,1208,877,2360,40580
2022-04-30 06:00:00,2022-04-30 07:00:00,108,0,362,937,867,2274,40387
2022-04-30 07:00:00,2022-04-30 08:00:00,89,0,468,1010,896,2463,39467
2022-04-30 08:00:00,2022-04-30 09:00:00,67,0,564,1201,1009,2841,38755
2022-04-30 09:00:00,2022-04-30 10:00:00,77,0,569,1349,1094,3089,39183
2022-04-30 10:00:00,2022-04-30 11:00:00,70,0,466,1239,1300,3075,39095
2022-04-30 11:00:00,2022-04-30 12:00:00,64,0,560,1436,1324,3384,38749
2022-04-30 12:00:00,2022-04-30 13:00:00,62,0,568,1330,1264,3224,38678
2022-04-30 13:00:00,2022-04-30 14:00:00,60,0,558,905,1268,2791,39161
2022-04-30 14:00:00,2022-04-30 15:00:00,62,0,518,879,1100,2559,40958
2022-04-30 15:00:00,2022-04-30 16:00:00,61,0,367,793,1100,2321,44623
2022-04-30 16:00:00,2022-04-30 17:00:00,62,0,217,510,1193,1982,46283
2022-04-30 17:00:00,2022-04-30 18:00:00,61,0,93,301,1143,1598,47349
2022-04-30 18:00:00,2022-04-30 19:00:00,62,0,11,198,864,1135,48492
2022-04-30 19:00:00,2022-04-30 20:00:00,60,0,8,179,733,980,48089
2022-04-30 20:00:00,2022-04-30 21:00:00,60,0,8,102,667,837,46161
2022-04-30 21:00:00,2022-04-30 22:00:00,60,0,8,103,561,732,44090
2022-04-30 22:00:00,2022-04-30 23:00:00,60,0,8,129,530,727,42149
2022-04-30 23:00:00,2022-05-01 00:00:00,60,0,8,133,499,700,40808
2022-05-01 00:00:00,2022-05-01 01:00:00,60,0,8,122,417,607,40073
2022-05-01 01:00:00,2022-05-01 02:00:00,60,0,8,129,392,589,39710
2022-05-01 02:00:00,2022-05-01 03:00:00,60,0,8,123,382,573,39468
2022-05-01 03:00:00,2022-05-01 04:00:00,60,0,7,132,384,583,39333
2022-05-01 04:00:00,2022-05-01 05:00:00,60,0,48,115,392,615,38034
2022-05-01 05:00:00,2022-05-01 06:00:00,60,0,192,115,394,761,36351
2022-05-01 06:00:00,2022-05-01 07:00:00,60,0,452,135,372,1019,35621
2022-05-01 07:00:00,2022-05-01 08:00:00,60,0,656,123,389,1228,34511
2022-05-01 08:00:00,2022-05-01 09:00:00,60,0,820,143,401,1424,33122
2022-05-01 09:00:00,2022-05-01 10:00:00,60,0,909,163,397,1529,32822
2022-05-01 10:00:00,2022-05-01 11:00:00,60,0,837,117,387,1401,31965
2022-05-01 11:00:00,2022-05-01 12:00:00,60,0,864,111,415,1450,30668
2022-05-01 12:00:00,2022-05-01 13:00:00,60,0,766,124,429,1379,30019
2022-05-01 13:00:00,2022-05-01 14:00:00,60,0,623,124,416,1223,31017
2022-05-01 14:00:00,2022-05-01 15:00:00,60,0,528,127,444,1159,33734
2022-05-01 15:00:00,2022-05-01 16:00:00,60,0,505,136,503,1204,39114
2022-05-01 16:00:00,2022-05-01 17:00:00,60,0,354,129,520,1063,42427
2022-05-01 17:00:00,2022-05-01 18:00:00,60,0,145,104,541,850,45149
2022-05-01 18:00:00,2022-05-01 19:00:00,59,0,23,111,733,926,47194
2022-05-01 19:00:00,2022-05-01 20:00:00,56,0,4,161,1103,1324,47432
2022-05-01 20:00:00,2022-05-01 21:00:00,56,0,4,228,1302,1590,45530
2022-05-01 21:00:00,2022-05-01 22:00:00,56,0,4,224,1359,1643,43257
2022-05-01 22:00:00,2022-05-01 23:00:00,60,0,4,244,1276,1584,41723
2022-05-01 23:00:00,2022-05-02 00:00:00,59,0,4,205,1207,1475,40415
2022-05-02 00:00:00,2022-05-02 01:00:00,60,0,4,194,979,1237,39793
2022-05-02 01:00:00,2022-05-02 02:00:00,60,0,4,185,819,1068,39889
2022-05-02 02:00:00,2022-05-02 03:00:00,60,0,4,117,632,813,40503
2022-05-02 03:00:00,2022-05-02 04:00:00,62,0,4,99,410,575,42354
2022-05-02 04:00:00,2022-05-02 05:00:00,64,0,60,117,390,631,44909
2022-05-02 05:00:00,2022-05-02 06:00:00,64,0,243,115,379,801,45808
2022-05-02 06:00:00,2022-05-02 07:00:00,64,0,561,119,377,1121,44383
2022-05-02 07:00:00,2022-05-02 08:00:00,62,0,888,120,382,1452,40801
2022-05-02 08:00:00,2022-05-02 09:00:00,60,0,1123,122,388,1693,36711
2022-05-02 09:00:00,2022-05-02 10:00:00,60,0,1135,109,427,1731,33612
2022-05-02 10:00:00,2022-05-02 11:00:00,60,0,1239,116,495,1910,31513
2022-05-02 11:00:00,2022-05-02 12:00:00,60,0,1265,169,673,2167,31064
2022-05-02 12:00:00,2022-05-02 13:00:00,60,0,1274,264,982,2580,31479
2022-05-02 13:00:00,2022-05-02 14:00:00,62,0,1183,341,1333,2919,33634
2022-05-02 14:00:00,2022-05-02 15:00:00,60,0,1009,408,1740,3217,37199
2022-05-02 15:00:00,2022-05-02 16:00:00,60,0,728,534,2143,3465,42153
2022-05-02 16:00:00,2022-05-02 17:00:00,60,0,437,617,2273,3387,44944
2022-05-02 17:00:00,2022-05-02 18:00:00,60,0,158,720,2093,3031,48247
2022-05-02 18:00:00,2022-05-02 19:00:00,60,0,16,853,2039,2968,50321
2022-05-02 19:00:00,2022-05-02 20:00:00,60,0,4,867,1849,2780,50553
2022-05-02 20:00:00,2022-05-02 21:00:00,60,0,4,894,1505,2463,48281
2022-05-02 21:00:00,2022-05-02 22:00:00,61,0,4,669,1139,1873,45841
2022-05-02 22:00:00,2022-05-02 23:00:00,62,0,4,509,831,1406,43846
2022-05-02 23:00:00,2022-05-03 00:00:00,64,0,4,347,633,1048,42333
2022-05-03 00:00:00,2022-05-03 01:00:00,64,0,4,361,532,961,41482
2022-05-03 01:00:00,2022-05-03 02:00:00,64,0,4,459,502,1029,41190
2022-05-03 02:00:00,2022-05-03 03:00:00,64,0,4,866,441,1375,41535
2022-05-03 03:00:00,2022-05-03 04:00:00,64,0,4,971,423,1462,43180
2022-05-03 04:00:00,2022-05-03 05:00:00,64,0,52,1090,446,1652,45308
2022-05-03 05:00:00,2022-05-03 06:00:00,64,0,140,1038,768,2010,47085
2022-05-03 06:00:00,2022-05-03 07:00:00,62,0,220,1049,1105,2436,46942
2022-05-03 07:00:00,2022-05-03 08:00:00,62,0,239,767,915,1983,45163
2022-05-03 08:00:00,2022-05-03 09:00:00,62,0,366,636,915,1979,43584
2022-05-03 09:00:00,2022-05-03 10:00:00,62,0,430,634,1040,2166,42081
2022-05-03 10:00:00,2022-05-03 11:00:00,61,0,656,1170,1183,3070,41167
2022-05-03 11:00:00,2022-05-03 12:00:00,62,0,850,1675,1373,3960,41977
2022-05-03 12:00:00,2022-05-03 13:00:00,60,0,854,1530,1301,3745,42486
2022-05-03 13:00:00,2022-05-03 14:00:00,60,0,921,1528,1255,3764,43492
2022-05-03 14:00:00,2022-05-03 15:00:00,60,0,641,1920,1605,4226,45615
2022-05-03 15:00:00,2022-05-03 16:00:00,60,0,498,1809,2082,4449,48480
2022-05-03 16:00:00,2022-05-03 17:00:00,60,0,241,1382,2325,4008,49246
2022-05-03 17:00:00,2022-05-03 18:00:00,60,0,80,1372,2031,3543,50817
2022-05-03 18:00:00,2022-05-03 19:00:00,60,0,20,1372,1550,3002,51882
2022-05-03 19:00:00,2022-05-03 20:00:00,60,0,8,1230,1203,2501,51813
2022-05-03 20:00:00,2022-05-03 21:00:00,60,0,8,1121,947,2136,49249
2022-05-03 21:00:00,2022-05-03 22:00:00,60,0,8,870,740,1678,46712
2022-05-03 22:00:00,2022-05-03 23:00:00,60,0,8,510,642,1220,44464
2022-05-03 23:00:00,2022-05-04 00:00:00,60,0,8,331,546,945,43006
2022-05-04 00:00:00,2022-05-04 01:00:00,60,0,8,114,483,665,42315
2022-05-04 01:00:00,2022-05-04 02:00:00,60,0,8,76,453,597,42076
2022-05-04 02:00:00,2022-05-04 03:00:00,61,0,8,94,413,576,42188
2022-05-04 03:00:00,2022-05-04 04:00:00,60,0,6,100,400,566,43354
2022-05-04 04:00:00,2022-05-04 05:00:00,60,0,39,106,387,592,45801
2022-05-04 05:00:00,2022-05-04 06:00:00,60,0,159,111,344,674,46916
2022-05-04 06:00:00,2022-05-04 07:00:00,60,0,355,109,362,886,45584
2022-05-04 07:00:00,2022-05-04 08:00:00,61,0,673,104,386,1224,42067
2022-05-04 08:00:00,2022-05-04 09:00:00,60,0,923,114,386,1483,38472
2022-05-04 09:00:00,2022-05-04 10:00:00,61,0,1096,119,392,1668,35263
2022-05-04 10:00:00,2022-05-04 11:00:00,62,0,1265,122,390,1839,32887
2022-05-04 11:00:00,2022-05-04 12:00:00,60,0,1266,106,403,1835,32178
2022-05-04 12:00:00,2022-05-04 13:00:00,61,0,1232,105,439,1837,32997
2022-05-04 13:00:00,2022-05-04 14:00:00,61,0,1183,83,488,1815,35249
2022-05-04 14:00:00,2022-05-04 15:00:00,61,0,1037,99,524,1721,38922
2022-05-04 15:00:00,2022-05-04 16:00:00,60,0,773,172,524,1529,44459
2022-05-04 16:00:00,2022-05-04 17:00:00,61,0,394,200,479,1134,47492
2022-05-04 17:00:00,2022-05-04 18:00:00,61,0,154,95,413,723,50132
2022-05-04 18:00:00,2022-05-04 19:00:00,60,0,21,123,395,599,51812
2022-05-04 19:00:00,2022-05-04 20:00:00,60,0,4,278,388,730,52057
2022-05-04 20:00:00,2022-05-04 21:00:00,60,0,4,165,342,571,49491
2022-05-04 21:00:00,2022-05-04 22:00:00,60,0,4,149,369,582,46689
2022-05-04 22:00:00,2022-05-04 23:00:00,60,0,4,215,400,679,44201
2022-05-04 23:00:00,2022-05-05 00:00:00,61,0,4,127,460,652,42709
2022-05-05 00:00:00,2022-05-05 01:00:00,60,0,4,217,459,740,41945
2022-05-05 01:00:00,2022-05-05 02:00:00,61,0,4,112,401,578,41661
2022-05-05 02:00:00,2022-05-05 03:00:00,61,0,4,149,259,473,41860
2022-05-05 03:00:00,2022-05-05 04:00:00,60,0,5,179,235,479,43004
2022-05-05 04:00:00,2022-05-05 05:00:00,60,0,49,161,274,544,45119
2022-05-05 05:00:00,2022-05-05 06:00:00,60,0,178,241,283,762,46917
2022-05-05 06:00:00,2022-05-05 07:00:00,60,0,397,342,310,1109,47548
2022-05-05 07:00:00,2022-05-05 08:00:00,62,0,454,256,297,1069,45552
2022-05-05 08:00:00,2022-05-05 09:00:00,60,0,614,196,243,1113,42891
2022-05-05 09:00:00,2022-05-05 10:00:00,62,0,932,179,240,1413,40574
2022-05-05 10:00:00,2022-05-05 11:00:00,60,0,1076,166,268,1570,38287
2022-05-05 11:00:00,2022-05-05 12:00:00,61,0,1079,116,347,1603,37171
2022-05-05 12:00:00,2022-05-05 13:00:00,60,0,1070,85,445,1660,37673
2022-05-05 13:00:00,2022-05-05 14:00:00,61,0,783,101,573,1518,39330
2022-05-05 14:00:00,2022-05-05 15:00:00,61,0,631,181,684,1557,42280
2022-05-05 15:00:00,2022-05-05 16:00:00,60,0,358,259,567,1244,46488
2022-05-05 16:00:00,2022-05-05 17:00:00,63,0,250,209,560,1082,47831
2022-05-05 17:00:00,2022-05-05 18:00:00,68,0,139,221,436,864,49861
2022-05-05 18:00:00,2022-05-05 19:00:00,82,0,25,188,328,623,51934
2022-05-05 19:00:00,2022-05-05 20:00:00,84,0,4,145,310,543,51381
2022-05-05 20:00:00,2022-05-05 21:00:00,83,0,4,107,318,512,49128
2022-05-05 21:00:00,2022-05-05 22:00:00,80,0,4,95,277,456,46980
2022-05-05 22:00:00,2022-05-05 23:00:00,81,0,4,90,260,435,44749
2022-05-05 23:00:00,2022-05-06 00:00:00,84,0,4,87,247,422,42869
2022-05-06 00:00:00,2022-05-06 01:00:00,84,0,4,80,233,401,42003
2022-05-06 01:00:00,2022-05-06 02:00:00,82,0,4,89,220,395,41747
2022-05-06 02:00:00,2022-05-06 03:00:00,35,0,4,141,202,382,41875
2022-05-06 03:00:00,2022-05-06 04:00:00,69,0,8,347,206,630,42942
2022-05-06 04:00:00,2022-05-06 05:00:00,82,0,66,447,205,800,45145
2022-05-06 05:00:00,2022-05-06 06:00:00,80,0,204,520,240,1044,47696
2022-05-06 06:00:00,2022-05-06 07:00:00,79,0,462,346,335,1222,47891
2022-05-06 07:00:00,2022-05-06 08:00:00,82,0,788,335,343,1548,44743
2022-05-06 08:00:00,2022-05-06 09:00:00,79,0,954,632,391,2056,39318
2022-05-06 09:00:00,2022-05-06 10:00:00,87,0,1128,797,489,2501,34854
2022-05-06 10:00:00,2022-05-06 11:00:00,94,0,1184,1114,628,3020,32627
2022-05-06 11:00:00,2022-05-06 12:00:00,94,0,1197,1652,675,3618,32347
2022-05-06 12:00:00,2022-05-06 13:00:00,96,0,1255,1679,764,3794,33241
2022-05-06 13:00:00,2022-05-06 14:00:00,95,0,1082,1854,1184,4215,35529
2022-05-06 14:00:00,2022-05-06 15:00:00,85,0,687,2040,1420,4232,38788
2022-05-06 15:00:00,2022-05-06 16:00:00,80,0,636,1816,1745,4277,43654
2022-05-06 16:00:00,2022-05-06 17:00:00,83,0,309,1959,1665,4016,46330
2022-05-06 17:00:00,2022-05-06 18:00:00,81,0,132,2137,1141,3491,49495
2022-05-06 18:00:00,2022-05-06 19:00:00,83,0,30,2461,964,3538,51506
2022-05-06 19:00:00,2022-05-06 20:00:00,84,0,4,2347,905,3340,51644
2022-05-06 20:00:00,2022-05-06 21:00:00,84,0,4,1863,772,2723,49389
2022-05-06 21:00:00,2022-05-06 22:00:00,82,0,4,1515,752,2353,46598
2022-05-06 22:00:00,2022-05-06 23:00:00,83,0,4,675,796,1558,43823
2022-05-06 23:00:00,2022-05-07 00:00:00,83,0,4,507,794,1388,41781
2022-05-07 00:00:00,2022-05-07 01:00:00,83,0,4,499,794,1380,40813
2022-05-07 01:00:00,2022-05-07 02:00:00,84,0,4,547,819,1454,40591
2022-05-07 02:00:00,2022-05-07 03:00:00,82,0,4,293,760,1139,40478
2022-05-07 03:00:00,2022-05-07 04:00:00,82,0,4,244,663,993,40474
2022-05-07 04:00:00,2022-05-07 05:00:00,81,0,51,158,567,857,40540
2022-05-07 05:00:00,2022-05-07 06:00:00,81,0,132,155,505,873,39959
2022-05-07 06:00:00,2022-05-07 07:00:00,82,0,360,259,423,1124,38884
2022-05-07 07:00:00,2022-05-07 08:00:00,82,0,574,162,420,1238,37522
2022-05-07 08:00:00,2022-05-07 09:00:00,81,0,650,116,542,1389,34656
2022-05-07 09:00:00,2022-05-07 10:00:00,80,0,717,145,905,1847,32828
2022-05-07 10:00:00,2022-05-07 11:00:00,82,0,806,163,1306,2357,32659
2022-05-07 11:00:00,2022-05-07 12:00:00,82,0,811,352,1512,2757,33097
2022-05-07 12:00:00,2022-05-07 13:00:00,81,0,849,727,1952,3609,33316
2022-05-07 13:00:00,2022-05-07 14:00:00,84,0,809,1251,2505,4649,34591
2022-05-07 14:00:00,2022-05-07 15:00:00,81,0,755,1986,3051,5873,38138
2022-05-07 15:00:00,2022-05-07 16:00:00,82,0,660,2121,3602,6465,41615
2022-05-07 16:00:00,2022-05-07 17:00:00,80,0,462,2798,3644,6984,43470
2022-05-07 17:00:00,2022-05-07 18:00:00,82,0,183,3857,3478,7600,45207
2022-05-07 18:00:00,2022-05-07 19:00:00,82,0,25,4278,3284,7669,46827
2022-05-07 19:00:00,2022-05-07 20:00:00,84,0,4,3880,3048,7016,47054
2022-05-07 20:00:00,2022-05-07 21:00:00,83,0,4,4684,2953,7724,45474
2022-05-07 21:00:00,2022-05-07 22:00:00,79,0,4,5518,2778,8379,43705
2022-05-07 22:00:00,2022-05-07 23:00:00,81,0,4,4975,2329,7389,41488
2022-05-07 23:00:00,2022-05-08 00:00:00,83,0,4,4488,2437,7012,39621
2022-05-08 00:00:00,2022-05-08 01:00:00,83,0,4,4513,2367,6967,38992
2022-05-08 01:00:00,2022-05-08 02:00:00,84,0,4,4116,2209,6413,38510
2022-05-08 02:00:00,2022-05-08 03:00:00,83,0,4,4247,2014,6348,38390
2022-05-08 03:00:00,2022-05-08 04:00:00,84,0,10,4531,2082,6707,38003
2022-05-08 04:00:00,2022-05-08 05:00:00,80,0,88,3987,2004,6159,36681
2022-05-08 05:00:00,2022-05-08 06:00:00,83,0,284,3609,1778,5754,35040
2022-05-08 06:00:00,2022-05-08 07:00:00,81,0,494,3076,1862,5513,33718
2022-05-08 07:00:00,2022-05-08 08:00:00,82,0,714,2406,1544,4746,31821
2022-05-08 08:00:00,2022-05-08 09:00:00,83,0,1093,2203,1328,4707,28279
2022-05-08 09:00:00,2022-05-08 10:00:00,81,0,1271,1890,1276,4518,25301
2022-05-08 10:00:00,2022-05-08 11:00:00,81,0,1314,1889,1313,4597,23511
2022-05-08 11:00:00,2022-05-08 12:00:00,84,0,1330,2130,1404,4948,22467
2022-05-08 12:00:00,2022-05-08 13:00:00,80,0,1326,2404,1616,5426,22684
2022-05-08 13:00:00,2022-05-08 14:00:00,83,0,1273,2466,1848,5670,24444
2022-05-08 14:00:00,2022-05-08 15:00:00,83,0,1126,2461,2009,5679,28317
2022-05-08 15:00:00,2022-05-08 16:00:00,81,0,845,2372,2076,5374,34533
2022-05-08 16:00:00,2022-05-08 17:00:00,81,0,496,2388,2113,5078,39467
2022-05-08 17:00:00,2022-05-08 18:00:00,82,0,187,2082,2121,4472,43533
2022-05-08 18:00:00,2022-05-08 19:00:00,83,0,30,1735,1980,3828,46093
2022-05-08 19:00:00,2022-05-08 20:00:00,83,0,4,1415,1923,3425,47428
2022-05-08 20:00:00,2022-05-08 21:00:00,83,0,4,1259,1988,3334,45827
2022-05-08 21:00:00,2022-05-08 22:00:00,82,0,4,1081,1848,3015,43602
2022-05-08 22:00:00,2022-05-08 23:00:00,80,0,4,1111,1786,2981,41626
2022-05-08 23:00:00,2022-05-09 00:00:00,83,0,4,1085,1659,2831,40454
2022-05-09 00:00:00,2022-05-09 01:00:00,83,0,4,780,1503,2370,39718
2022-05-09 01:00:00,2022-05-09 02:00:00,84,0,4,395,1446,1929,39504
2022-05-09 02:00:00,2022-05-09 03:00:00,84,0,4,256,1455,1799,39904
2022-05-09 03:00:00,2022-05-09 04:00:00,84,0,8,247,1528,1867,41450
2022-05-09 04:00:00,2022-05-09 05:00:00,83,0,79,284,1473,1919,43719
2022-05-09 05:00:00,2022-05-09 06:00:00,80,0,281,110,1224,1695,45197
2022-05-09 06:00:00,2022-05-09 07:00:00,77,0,609,86,631,1403,43934
2022-05-09 07:00:00,2022-05-09 08:00:00,83,0,922,98,386,1489,40582
2022-05-09 08:00:00,2022-05-09 09:00:00,82,0,1139,111,377,1709,36895
2022-05-09 09:00:00,2022-05-09 10:00:00,83,0,1255,90,385,1813,34090
2022-05-09 10:00:00,2022-05-09 11:00:00,82,0,1301,66,375,1824,32169
2022-05-09 11:00:00,2022-05-09 12:00:00,82,0,1313,89,386,1870,31814
2022-05-09 12:00:00,2022-05-09 13:00:00,82,0,1283,119,458,1942,32517
2022-05-09 13:00:00,2022-05-09 14:00:00,83,0,1205,117,449,1854,34582
2022-05-09 14:00:00,2022-05-09 15:00:00,82,0,1027,118,532,1759,39049
2022-05-09 15:00:00,2022-05-09 16:00:00,80,0,727,91,512,1410,44959
2022-05-09 16:00:00,2022-05-09 17:00:00,82,0,405,138,500,1125,48317
2022-05-09 17:00:00,2022-05-09 18:00:00,84,0,164,139,417,804,51217
2022-05-09 18:00:00,2022-05-09 19:00:00,84,0,22,275,536,917,52527
2022-05-09 19:00:00,2022-05-09 20:00:00,82,0,4,666,424,1176,52649
2022-05-09 20:00:00,2022-05-09 21:00:00,83,0,4,1275,540,1902,50235
2022-05-09 21:00:00,2022-05-09 22:00:00,80,0,4,2051,586,2721,47346
2022-05-09 22:00:00,2022-05-09 23:00:00,84,0,4,2540,961,3589,43901
2022-05-09 23:00:00,2022-05-10 00:00:00,80,0,4,3265,1732,5081,41706
2022-05-10 00:00:00,2022-05-10 01:00:00,81,0,4,4170,2283,6538,41112
2022-05-10 01:00:00,2022-05-10 02:00:00,82,0,4,4599,2666,7351,40760
2022-05-10 02:00:00,2022-05-10 03:00:00,82,0,4,5564,3155,8805,40833
2022-05-10 03:00:00,2022-05-10 04:00:00,83,0,4,7610,3577,11274,42103
2022-05-10 04:00:00,2022-05-10 05:00:00,83,0,55,8562,4218,12918,44490
2022-05-10 05:00:00,2022-05-10 06:00:00,80,0,146,7658,5190,13074,47799
2022-05-10 06:00:00,2022-05-10 07:00:00,78,0,386,7582,5538,13584,48731
2022-05-10 07:00:00,2022-05-10 08:00:00,82,0,667,8288,5435,14472,47409
2022-05-10 08:00:00,2022-05-10 09:00:00,81,0,660,8598,5238,14577,45120
2022-05-10 09:00:00,2022-05-10 10:00:00,82,0,610,8214,5464,14370,42616
2022-05-10 10:00:00,2022-05-10 11:00:00,82,0,773,6972,5284,13111,39962
2022-05-10 11:00:00,2022-05-10 12:00:00,82,0,580,8581,6143,15386,41914
2022-05-10 12:00:00,2022-05-10 13:00:00,81,0,776,8830,5850,15537,44433
2022-05-10 13:00:00,2022-05-10 14:00:00,79,0,616,8781,5373,14849,46738
2022-05-10 14:00:00,2022-05-10 15:00:00,77,0,344,9085,5147,14653,50134
2022-05-10 15:00:00,2022-05-10 16:00:00,80,0,204,8849,4883,14016,52962
2022-05-10 16:00:00,2022-05-10 17:00:00,83,0,144,8237,5097,13561,52046
2022-05-10 17:00:00,2022-05-10 18:00:00,81,0,121,7477,4562,12241,51680
2022-05-10 18:00:00,2022-05-10 19:00:00,82,0,40,6179,3391,9692,51636
2022-05-10 19:00:00,2022-05-10 20:00:00,82,0,4,3653,2663,6402,51152
2022-05-10 20:00:00,2022-05-10 21:00:00,81,0,4,2671,2205,4961,48887
2022-05-10 21:00:00,2022-05-10 22:00:00,82,0,4,2454,1985,4525,46127
2022-05-10 22:00:00,2022-05-10 23:00:00,81,0,4,2360,1910,4355,43663
2022-05-10 23:00:00,2022-05-11 00:00:00,80,0,4,3177,1894,5155,42027
2022-05-11 00:00:00,2022-05-11 01:00:00,81,0,4,3938,2120,6143,41069
2022-05-11 01:00:00,2022-05-11 02:00:00,111,0,4,5092,2357,7564,40746
2022-05-11 02:00:00,2022-05-11 03:00:00,136,0,4,5320,2680,8140,40871
2022-05-11 03:00:00,2022-05-11 04:00:00,137,0,3,6159,2853,9152,42038
2022-05-11 04:00:00,2022-05-11 05:00:00,136,0,35,6122,3268,9561,44406
2022-05-11 05:00:00,2022-05-11 06:00:00,130,0,145,6701,3971,10947,46814
2022-05-11 06:00:00,2022-05-11 07:00:00,134,0,343,6332,4343,11152,46018
2022-05-11 07:00:00,2022-05-11 08:00:00,136,0,587,6275,4431,11429,42373
2022-05-11 08:00:00,2022-05-11 09:00:00,136,0,949,5792,3871,10748,38787
2022-05-11 09:00:00,2022-05-11 10:00:00,136,0,892,5639,3655,10322,35665
2022-05-11 10:00:00,2022-05-11 11:00:00,136,0,924,5667,3415,10142,33548
2022-05-11 11:00:00,2022-05-11 12:00:00,136,0,976,6604,4098,11814,32852
2022-05-11 12:00:00,2022-05-11 13:00:00,136,0,974,6804,4724,12638,33893
2022-05-11 13:00:00,2022-05-11 14:00:00,132,0,979,8114,5175,14400,37747
2022-05-11 14:00:00,2022-05-11 15:00:00,133,0,777,8554,5375,14839,43325
2022-05-11 15:00:00,2022-05-11 16:00:00,133,0,436,8400,6280,15249,49139
2022-05-11 16:00:00,2022-05-11 17:00:00,133,0,125,8532,6603,15393,50745
2022-05-11 17:00:00,2022-05-11 18:00:00,133,0,30,8648,7198,16009,51823
2022-05-11 18:00:00,2022-05-11 19:00:00,133,0,7,8621,7664,16425,51865
2022-05-11 19:00:00,2022-05-11 20:00:00,134,0,8,8481,8179,16802,51007
2022-05-11 20:00:00,2022-05-11 21:00:00,135,0,8,4019,8039,12201,48324
2022-05-11 21:00:00,2022-05-11 22:00:00,134,0,8,2696,7008,9846,45748
2022-05-11 22:00:00,2022-05-11 23:00:00,132,0,8,3111,5877,9128,43206
2022-05-11 23:00:00,2022-05-12 00:00:00,136,0,8,3481,4604,8229,41625
2022-05-12 00:00:00,2022-05-12 01:00:00,129,0,8,3957,3809,7903,40890
2022-05-12 01:00:00,2022-05-12 02:00:00,108,0,8,3343,3600,7059,40316
2022-05-12 02:00:00,2022-05-12 03:00:00,97,0,8,2411,3280,5796,40374
2022-05-12 03:00:00,2022-05-12 04:00:00,92,0,11,1886,2540,4529,41675
2022-05-12 04:00:00,2022-05-12 05:00:00,92,0,84,1926,1836,3938,43826
2022-05-12 05:00:00,2022-05-12 06:00:00,93,0,299,1071,1471,2934,45051
2022-05-12 06:00:00,2022-05-12 07:00:00,95,0,616,855,1235,2801,43385
2022-05-12 07:00:00,2022-05-12 08:00:00,89,0,941,984,1465,3479,40360
2022-05-12 08:00:00,2022-05-12 09:00:00,86,0,1030,1274,1567,3957,37527
2022-05-12 09:00:00,2022-05-12 10:00:00,88,0,1058,1730,1778,4654,35722
2022-05-12 10:00:00,2022-05-12 11:00:00,86,0,1191,2335,2673,6285,34797
2022-05-12 11:00:00,2022-05-12 12:00:00,86,0,1096,2871,3495,7548,34857
2022-05-12 12:00:00,2022-05-12 13:00:00,86,0,1033,4151,4167,9437,35710
2022-05-12 13:00:00,2022-05-12 14:00:00,85,0,889,4410,4202,9586,36922
2022-05-12 14:00:00,2022-05-12 15:00:00,78,0,901,4021,4448,9448,39301
2022-05-12 15:00:00,2022-05-12 16:00:00,77,0,704,4357,4352,9490,43592
2022-05-12 16:00:00,2022-05-12 17:00:00,81,0,457,5613,3950,10101,45914
2022-05-12 17:00:00,2022-05-12 18:00:00,81,0,191,5872,3769,9913,49030
2022-05-12 18:00:00,2022-05-12 19:00:00,83,0,31,5491,3380,8985,51117
2022-05-12 19:00:00,2022-05-12 20:00:00,81,0,8,4852,3276,8217,51214
2022-05-12 20:00:00,2022-05-12 21:00:00,84,0,8,5384,3431,8907,48952
2022-05-12 21:00:00,2022-05-12 22:00:00,84,0,8,5241,3410,8743,46192
2022-05-12 22:00:00,2022-05-12 23:00:00,80,0,8,5328,3768,9184,43366
2022-05-12 23:00:00,2022-05-13 00:00:00,81,0,8,6183,3754,10026,41508
2022-05-13 00:00:00,2022-05-13 01:00:00,84,0,8,6498,3927,10517,40688
2022-05-13 01:00:00,2022-05-13 02:00:00,83,0,8,5414,4376,9881,40096
2022-05-13 02:00:00,2022-05-13 03:00:00,84,0,8,6334,4725,11151,40121
2022-05-13 03:00:00,2022-05-13 04:00:00,82,0,7,6609,5009,11707,41156
2022-05-13 04:00:00,2022-05-13 05:00:00,81,0,24,6382,4874,11361,43767
2022-05-13 05:00:00,2022-05-13 06:00:00,78,0,176,6084,5466,11804,46203
2022-05-13 06:00:00,2022-05-13 07:00:00,78,0,370,5566,5155,11169,46310
2022-05-13 07:00:00,2022-05-13 08:00:00,81,0,588,4930,5081,10680,44165
2022-05-13 08:00:00,2022-05-13 09:00:00,81,0,654,4619,5030,10384,41841
2022-05-13 09:00:00,2022-05-13 10:00:00,81,0,741,5188,4912,10922,39729
2022-05-13 10:00:00,2022-05-13 11:00:00,81,0,826,5223,5129,11259,37852
2022-05-13 11:00:00,2022-05-13 12:00:00,80,0,773,5807,5600,12260,37514
2022-05-13 12:00:00,2022-05-13 13:00:00,80,0,882,6062,5667,12691,36676
2022-05-13 13:00:00,2022-05-13 14:00:00,79,0,770,6107,4922,11878,36175
2022-05-13 14:00:00,2022-05-13 15:00:00,76,0,639,7103,5664,13482,38203
2022-05-13 15:00:00,2022-05-13 16:00:00,73,0,658,7957,6133,14821,42719
2022-05-13 16:00:00,2022-05-13 17:00:00,75,0,371,8820,5957,15223,45199
2022-05-13 17:00:00,2022-05-13 18:00:00,69,0,167,8948,5733,14917,47841
2022-05-13 18:00:00,2022-05-13 19:00:00,66,0,43,8681,4876,13666,49406
2022-05-13 19:00:00,2022-05-13 20:00:00,63,0,3,8267,4492,12825,49468
2022-05-13 20:00:00,2022-05-13 21:00:00,64,0,4,6907,4916,11891,47604
2022-05-13 21:00:00,2022-05-13 22:00:00,64,0,4,5587,4835,10490,45383
2022-05-13 22:00:00,2022-05-13 23:00:00,64,0,4,4614,4315,8997,42275
2022-05-13 23:00:00,2022-05-14 00:00:00,64,0,4,4100,3829,7997,40716
2022-05-14 00:00:00,2022-05-14 01:00:00,64,0,4,3001,2884,5953,39515
2022-05-14 01:00:00,2022-05-14 02:00:00,65,0,4,2594,1958,4621,38716
2022-05-14 02:00:00,2022-05-14 03:00:00,65,0,4,2220,1434,3723,38973
2022-05-14 03:00:00,2022-05-14 04:00:00,67,0,11,2045,1250,3373,38898
2022-05-14 04:00:00,2022-05-14 05:00:00,68,0,91,1691,1128,2978,38326
2022-05-14 05:00:00,2022-05-14 06:00:00,65,0,276,962,848,2151,37057
2022-05-14 06:00:00,2022-05-14 07:00:00,62,0,577,581,679,1899,35924
2022-05-14 07:00:00,2022-05-14 08:00:00,64,0,925,350,519,1858,34118
2022-05-14 08:00:00,2022-05-14 09:00:00,66,0,1017,352,467,1902,31283
2022-05-14 09:00:00,2022-05-14 10:00:00,65,0,951,247,484,1747,30049
2022-05-14 10:00:00,2022-05-14 11:00:00,64,0,881,145,509,1599,29000
2022-05-14 11:00:00,2022-05-14 12:00:00,64,0,771,120,545,1500,27706
2022-05-14 12:00:00,2022-05-14 13:00:00,64,0,924,98,540,1626,27616
2022-05-14 13:00:00,2022-05-14 14:00:00,62,0,709,104,561,1436,28789
2022-05-14 14:00:00,2022-05-14 15:00:00,64,0,672,113,615,1464,31619
2022-05-14 15:00:00,2022-05-14 16:00:00,64,0,574,105,659,1402,36711
2022-05-14 16:00:00,2022-05-14 17:00:00,64,0,380,109,667,1220,40561
2022-05-14 17:00:00,2022-05-14 18:00:00,64,0,185,148,636,1033,43757
2022-05-14 18:00:00,2022-05-14 19:00:00,64,0,37,441,632,1174,46286
2022-05-14 19:00:00,2022-05-14 20:00:00,64,0,3,646,763,1476,47060
2022-05-14 20:00:00,2022-05-14 21:00:00,64,0,4,800,857,1725,45857
2022-05-14 21:00:00,2022-05-14 22:00:00,64,0,4,1165,1127,2360,43894
2022-05-14 22:00:00,2022-05-14 23:00:00,64,0,4,1306,1493,2867,41870
2022-05-14 23:00:00,2022-05-15 00:00:00,63,0,4,1733,1711,3511,40093
2022-05-15 00:00:00,2022-05-15 01:00:00,62,0,4,1583,1879,3528,38782
2022-05-15 01:00:00,2022-05-15 02:00:00,64,0,4,1384,1812,3264,38270
2022-05-15 02:00:00,2022-05-15 03:00:00,65,0,4,1407,1734,3210,38122
2022-05-15 03:00:00,2022-05-15 04:00:00,65,0,11,1157,1495,2728,37268
2022-05-15 04:00:00,2022-05-15 05:00:00,64,0,92,1131,1426,2713,35221
2022-05-15 05:00:00,2022-05-15 06:00:00,64,0,304,1250,1173,2791,33210
2022-05-15 06:00:00,2022-05-15 07:00:00,64,0,626,1295,857,2842,31953
2022-05-15 07:00:00,2022-05-15 08:00:00,64,0,933,1118,822,2937,30115
2022-05-15 08:00:00,2022-05-15 09:00:00,64,0,1162,959,1001,3186,27687
2022-05-15 09:00:00,2022-05-15 10:00:00,64,0,1257,872,1288,3481,25620
2022-05-15 10:00:00,2022-05-15 11:00:00,64,0,1321,1434,1365,4184,24542
2022-05-15 11:00:00,2022-05-15 12:00:00,64,0,1284,2097,1270,4715,23866
2022-05-15 12:00:00,2022-05-15 13:00:00,64,0,1298,2532,1197,5091,24220
2022-05-15 13:00:00,2022-05-15 14:00:00,64,0,1172,3460,1373,6069,26501
2022-05-15 14:00:00,2022-05-15 15:00:00,64,0,977,4607,1593,7241,30747
2022-05-15 15:00:00,2022-05-15 16:00:00,64,0,814,5351,2120,8349,36728
2022-05-15 16:00:00,2022-05-15 17:00:00,65,0,498,5698,2912,9173,40700
2022-05-15 17:00:00,2022-05-15 18:00:00,65,0,193,6253,3273,9784,44190
2022-05-15 18:00:00,2022-05-15 19:00:00,66,0,37,6855,3741,10699,46878
2022-05-15 19:00:00,2022-05-15 20:00:00,65,0,3,7541,4727,12336,47507
2022-05-15 20:00:00,2022-05-15 21:00:00,65,0,4,7672,5680,13421,46293
2022-05-15 21:00:00,2022-05-15 22:00:00,65,0,4,7340,5745,13154,43659
2022-05-15 22:00:00,2022-05-15 23:00:00,64,0,4,6817,5468,12353,41879
2022-05-15 23:00:00,2022-05-16 00:00:00,64,0,4,6411,4960,11439,40320
2022-05-16 00:00:00,2022-05-16 01:00:00,64,0,4,4794,4274,9136,39513
2022-05-16 01:00:00,2022-05-16 02:00:00,65,0,4,3873,3982,7924,39488
2022-05-16 02:00:00,2022-05-16 03:00:00,64,0,4,3503,3907,7478,39838
2022-05-16 03:00:00,2022-05-16 04:00:00,64,0,15,2821,3437,6337,40693
2022-05-16 04:00:00,2022-05-16 05:00:00,64,0,80,2740,3503,6387,42531
2022-05-16 05:00:00,2022-05-16 06:00:00,64,0,249,2577,3201,6091,45768
2022-05-16 06:00:00,2022-05-16 07:00:00,65,0,501,2143,2428,5137,46877
2022-05-16 07:00:00,2022-05-16 08:00:00,65,0,859,3254,1796,5974,46039
2022-05-16 08:00:00,2022-05-16 09:00:00,64,0,947,4719,2244,7974,42575
2022-05-16 09:00:00,2022-05-16 10:00:00,64,0,1023,5860,2286,9233,42049
2022-05-16 10:00:00,2022-05-16 11:00:00,67,0,953,5620,2671,9311,44511
2022-05-16 11:00:00,2022-05-16 12:00:00,66,0,584,6146,3382,10178,46031
2022-05-16 12:00:00,2022-05-16 13:00:00,64,0,557,6804,4675,12100,44824
2022-05-16 13:00:00,2022-05-16 14:00:00,64,0,491,6821,5489,12865,45807
2022-05-16 14:00:00,2022-05-16 15:00:00,64,0,599,6194,5003,11860,48254
2022-05-16 15:00:00,2022-05-16 16:00:00,64,0,367,4974,5358,10763,50241
2022-05-16 16:00:00,2022-05-16 17:00:00,64,0,143,4523,4922,9652,48721
2022-05-16 17:00:00,2022-05-16 18:00:00,64,0,39,4045,4569,8717,49506
2022-05-16 18:00:00,2022-05-16 19:00:00,64,0,9,4887,3512,8472,50797
2022-05-16 19:00:00,2022-05-16 20:00:00,64,0,4,4068,3050,7186,50822
2022-05-16 20:00:00,2022-05-16 21:00:00,66,0,4,3543,3068,6681,48473
2022-05-16 21:00:00,2022-05-16 22:00:00,64,0,4,2889,2683,5640,45654
2022-05-16 22:00:00,2022-05-16 23:00:00,73,0,4,2437,2380,4894,43513
2022-05-16 23:00:00,2022-05-17 00:00:00,78,0,4,1718,2219,4019,41933
2022-05-17 00:00:00,2022-05-17 01:00:00,63,0,4,1168,2038,3273,41009
2022-05-17 01:00:00,2022-05-17 02:00:00,68,0,4,1039,2033,3144,40605
2022-05-17 02:00:00,2022-05-17 03:00:00,65,0,4,1204,2075,3348,40858
2022-05-17 03:00:00,2022-05-17 04:00:00,65,0,12,832,1822,2731,41887
2022-05-17 04:00:00,2022-05-17 05:00:00,64,0,138,545,1247,1994,44465
2022-05-17 05:00:00,2022-05-17 06:00:00,64,0,274,345,1079,1762,48356
2022-05-17 06:00:00,2022-05-17 07:00:00,64,0,472,194,752,1482,49661
2022-05-17 07:00:00,2022-05-17 08:00:00,64,0,761,120,523,1468,48959
2022-05-17 08:00:00,2022-05-17 09:00:00,64,0,963,98,579,1704,46174
2022-05-17 09:00:00,2022-05-17 10:00:00,64,0,1116,162,619,1961,42413
2022-05-17 10:00:00,2022-05-17 11:00:00,64,0,1069,264,555,1952,38896
2022-05-17 11:00:00,2022-05-17 12:00:00,66,0,1160,222,502,1950,36427
2022-05-17 12:00:00,2022-05-17 13:00:00,68,0,1043,130,493,1734,36297
2022-05-17 13:00:00,2022-05-17 14:00:00,68,0,1095,121,485,1769,39040
2022-05-17 14:00:00,2022-05-17 15:00:00,69,0,953,144,523,1689,42894
2022-05-17 15:00:00,2022-05-17 16:00:00,69,0,733,195,662,1659,47195
2022-05-17 16:00:00,2022-05-17 17:00:00,67,0,370,197,797,1431,49045
2022-05-17 17:00:00,2022-05-17 18:00:00,65,0,126,286,974,1451,51026
2022-05-17 18:00:00,2022-05-17 19:00:00,64,0,36,339,1491,1930,51772
2022-05-17 19:00:00,2022-05-17 20:00:00,65,0,4,491,1505,2065,52199
2022-05-17 20:00:00,2022-05-17 21:00:00,64,0,4,1153,1800,3021,50545
2022-05-17 21:00:00,2022-05-17 22:00:00,64,0,4,1912,1779,3759,47779
2022-05-17 22:00:00,2022-05-17 23:00:00,65,0,4,2783,1817,4669,45106
2022-05-17 23:00:00,2022-05-18 00:00:00,66,0,4,3568,1935,5573,43236
2022-05-18 00:00:00,2022-05-18 01:00:00,64,0,4,3698,2087,5853,42496
2022-05-18 01:00:00,2022-05-18 02:00:00,64,0,4,2966,1871,4905,42097
2022-05-18 02:00:00,2022-05-18 03:00:00,66,0,4,3790,1858,5718,41966
2022-05-18 03:00:00,2022-05-18 04:00:00,64,0,15,2760,1876,4715,42555
2022-05-18 04:00:00,2022-05-18 05:00:00,64,0,102,2761,1826,4753,44280
2022-05-18 05:00:00,2022-05-18 06:00:00,64,0,313,2448,1534,4359,47105
2022-05-18 06:00:00,2022-05-18 07:00:00,64,0,640,1467,1280,3451,46528
2022-05-18 07:00:00,2022-05-18 08:00:00,62,0,902,1067,1112,3143,43689
2022-05-18 08:00:00,2022-05-18 09:00:00,70,0,1093,558,807,2528,40091
2022-05-18 09:00:00,2022-05-18 10:00:00,79,0,1273,262,619,2233,37783
2022-05-18 10:00:00,2022-05-18 11:00:00,80,0,1281,259,696,2316,36653
2022-05-18 11:00:00,2022-05-18 12:00:00,80,0,1213,291,810,2394,36958
2022-05-18 12:00:00,2022-05-18 13:00:00,80,0,873,301,566,1820,38531
2022-05-18 13:00:00,2022-05-18 14:00:00,79,0,857,168,599,1703,40007
2022-05-18 14:00:00,2022-05-18 15:00:00,74,0,777,107,647,1605,42643
2022-05-18 15:00:00,2022-05-18 16:00:00,81,0,566,185,637,1469,46793
2022-05-18 16:00:00,2022-05-18 17:00:00,83,0,401,216,480,1180,48637
2022-05-18 17:00:00,2022-05-18 18:00:00,84,0,201,515,414,1214,51212
2022-05-18 18:00:00,2022-05-18 19:00:00,84,0,56,760,455,1355,52946
2022-05-18 19:00:00,2022-05-18 20:00:00,84,0,3,947,621,1655,53657
2022-05-18 20:00:00,2022-05-18 21:00:00,80,0,4,1494,966,2544,51745
2022-05-18 21:00:00,2022-05-18 22:00:00,80,0,4,2433,1282,3799,48775
2022-05-18 22:00:00,2022-05-18 23:00:00,79,0,4,3183,1630,4896,45560
2022-05-18 23:00:00,2022-05-19 00:00:00,80,0,4,2947,1976,5007,43558
2022-05-19 00:00:00,2022-05-19 01:00:00,80,0,4,3108,2256,5448,42309
2022-05-19 01:00:00,2022-05-19 02:00:00,80,0,4,3502,2832,6418,41803
2022-05-19 02:00:00,2022-05-19 03:00:00,81,0,4,2570,3116,5771,41779
2022-05-19 03:00:00,2022-05-19 04:00:00,80,0,9,1213,3774,5076,42864
2022-05-19 04:00:00,2022-05-19 05:00:00,80,0,97,1792,3877,5846,46258
2022-05-19 05:00:00,2022-05-19 06:00:00,79,0,249,1637,1828,3793,49611
2022-05-19 06:00:00,2022-05-19 07:00:00,76,0,499,955,825,2355,50518
2022-05-19 07:00:00,2022-05-19 08:00:00,81,0,386,506,512,1485,49114
2022-05-19 08:00:00,2022-05-19 09:00:00,83,0,507,666,503,1759,44436
2022-05-19 09:00:00,2022-05-19 10:00:00,82,0,872,1668,1135,3757,42321
2022-05-19 10:00:00,2022-05-19 11:00:00,82,0,1027,1111,2105,4325,46738
2022-05-19 11:00:00,2022-05-19 12:00:00,81,0,950,1278,1779,4088,54585
2022-05-19 12:00:00,2022-05-19 13:00:00,73,0,367,2881,2021,5342,55304
2022-05-19 13:00:00,2022-05-19 14:00:00,64,0,135,2223,1488,3910,48976
2022-05-19 14:00:00,2022-05-19 15:00:00,63,0,203,800,1623,2689,46794
2022-05-19 15:00:00,2022-05-19 16:00:00,64,0,612,887,2574,4137,47800
2022-05-19 16:00:00,2022-05-19 17:00:00,64,0,498,855,3328,4745,48463
2022-05-19 17:00:00,2022-05-19 18:00:00,64,0,240,652,2991,3947,50122
2022-05-19 18:00:00,2022-05-19 19:00:00,64,0,46,649,2104,2863,51631
2022-05-19 19:00:00,2022-05-19 20:00:00,64,0,5,1207,1469,2745,52159
2022-05-19 20:00:00,2022-05-19 21:00:00,64,0,4,1331,1713,3112,50609
2022-05-19 21:00:00,2022-05-19 22:00:00,63,0,4,1208,1420,2695,47931
2022-05-19 22:00:00,2022-05-19 23:00:00,64,0,4,1108,1205,2381,45204
2022-05-19 23:00:00,2022-05-20 00:00:00,64,0,4,599,1101,1768,43435
2022-05-20 00:00:00,2022-05-20 01:00:00,64,0,4,381,752,1201,42722
2022-05-20 01:00:00,2022-05-20 02:00:00,64,0,4,304,423,795,42226
2022-05-20 02:00:00,2022-05-20 03:00:00,64,0,4,260,443,771,42297
2022-05-20 03:00:00,2022-05-20 04:00:00,64,0,17,356,534,971,42486
2022-05-20 04:00:00,2022-05-20 05:00:00,64,0,101,290,550,1005,43814
2022-05-20 05:00:00,2022-05-20 06:00:00,63,0,295,649,572,1579,45009
2022-05-20 06:00:00,2022-05-20 07:00:00,64,0,573,499,697,1833,44328
2022-05-20 07:00:00,2022-05-20 08:00:00,64,0,747,371,724,1906,42428
2022-05-20 08:00:00,2022-05-20 09:00:00,64,0,1022,323,739,2148,41394
2022-05-20 09:00:00,2022-05-20 10:00:00,72,0,1038,234,866,2210,41808
2022-05-20 10:00:00,2022-05-20 11:00:00,78,0,989,249,882,2198,42637
2022-05-20 11:00:00,2022-05-20 12:00:00,80,0,1060,975,1190,3305,49529
2022-05-20 12:00:00,2022-05-20 13:00:00,80,0,627,2427,1526,4660,54568
2022-05-20 13:00:00,2022-05-20 14:00:00,79,0,170,1448,2267,3964,55037
2022-05-20 14:00:00,2022-05-20 15:00:00,79,0,94,2805,2408,5386,54429
2022-05-20 15:00:00,2022-05-20 16:00:00,79,0,54,1060,3352,4545,54091
2022-05-20 16:00:00,2022-05-20 17:00:00,80,0,76,1906,2206,4268,52340
2022-05-20 17:00:00,2022-05-20 18:00:00,80,0,71,2181,5306,7638,51303
2022-05-20 18:00:00,2022-05-20 19:00:00,80,0,36,4285,4739,9140,50539
2022-05-20 19:00:00,2022-05-20 20:00:00,80,0,4,6218,4607,10909,49429
2022-05-20 20:00:00,2022-05-20 21:00:00,81,0,4,7322,5304,12711,47802
2022-05-20 21:00:00,2022-05-20 22:00:00,76,0,4,7963,5247,13290,45673
2022-05-20 22:00:00,2022-05-20 23:00:00,78,0,4,8128,5766,13976,43002
2022-05-20 23:00:00,2022-05-21 00:00:00,80,0,4,8707,6121,14912,41313
2022-05-21 00:00:00,2022-05-21 01:00:00,80,0,4,8685,6425,15194,40327
2022-05-21 01:00:00,2022-05-21 02:00:00,80,0,4,8139,6800,15023,39445
2022-05-21 02:00:00,2022-05-21 03:00:00,80,0,4,7841,6748,14673,39123
2022-05-21 03:00:00,2022-05-21 04:00:00,80,0,9,6948,6314,13351,38817
2022-05-21 04:00:00,2022-05-21 05:00:00,80,0,71,6227,5832,12210,38254
2022-05-21 05:00:00,2022-05-21 06:00:00,77,0,273,5226,4948,10524,37253
2022-05-21 06:00:00,2022-05-21 07:00:00,74,0,492,4419,4750,9735,37203
2022-05-21 07:00:00,2022-05-21 08:00:00,79,0,814,3771,4906,9570,36394
2022-05-21 08:00:00,2022-05-21 09:00:00,79,0,968,3082,4445,8574,34539
2022-05-21 09:00:00,2022-05-21 10:00:00,79,0,870,2553,3715,7217,34110
2022-05-21 10:00:00,2022-05-21 11:00:00,79,0,950,2325,3141,6495,33176
2022-05-21 11:00:00,2022-05-21 12:00:00,77,0,980,1856,2748,5661,31097
2022-05-21 12:00:00,2022-05-21 13:00:00,78,0,893,1698,2750,5419,31399
2022-05-21 13:00:00,2022-05-21 14:00:00,80,0,793,1350,2790,5013,33435
2022-05-21 14:00:00,2022-05-21 15:00:00,77,0,620,1218,2123,4038,35418
2022-05-21 15:00:00,2022-05-21 16:00:00,76,0,625,853,1727,3281,39181
2022-05-21 16:00:00,2022-05-21 17:00:00,79,0,374,722,1356,2531,41017
2022-05-21 17:00:00,2022-05-21 18:00:00,80,0,178,740,1050,2048,42886
2022-05-21 18:00:00,2022-05-21 19:00:00,80,0,51,441,667,1239,45117
2022-05-21 19:00:00,2022-05-21 20:00:00,80,0,8,283,642,1013,46477
2022-05-21 20:00:00,2022-05-21 21:00:00,77,0,8,199,527,811,45906
2022-05-21 21:00:00,2022-05-21 22:00:00,72,0,8,157,449,686,44042
2022-05-21 22:00:00,2022-05-21 23:00:00,77,0,8,328,417,830,41840
2022-05-21 23:00:00,2022-05-22 00:00:00,80,0,8,344,436,868,39657
2022-05-22 00:00:00,2022-05-22 01:00:00,80,0,8,284,435,807,38410
2022-05-22 01:00:00,2022-05-22 02:00:00,80,0,8,348,446,882,37914
2022-05-22 02:00:00,2022-05-22 03:00:00,80,0,8,355,436,879,37677
2022-05-22 03:00:00,2022-05-22 04:00:00,80,0,23,221,430,754,36466
2022-05-22 04:00:00,2022-05-22 05:00:00,80,0,117,206,436,839,34285
2022-05-22 05:00:00,2022-05-22 06:00:00,79,0,358,297,434,1168,32179
2022-05-22 06:00:00,2022-05-22 07:00:00,72,0,700,334,469,1575,30604
2022-05-22 07:00:00,2022-05-22 08:00:00,75,0,983,311,498,1867,28759
2022-05-22 08:00:00,2022-05-22 09:00:00,78,0,1033,273,478,1862,26716
2022-05-22 09:00:00,2022-05-22 10:00:00,77,0,1062,387,444,1970,25518
2022-05-22 10:00:00,2022-05-22 11:00:00,77,0,1098,362,424,1961,24480
2022-05-22 11:00:00,2022-05-22 12:00:00,76,0,953,121,446,1596,23607
2022-05-22 12:00:00,2022-05-22 13:00:00,76,0,896,98,476,1546,23953
2022-05-22 13:00:00,2022-05-22 14:00:00,77,0,883,137,458,1555,25572
2022-05-22 14:00:00,2022-05-22 15:00:00,78,0,840,152,509,1579,29435
2022-05-22 15:00:00,2022-05-22 16:00:00,78,0,736,221,604,1639,35476
2022-05-22 16:00:00,2022-05-22 17:00:00,80,0,527,451,671,1729,39492
2022-05-22 17:00:00,2022-05-22 18:00:00,80,0,225,532,594,1431,43100
2022-05-22 18:00:00,2022-05-22 19:00:00,80,0,66,704,821,1671,45468
2022-05-22 19:00:00,2022-05-22 20:00:00,80,0,7,1031,1613,2731,45902
2022-05-22 20:00:00,2022-05-22 21:00:00,79,0,8,1845,2532,4464,44884
2022-05-22 21:00:00,2022-05-22 22:00:00,76,0,8,2212,2836,5132,42763
2022-05-22 22:00:00,2022-05-22 23:00:00,79,0,8,2534,3199,5820,41751
2022-05-22 23:00:00,2022-05-23 00:00:00,82,0,8,2639,3014,5743,40450
2022-05-23 00:00:00,2022-05-23 01:00:00,80,0,8,2533,2643,5264,39718
2022-05-23 01:00:00,2022-05-23 02:00:00,80,0,8,2455,2145,4688,39684
2022-05-23 02:00:00,2022-05-23 03:00:00,80,0,8,2244,1777,4109,39844
2022-05-23 03:00:00,2022-05-23 04:00:00,80,0,18,2055,1570,3723,40596
2022-05-23 04:00:00,2022-05-23 05:00:00,81,0,108,1731,1278,3198,42569
2022-05-23 05:00:00,2022-05-23 06:00:00,75,0,287,1467,1047,2876,45777
2022-05-23 06:00:00,2022-05-23 07:00:00,76,0,543,1182,831,2632,47144
2022-05-23 07:00:00,2022-05-23 08:00:00,79,0,781,931,590,2381,46486
2022-05-23 08:00:00,2022-05-23 09:00:00,80,0,980,1176,516,2752,44645
2022-05-23 09:00:00,2022-05-23 10:00:00,80,0,1099,1141,573,2893,43885
2022-05-23 10:00:00,2022-05-23 11:00:00,80,0,1027,967,693,2767,42429
2022-05-23 11:00:00,2022-05-23 12:00:00,80,0,1053,880,881,2894,44964
2022-05-23 12:00:00,2022-05-23 13:00:00,80,0,733,1167,1192,3172,49565
2022-05-23 13:00:00,2022-05-23 14:00:00,79,0,364,1321,1174,2938,52488
2022-05-23 14:00:00,2022-05-23 15:00:00,72,0,379,1717,1891,4059,54234
2022-05-23 15:00:00,2022-05-23 16:00:00,76,0,177,1450,2347,4050,56677
2022-05-23 16:00:00,2022-05-23 17:00:00,80,0,121,868,2921,3990,55627
2022-05-23 17:00:00,2022-05-23 18:00:00,77,0,30,939,4386,5432,54551
2022-05-23 18:00:00,2022-05-23 19:00:00,76,0,11,2129,3643,5859,53142
2022-05-23 19:00:00,2022-05-23 20:00:00,76,0,4,2765,2237,5082,51793
2022-05-23 20:00:00,2022-05-23 21:00:00,78,0,4,2256,2990,5328,49393
2022-05-23 21:00:00,2022-05-23 22:00:00,76,0,4,1965,3723,5768,46517
2022-05-23 22:00:00,2022-05-23 23:00:00,75,0,4,4623,3817,8519,43471
2022-05-23 23:00:00,2022-05-24 00:00:00,74,0,4,6803,3504,10385,42370
2022-05-24 00:00:00,2022-05-24 01:00:00,78,0,4,6344,3398,9824,41473
2022-05-24 01:00:00,2022-05-24 02:00:00,80,0,4,6369,4393,10846,41115
2022-05-24 02:00:00,2022-05-24 03:00:00,80,0,4,5159,4883,10126,41105
2022-05-24 03:00:00,2022-05-24 04:00:00,79,0,9,4398,3912,8398,41704
2022-05-24 04:00:00,2022-05-24 05:00:00,79,0,79,2965,4543,7666,44244
2022-05-24 05:00:00,2022-05-24 06:00:00,78,0,147,3402,5098,8725,48175
2022-05-24 06:00:00,2022-05-24 07:00:00,77,0,261,4409,5663,10410,48795
2022-05-24 07:00:00,2022-05-24 08:00:00,76,0,265,5744,5707,11792,47482
2022-05-24 08:00:00,2022-05-24 09:00:00,79,0,620,5602,5815,12116,46004
2022-05-24 09:00:00,2022-05-24 10:00:00,78,0,556,4658,6362,11654,44240
2022-05-24 10:00:00,2022-05-24 11:00:00,80,0,702,3848,5848,10478,41253
2022-05-24 11:00:00,2022-05-24 12:00:00,80,0,673,4092,5415,10260,39605
2022-05-24 12:00:00,2022-05-24 13:00:00,79,0,918,3890,5465,10352,38732
2022-05-24 13:00:00,2022-05-24 14:00:00,74,0,823,3803,4930,9630,39789
2022-05-24 14:00:00,2022-05-24 15:00:00,74,0,824,4083,3897,8878,42043
2022-05-24 15:00:00,2022-05-24 16:00:00,79,0,752,4246,3580,8657,46026
2022-05-24 16:00:00,2022-05-24 17:00:00,77,0,478,3604,3162,7321,46763
2022-05-24 17:00:00,2022-05-24 18:00:00,80,0,203,3115,2166,5564,47969
2022-05-24 18:00:00,2022-05-24 19:00:00,80,0,88,2635,1615,4418,49795
2022-05-24 19:00:00,2022-05-24 20:00:00,80,0,6,2690,1487,4263,50727
2022-05-24 20:00:00,2022-05-24 21:00:00,80,0,4,2623,1334,4041,49153
2022-05-24 21:00:00,2022-05-24 22:00:00,77,0,4,2223,1715,4019,46120
2022-05-24 22:00:00,2022-05-24 23:00:00,75,0,4,2031,1968,4078,43521
2022-05-24 23:00:00,2022-05-25 00:00:00,78,0,4,2138,2272,4492,41954
2022-05-25 00:00:00,2022-05-25 01:00:00,80,0,4,1834,2307,4225,41018
2022-05-25 01:00:00,2022-05-25 02:00:00,81,0,4,2025,2255,4365,40566
2022-05-25 02:00:00,2022-05-25 03:00:00,80,0,4,1898,2549,4531,40425
2022-05-25 03:00:00,2022-05-25 04:00:00,80,0,18,1583,2353,4034,41034
2022-05-25 04:00:00,2022-05-25 05:00:00,79,0,105,1929,2203,4316,42793
2022-05-25 05:00:00,2022-05-25 06:00:00,75,0,332,2986,2097,5490,44204
2022-05-25 06:00:00,2022-05-25 07:00:00,78,0,643,4658,2373,7752,44080
2022-05-25 07:00:00,2022-05-25 08:00:00,80,0,915,6298,2943,10236,41600
2022-05-25 08:00:00,2022-05-25 09:00:00,64,0,1004,7022,3613,11703,38755
2022-05-25 09:00:00,2022-05-25 10:00:00,63,0,893,8122,5402,14480,37532
2022-05-25 10:00:00,2022-05-25 11:00:00,62,0,727,8612,6503,15904,37488
2022-05-25 11:00:00,2022-05-25 12:00:00,64,0,705,8965,7003,16737,38096
2022-05-25 12:00:00,2022-05-25 13:00:00,64,0,751,9281,6955,17051,40625
2022-05-25 13:00:00,2022-05-25 14:00:00,64,0,743,9178,7054,17039,42449
2022-05-25 14:00:00,2022-05-25 15:00:00,65,0,558,9296,7755,17674,46864
2022-05-25 15:00:00,2022-05-25 16:00:00,65,0,329,9310,7988,17692,51719
2022-05-25 16:00:00,2022-05-25 17:00:00,64,0,179,9278,7841,17362,51812
2022-05-25 17:00:00,2022-05-25 18:00:00,62,0,80,9276,7550,16968,51260
2022-05-25 18:00:00,2022-05-25 19:00:00,64,0,17,9300,7317,16698,50385
2022-05-25 19:00:00,2022-05-25 20:00:00,64,0,4,9309,7139,16516,49219
2022-05-25 20:00:00,2022-05-25 21:00:00,64,0,4,9161,6696,15925,47600
2022-05-25 21:00:00,2022-05-25 22:00:00,64,0,4,8676,6493,15237,45838
2022-05-25 22:00:00,2022-05-25 23:00:00,64,0,4,7774,6411,14253,43051
2022-05-25 23:00:00,2022-05-26 00:00:00,62,0,4,6172,5977,12215,40771
2022-05-26 00:00:00,2022-05-26 01:00:00,65,0,4,5731,5067,10867,39732
2022-05-26 01:00:00,2022-05-26 02:00:00,66,0,4,5681,4611,10362,39446
2022-05-26 02:00:00,2022-05-26 03:00:00,65,0,4,5037,4120,9226,39128
2022-05-26 03:00:00,2022-05-26 04:00:00,65,0,17,4260,3248,7590,38388
2022-05-26 04:00:00,2022-05-26 05:00:00,65,0,114,3726,2611,6516,37384
2022-05-26 05:00:00,2022-05-26 06:00:00,64,0,333,3364,2669,6430,36309
2022-05-26 06:00:00,2022-05-26 07:00:00,67,0,564,3086,2807,6524,35715
2022-05-26 07:00:00,2022-05-26 08:00:00,69,0,733,3279,2486,6567,34508
2022-05-26 08:00:00,2022-05-26 09:00:00,64,0,1003,3256,2760,7083,32824
2022-05-26 09:00:00,2022-05-26 10:00:00,65,0,931,3257,3869,8122,31945
2022-05-26 10:00:00,2022-05-26 11:00:00,67,0,646,2253,3703,6669,31360
2022-05-26 11:00:00,2022-05-26 12:00:00,67,0,476,2410,4001,6954,30808
2022-05-26 12:00:00,2022-05-26 13:00:00,68,0,574,2665,4246,7553,30645
2022-05-26 13:00:00,2022-05-26 14:00:00,66,0,525,4164,5324,10079,33180
2022-05-26 14:00:00,2022-05-26 15:00:00,64,0,461,7245,6611,14381,36691
2022-05-26 15:00:00,2022-05-26 16:00:00,67,0,255,8131,6984,15437,41914
2022-05-26 16:00:00,2022-05-26 17:00:00,68,0,198,8983,7252,16501,44867
2022-05-26 17:00:00,2022-05-26 18:00:00,66,0,66,9222,7314,16668,46571
2022-05-26 18:00:00,2022-05-26 19:00:00,65,0,11,9231,7296,16603,46510
2022-05-26 19:00:00,2022-05-26 20:00:00,64,0,4,9212,7383,16663,46416
2022-05-26 20:00:00,2022-05-26 21:00:00,64,0,4,9186,7460,16714,45541
2022-05-26 21:00:00,2022-05-26 22:00:00,64,0,4,9063,7121,16252,43619
2022-05-26 22:00:00,2022-05-26 23:00:00,64,0,4,8451,6588,15107,41412
2022-05-26 23:00:00,2022-05-27 00:00:00,64,0,4,7769,5820,13657,40091
2022-05-27 00:00:00,2022-05-27 01:00:00,64,0,4,7192,5631,12891,39193
2022-05-27 01:00:00,2022-05-27 02:00:00,64,0,4,6860,4863,11791,38647
2022-05-27 02:00:00,2022-05-27 03:00:00,64,0,4,6729,4003,10800,38548
2022-05-27 03:00:00,2022-05-27 04:00:00,64,0,42,5704,3789,9599,39001
2022-05-27 04:00:00,2022-05-27 05:00:00,62,0,116,5313,4250,9741,39951
2022-05-27 05:00:00,2022-05-27 06:00:00,64,0,250,4729,5117,10160,40390
2022-05-27 06:00:00,2022-05-27 07:00:00,63,0,576,4532,5880,11051,40486
2022-05-27 07:00:00,2022-05-27 08:00:00,64,0,783,5493,6060,12400,38713
2022-05-27 08:00:00,2022-05-27 09:00:00,63,0,833,5589,5697,12182,35360
2022-05-27 09:00:00,2022-05-27 10:00:00,64,0,768,4061,4508,9401,33047
2022-05-27 10:00:00,2022-05-27 11:00:00,64,0,815,3150,4316,8345,31414
2022-05-27 11:00:00,2022-05-27 12:00:00,65,0,815,3057,4670,8607,31528
2022-05-27 12:00:00,2022-05-27 13:00:00,64,0,725,2909,4931,8629,31860
2022-05-27 13:00:00,2022-05-27 14:00:00,63,0,712,3010,5135,8920,32581
2022-05-27 14:00:00,2022-05-27 15:00:00,65,0,684,3066,6168,9983,35924
2022-05-27 15:00:00,2022-05-27 16:00:00,66,0,508,3042,6002,9618,40711
2022-05-27 16:00:00,2022-05-27 17:00:00,65,0,328,2894,5675,8962,42896
2022-05-27 17:00:00,2022-05-27 18:00:00,68,0,218,2849,5390,8525,45097
2022-05-27 18:00:00,2022-05-27 19:00:00,66,0,69,2751,4776,7662,46662
2022-05-27 19:00:00,2022-05-27 20:00:00,66,0,7,2827,4550,7450,47163
2022-05-27 20:00:00,2022-05-27 21:00:00,67,0,4,2794,4287,7152,46390
2022-05-27 21:00:00,2022-05-27 22:00:00,64,0,4,2909,4650,7627,44346
2022-05-27 22:00:00,2022-05-27 23:00:00,64,0,4,3207,4816,8091,41562
2022-05-27 23:00:00,2022-05-28 00:00:00,66,0,4,4855,5219,10144,40150
2022-05-28 00:00:00,2022-05-28 01:00:00,68,0,4,5450,5805,11327,39766
2022-05-28 01:00:00,2022-05-28 02:00:00,68,0,4,5842,6048,11962,39401
2022-05-28 02:00:00,2022-05-28 03:00:00,68,0,4,5919,5739,11730,38876
2022-05-28 03:00:00,2022-05-28 04:00:00,68,0,29,4940,5491,10528,37481
2022-05-28 04:00:00,2022-05-28 05:00:00,68,0,100,4766,5095,10029,36978
2022-05-28 05:00:00,2022-05-28 06:00:00,65,0,324,5178,5015,10582,36005
2022-05-28 06:00:00,2022-05-28 07:00:00,64,0,420,4816,4780,10080,35498
2022-05-28 07:00:00,2022-05-28 08:00:00,64,0,473,3252,3342,7131,34791
2022-05-28 08:00:00,2022-05-28 09:00:00,64,0,630,3229,3200,7123,32676
2022-05-28 09:00:00,2022-05-28 10:00:00,64,0,730,3126,3223,7143,30658
2022-05-28 10:00:00,2022-05-28 11:00:00,64,0,830,3097,3259,7250,29826
2022-05-28 11:00:00,2022-05-28 12:00:00,64,0,861,3247,3246,7418,28951
2022-05-28 12:00:00,2022-05-28 13:00:00,64,0,695,3180,3417,7356,28711
2022-05-28 13:00:00,2022-05-28 14:00:00,64,0,847,3207,3756,7874,30045
2022-05-28 14:00:00,2022-05-28 15:00:00,65,0,688,3175,3918,7846,33111
2022-05-28 15:00:00,2022-05-28 16:00:00,68,0,555,3929,4442,8994,37693
2022-05-28 16:00:00,2022-05-28 17:00:00,68,0,399,4452,5335,10254,40404
2022-05-28 17:00:00,2022-05-28 18:00:00,68,0,190,4641,4636,9535,42804
2022-05-28 18:00:00,2022-05-28 19:00:00,68,0,60,4778,3792,8698,44437
2022-05-28 19:00:00,2022-05-28 20:00:00,68,0,4,4619,3505,8196,45030
2022-05-28 20:00:00,2022-05-28 21:00:00,68,0,4,4384,3611,8067,44617
2022-05-28 21:00:00,2022-05-28 22:00:00,64,0,4,4492,3382,7942,42657
2022-05-28 22:00:00,2022-05-28 23:00:00,66,0,4,4710,3240,8020,40590
2022-05-28 23:00:00,2022-05-29 00:00:00,68,0,4,4399,2737,7208,38737
2022-05-29 00:00:00,2022-05-29 01:00:00,68,0,4,5216,2569,7857,37766
2022-05-29 01:00:00,2022-05-29 02:00:00,68,0,4,4967,2654,7693,37342
2022-05-29 02:00:00,2022-05-29 03:00:00,67,0,4,5180,2596,7847,37383
2022-05-29 03:00:00,2022-05-29 04:00:00,68,0,12,4671,2867,7618,36670
2022-05-29 04:00:00,2022-05-29 05:00:00,67,0,54,4497,2690,7308,35553
2022-05-29 05:00:00,2022-05-29 06:00:00,66,0,139,3900,2649,6754,35032
2022-05-29 06:00:00,2022-05-29 07:00:00,67,0,220,4799,2957,8043,35239
2022-05-29 07:00:00,2022-05-29 08:00:00,68,0,280,4375,3428,8151,35389
2022-05-29 08:00:00,2022-05-29 09:00:00,68,0,360,4473,3638,8539,35282
2022-05-29 09:00:00,2022-05-29 10:00:00,68,0,527,4755,3600,8950,35370
2022-05-29 10:00:00,2022-05-29 11:00:00,68,0,567,4166,3483,8284,35593
2022-05-29 11:00:00,2022-05-29 12:00:00,68,0,561,3241,3141,7011,35192
2022-05-29 12:00:00,2022-05-29 13:00:00,68,0,524,2932,3090,6614,34531
2022-05-29 13:00:00,2022-05-29 14:00:00,64,0,515,2774,2958,6311,35137
2022-05-29 14:00:00,2022-05-29 15:00:00,65,0,358,2910,3303,6636,37564
2022-05-29 15:00:00,2022-05-29 16:00:00,68,0,232,3262,2911,6473,41598
2022-05-29 16:00:00,2022-05-29 17:00:00,68,0,186,2970,2693,5917,43389
2022-05-29 17:00:00,2022-05-29 18:00:00,68,0,117,2959,2616,5760,44456
2022-05-29 18:00:00,2022-05-29 19:00:00,68,0,49,2779,1798,4694,45061
2022-05-29 19:00:00,2022-05-29 20:00:00,68,0,8,2189,1478,3743,45433
2022-05-29 20:00:00,2022-05-29 21:00:00,69,0,8,2358,1021,3456,44769
2022-05-29 21:00:00,2022-05-29 22:00:00,66,0,8,1235,1144,2453,42579
2022-05-29 22:00:00,2022-05-29 23:00:00,66,0,8,1166,732,1972,41045
2022-05-29 23:00:00,2022-05-30 00:00:00,68,0,8,457,578,1111,39947
2022-05-30 00:00:00,2022-05-30 01:00:00,68,0,8,353,387,816,39380
2022-05-30 01:00:00,2022-05-30 02:00:00,68,0,8,426,456,958,39220
2022-05-30 02:00:00,2022-05-30 03:00:00,68,0,8,340,493,909,39584
2022-05-30 03:00:00,2022-05-30 04:00:00,68,0,17,251,572,908,40370
2022-05-30 04:00:00,2022-05-30 05:00:00,68,0,79,260,478,885,42501
2022-05-30 05:00:00,2022-05-30 06:00:00,68,0,251,112,309,740,44426
2022-05-30 06:00:00,2022-05-30 07:00:00,66,0,493,119,311,989,44283
2022-05-30 07:00:00,2022-05-30 08:00:00,67,0,668,83,263,1081,44326
2022-05-30 08:00:00,2022-05-30 09:00:00,67,0,625,76,307,1075,43712
2022-05-30 09:00:00,2022-05-30 10:00:00,68,0,673,96,460,1297,43091
2022-05-30 10:00:00,2022-05-30 11:00:00,64,0,635,114,371,1184,41692
2022-05-30 11:00:00,2022-05-30 12:00:00,64,0,704,114,318,1200,40687
2022-05-30 12:00:00,2022-05-30 13:00:00,64,0,601,126,296,1087,40230
2022-05-30 13:00:00,2022-05-30 14:00:00,62,0,669,121,278,1130,40933
2022-05-30 14:00:00,2022-05-30 15:00:00,64,0,526,105,232,927,43322
2022-05-30 15:00:00,2022-05-30 16:00:00,64,0,482,102,230,878,47313
2022-05-30 16:00:00,2022-05-30 17:00:00,64,0,425,100,223,812,48019
2022-05-30 17:00:00,2022-05-30 18:00:00,64,0,206,119,212,601,48893
2022-05-30 18:00:00,2022-05-30 19:00:00,64,0,75,116,215,470,49527
2022-05-30 19:00:00,2022-05-30 20:00:00,64,0,7,127,283,481,50043
2022-05-30 20:00:00,2022-05-30 21:00:00,64,0,4,127,553,748,48866
2022-05-30 21:00:00,2022-05-30 22:00:00,64,0,4,122,649,839,46037
2022-05-30 22:00:00,2022-05-30 23:00:00,67,0,4,212,756,1039,43454
2022-05-30 23:00:00,2022-05-31 00:00:00,66,0,4,343,1025,1438,41843
2022-05-31 00:00:00,2022-05-31 01:00:00,68,0,4,487,1189,1748,40863
2022-05-31 01:00:00,2022-05-31 02:00:00,65,0,4,550,1041,1660,40352
2022-05-31 02:00:00,2022-05-31 03:00:00,68,0,4,536,893,1501,40562
2022-05-31 03:00:00,2022-05-31 04:00:00,66,0,12,494,698,1270,41132
2022-05-31 04:00:00,2022-05-31 05:00:00,64,0,84,390,475,1013,43516
2022-05-31 05:00:00,2022-05-31 06:00:00,61,0,202,301,367,931,45945
2022-05-31 06:00:00,2022-05-31 07:00:00,62,0,432,262,268,1024,44893
2022-05-31 07:00:00,2022-05-31 08:00:00,62,0,839,300,247,1448,41557
2022-05-31 08:00:00,2022-05-31 09:00:00,63,0,915,349,262,1589,37697
2022-05-31 09:00:00,2022-05-31 10:00:00,62,0,783,284,276,1405,37432
2022-05-31 10:00:00,2022-05-31 11:00:00,61,0,515,225,291,1092,39148
2022-05-31 11:00:00,2022-05-31 12:00:00,59,0,731,237,348,1375,40788
2022-05-31 12:00:00,2022-05-31 13:00:00,60,0,692,218,772,1742,41394
2022-05-31 13:00:00,2022-05-31 14:00:00,61,0,438,150,570,1219,42513
2022-05-31 14:00:00,2022-05-31 15:00:00,61,0,311,194,913,1479,43760
2022-05-31 15:00:00,2022-05-31 16:00:00,62,0,362,674,652,1750,48033
2022-05-31 16:00:00,2022-05-31 17:00:00,63,0,317,1066,360,1806,49938
2022-05-31 17:00:00,2022-05-31 18:00:00,61,0,114,1359,435,1969,50916
2022-05-31 18:00:00,2022-05-31 19:00:00,61,0,49,1513,340,1963,51036
2022-05-31 19:00:00,2022-05-31 20:00:00,62,0,4,974,619,1659,50477
2022-05-31 20:00:00,2022-05-31 21:00:00,63,0,4,917,669,1653,48621
2022-05-31 21:00:00,2022-05-31 22:00:00,64,0,4,1014,728,1810,45778
2022-05-31 22:00:00,2022-05-31 23:00:00,64,0,4,1578,849,2495,43302
2022-05-31 23:00:00,2022-06-01 00:00:00,65,0,4,1412,1011,2492,41811
2022-06-01 00:00:00,2022-06-01 01:00:00,64,0,4,875,1299,2242,41087
2022-06-01 01:00:00,2022-06-01 02:00:00,64,0,4,1095,1183,2346,40563
2022-06-01 02:00:00,2022-06-01 03:00:00,64,0,4,1200,1154,2422,40721
2022-06-01 03:00:00,2022-06-01 04:00:00,64,0,18,924,898,1904,41044
2022-06-01 04:00:00,2022-06-01 05:00:00,64,0,69,836,686,1655,42951
2022-06-01 05:00:00,2022-06-01 06:00:00,64,0,135,912,558,1669,44653
2022-06-01 06:00:00,2022-06-01 07:00:00,62,0,340,865,464,1731,44132
2022-06-01 07:00:00,2022-06-01 08:00:00,64,0,554,580,639,1837,42014
2022-06-01 08:00:00,2022-06-01 09:00:00,64,0,460,743,1018,2285,40267
2022-06-01 09:00:00,2022-06-01 10:00:00,64,0,806,990,1679,3539,39615
2022-06-01 10:00:00,2022-06-01 11:00:00,64,0,787,1217,2206,4274,39772
2022-06-01 11:00:00,2022-06-01 12:00:00,64,0,494,1142,2573,4273,39246
2022-06-01 12:00:00,2022-06-01 13:00:00,64,0,749,950,2486,4249,39165
2022-06-01 13:00:00,2022-06-01 14:00:00,63,0,564,912,2089,3628,40332
2022-06-01 14:00:00,2022-06-01 15:00:00,64,0,830,811,1854,3559,42402
2022-06-01 15:00:00,2022-06-01 16:00:00,64,0,397,715,1877,3053,45285
2022-06-01 16:00:00,2022-06-01 17:00:00,64,0,290,567,1618,2539,45686
2022-06-01 17:00:00,2022-06-01 18:00:00,64,0,185,429,1512,2190,47518
2022-06-01 18:00:00,2022-06-01 19:00:00,64,0,72,567,1175,1878,49214
2022-06-01 19:00:00,2022-06-01 20:00:00,65,0,8,637,957,1667,49869
2022-06-01 20:00:00,2022-06-01 21:00:00,64,0,4,664,679,1411,49088
2022-06-01 21:00:00,2022-06-01 22:00:00,64,0,4,689,592,1349,46672
2022-06-01 22:00:00,2022-06-01 23:00:00,64,0,4,763,498,1329,44015
2022-06-01 23:00:00,2022-06-02 00:00:00,64,0,4,880,498,1446,42446
2022-06-02 00:00:00,2022-06-02 01:00:00,64,0,4,958,406,1432,41629
2022-06-02 01:00:00,2022-06-02 02:00:00,64,0,4,1150,453,1671,41470
2022-06-02 02:00:00,2022-06-02 03:00:00,64,0,4,1199,615,1882,41497
2022-06-02 03:00:00,2022-06-02 04:00:00,64,0,23,1317,735,2139,41756
2022-06-02 04:00:00,2022-06-02 05:00:00,64,0,122,1377,683,2246,43104
2022-06-02 05:00:00,2022-06-02 06:00:00,64,0,371,1288,586,2309,44158
2022-06-02 06:00:00,2022-06-02 07:00:00,64,0,676,895,484,2119,43273
2022-06-02 07:00:00,2022-06-02 08:00:00,64,0,807,790,350,2011,41305
2022-06-02 08:00:00,2022-06-02 09:00:00,64,0,900,763,263,1990,37741
2022-06-02 09:00:00,2022-06-02 10:00:00,64,0,997,524,235,1820,35095
2022-06-02 10:00:00,2022-06-02 11:00:00,64,0,1104,413,230,1811,33368
2022-06-02 11:00:00,2022-06-02 12:00:00,64,0,1124,451,234,1873,33030
2022-06-02 12:00:00,2022-06-02 13:00:00,64,0,1177,684,235,2160,33075
2022-06-02 13:00:00,2022-06-02 14:00:00,64,0,1074,871,320,2329,34186
2022-06-02 14:00:00,2022-06-02 15:00:00,63,0,976,1211,417,2667,37281
2022-06-02 15:00:00,2022-06-02 16:00:00,64,0,801,1324,512,2701,42138
2022-06-02 16:00:00,2022-06-02 17:00:00,64,0,592,1468,642,2766,44713
2022-06-02 17:00:00,2022-06-02 18:00:00,64,0,268,1662,801,2795,47610
2022-06-02 18:00:00,2022-06-02 19:00:00,64,0,82,1798,973,2917,49566
2022-06-02 19:00:00,2022-06-02 20:00:00,64,0,12,2327,1536,3939,49958
2022-06-02 20:00:00,2022-06-02 21:00:00,64,0,8,3102,2300,5474,48963
2022-06-02 21:00:00,2022-06-02 22:00:00,64,0,8,3693,2904,6669,46613
2022-06-02 22:00:00,2022-06-02 23:00:00,64,0,8,3731,3010,6813,43961
2022-06-02 23:00:00,2022-06-03 00:00:00,64,0,8,3763,2877,6712,42103
2022-06-03 00:00:00,2022-06-03 01:00:00,64,0,8,3475,2919,6466,41322
2022-06-03 01:00:00,2022-06-03 02:00:00,64,0,8,2936,2688,5696,40786
2022-06-03 02:00:00,2022-06-03 03:00:00,64,0,8,2105,2737,4914,40706
2022-06-03 03:00:00,2022-06-03 04:00:00,62,0,28,1626,2518,4234,40827
2022-06-03 04:00:00,2022-06-03 05:00:00,61,0,129,1831,2323,4344,42196
2022-06-03 05:00:00,2022-06-03 06:00:00,61,0,372,1670,1790,3893,43203
2022-06-03 06:00:00,2022-06-03 07:00:00,60,0,692,1323,1198,3273,42370
2022-06-03 07:00:00,2022-06-03 08:00:00,62,0,966,1280,1118,3426,39283
2022-06-03 08:00:00,2022-06-03 09:00:00,62,0,1190,1691,1276,4219,36056
2022-06-03 09:00:00,2022-06-03 10:00:00,61,0,1294,2044,1762,5161,33754
2022-06-03 10:00:00,2022-06-03 11:00:00,62,0,1282,2747,2076,6167,32192
2022-06-03 11:00:00,2022-06-03 12:00:00,61,0,1302,3490,1925,6778,32373
2022-06-03 12:00:00,2022-06-03 13:00:00,61,0,1306,4028,1888,7283,33855
2022-06-03 13:00:00,2022-06-03 14:00:00,60,0,1259,4895,2221,8435,35625
2022-06-03 14:00:00,2022-06-03 15:00:00,62,0,1133,5780,2744,9719,38899
2022-06-03 15:00:00,2022-06-03 16:00:00,62,0,843,6680,3446,11031,43247
2022-06-03 16:00:00,2022-06-03 17:00:00,62,0,560,7210,4035,11867,45727
2022-06-03 17:00:00,2022-06-03 18:00:00,63,0,291,7338,4752,12444,47702
2022-06-03 18:00:00,2022-06-03 19:00:00,61,0,88,7137,4678,11964,48295
2022-06-03 19:00:00,2022-06-03 20:00:00,63,0,11,7021,4523,11618,48333
2022-06-03 20:00:00,2022-06-03 21:00:00,64,0,4,7046,4344,11458,47561
2022-06-03 21:00:00,2022-06-03 22:00:00,63,0,4,7187,4221,11475,45329
2022-06-03 22:00:00,2022-06-03 23:00:00,63,0,4,7619,4456,12142,42783
2022-06-03 23:00:00,2022-06-04 00:00:00,64,0,4,7829,4746,12643,41011
2022-06-04 00:00:00,2022-06-04 01:00:00,64,0,4,7818,4701,12587,39804
2022-06-04 01:00:00,2022-06-04 02:00:00,64,0,4,7634,4408,12110,39303
2022-06-04 02:00:00,2022-06-04 03:00:00,64,0,4,7222,4385,11675,39120
2022-06-04 03:00:00,2022-06-04 04:00:00,62,0,27,6778,4430,11297,37841
2022-06-04 04:00:00,2022-06-04 05:00:00,62,0,124,6686,3925,10797,37167
2022-06-04 05:00:00,2022-06-04 06:00:00,61,0,340,6430,3623,10454,37057
2022-06-04 06:00:00,2022-06-04 07:00:00,60,0,611,6415,3429,10515,38269
2022-06-04 07:00:00,2022-06-04 08:00:00,62,0,899,6784,3191,10936,38545
2022-06-04 08:00:00,2022-06-04 09:00:00,63,0,1042,6723,3025,10853,36053
2022-06-04 09:00:00,2022-06-04 10:00:00,62,0,1188,6735,2709,10694,32767
2022-06-04 10:00:00,2022-06-04 11:00:00,60,0,1268,6922,3106,11356,31729
2022-06-04 11:00:00,2022-06-04 12:00:00,60,0,1259,6923,3423,11665,30229
2022-06-04 12:00:00,2022-06-04 13:00:00,60,0,1231,6704,3297,11292,28055
2022-06-04 13:00:00,2022-06-04 14:00:00,61,0,1221,6632,3301,11215,28126
2022-06-04 14:00:00,2022-06-04 15:00:00,60,0,1132,6845,3408,11445,30019
2022-06-04 15:00:00,2022-06-04 16:00:00,63,0,913,7047,3310,11333,34941
2022-06-04 16:00:00,2022-06-04 17:00:00,63,0,614,7111,3340,11128,39013
2022-06-04 17:00:00,2022-06-04 18:00:00,63,0,290,7204,3520,11077,42107
2022-06-04 18:00:00,2022-06-04 19:00:00,62,0,82,6183,3762,10089,44263
2022-06-04 19:00:00,2022-06-04 20:00:00,64,0,12,6351,4380,10807,45154
2022-06-04 20:00:00,2022-06-04 21:00:00,63,0,8,7184,4554,11809,44852
2022-06-04 21:00:00,2022-06-04 22:00:00,64,0,8,7435,4805,12312,43108
2022-06-04 22:00:00,2022-06-04 23:00:00,63,0,8,7189,4666,11926,41058
2022-06-04 23:00:00,2022-06-05 00:00:00,62,0,8,6309,4079,10458,39419
2022-06-05 00:00:00,2022-06-05 01:00:00,63,0,8,5479,4200,9750,38610
2022-06-05 01:00:00,2022-06-05 02:00:00,63,0,8,6385,4529,10985,37971
2022-06-05 02:00:00,2022-06-05 03:00:00,64,0,8,6019,4734,10825,37558
2022-06-05 03:00:00,2022-06-05 04:00:00,63,0,36,5042,4645,9786,36473
2022-06-05 04:00:00,2022-06-05 05:00:00,61,0,169,3779,3843,7852,35557
2022-06-05 05:00:00,2022-06-05 06:00:00,61,0,297,3453,3416,7227,35700
2022-06-05 06:00:00,2022-06-05 07:00:00,61,0,475,2693,2472,5701,36567
2022-06-05 07:00:00,2022-06-05 08:00:00,61,0,724,2961,1663,5409,35270
2022-06-05 08:00:00,2022-06-05 09:00:00,61,0,798,2369,1491,4719,33553
2022-06-05 09:00:00,2022-06-05 10:00:00,61,0,969,2130,1535,4695,36218
2022-06-05 10:00:00,2022-06-05 11:00:00,60,0,972,1790,1543,4365,38977
2022-06-05 11:00:00,2022-06-05 12:00:00,60,0,747,2120,1730,4657,40595
2022-06-05 12:00:00,2022-06-05 13:00:00,60,0,516,2518,1505,4599,41872
2022-06-05 13:00:00,2022-06-05 14:00:00,60,0,500,2344,1253,4157,43224
2022-06-05 14:00:00,2022-06-05 15:00:00,60,0,279,2363,1128,3830,44791
2022-06-05 15:00:00,2022-06-05 16:00:00,60,0,201,2479,1766,4506,47362
2022-06-05 16:00:00,2022-06-05 17:00:00,61,0,72,2581,1819,4533,47636
2022-06-05 17:00:00,2022-06-05 18:00:00,62,0,22,3249,1245,4578,47043
2022-06-05 18:00:00,2022-06-05 19:00:00,60,0,7,3776,2190,6033,46437
2022-06-05 19:00:00,2022-06-05 20:00:00,62,0,3,4745,3140,7950,45881
2022-06-05 20:00:00,2022-06-05 21:00:00,62,0,4,5227,3749,9042,44971
2022-06-05 21:00:00,2022-06-05 22:00:00,61,0,4,4311,3942,8318,42713
2022-06-05 22:00:00,2022-06-05 23:00:00,61,0,4,3481,3233,6779,40624
2022-06-05 23:00:00,2022-06-06 00:00:00,63,0,4,3100,3155,6322,38929
2022-06-06 00:00:00,2022-06-06 01:00:00,62,0,4,3349,3747,7162,38229
2022-06-06 01:00:00,2022-06-06 02:00:00,63,0,4,4747,4560,9374,38144
2022-06-06 02:00:00,2022-06-06 03:00:00,64,0,4,6126,5239,11433,38028
2022-06-06 03:00:00,2022-06-06 04:00:00,61,0,6,6097,6525,12689,37365
2022-06-06 04:00:00,2022-06-06 05:00:00,62,0,37,7165,6389,13653,37048
2022-06-06 05:00:00,2022-06-06 06:00:00,61,0,101,6542,6459,13163,36299
2022-06-06 06:00:00,2022-06-06 07:00:00,61,0,256,3956,6652,10925,35341
2022-06-06 07:00:00,2022-06-06 08:00:00,64,0,394,3265,6383,10106,34977
2022-06-06 08:00:00,2022-06-06 09:00:00,63,0,615,1797,5472,7947,35483
2022-06-06 09:00:00,2022-06-06 10:00:00,62,0,667,747,5095,6571,34366
2022-06-06 10:00:00,2022-06-06 11:00:00,61,0,486,1327,5399,7273,35533
2022-06-06 11:00:00,2022-06-06 12:00:00,63,0,418,3324,5631,9436,37236
2022-06-06 12:00:00,2022-06-06 13:00:00,62,0,678,4646,5832,11218,40390
2022-06-06 13:00:00,2022-06-06 14:00:00,62,0,404,5227,5798,11491,42219
2022-06-06 14:00:00,2022-06-06 15:00:00,62,0,204,6236,6645,13147,44921
2022-06-06 15:00:00,2022-06-06 16:00:00,63,0,119,5090,6267,11539,47975
2022-06-06 16:00:00,2022-06-06 17:00:00,64,0,105,4739,5348,10256,47628
2022-06-06 17:00:00,2022-06-06 18:00:00,63,0,74,4281,4909,9327,47254
2022-06-06 18:00:00,2022-06-06 19:00:00,64,0,19,3895,4689,8667,46897
2022-06-06 19:00:00,2022-06-06 20:00:00,62,0,5,3609,4389,8065,46344
2022-06-06 20:00:00,2022-06-06 21:00:00,64,0,4,3500,4381,7949,45412
2022-06-06 21:00:00,2022-06-06 22:00:00,64,0,4,3310,4471,7849,43009
2022-06-06 22:00:00,2022-06-06 23:00:00,64,0,4,3330,4605,8003,40853
2022-06-06 23:00:00,2022-06-07 00:00:00,68,0,4,3569,5019,8660,39222
2022-06-07 00:00:00,2022-06-07 01:00:00,83,0,4,3968,5235,9290,38535
2022-06-07 01:00:00,2022-06-07 02:00:00,81,0,4,4141,5368,9594,38364
2022-06-07 02:00:00,2022-06-07 03:00:00,80,0,4,4035,5316,9435,38773
2022-06-07 03:00:00,2022-06-07 04:00:00,80,0,8,3658,5232,8978,39696
2022-06-07 04:00:00,2022-06-07 05:00:00,80,0,51,2479,5233,7843,42757
2022-06-07 05:00:00,2022-06-07 06:00:00,76,0,85,2221,4851,7233,46523
2022-06-07 06:00:00,2022-06-07 07:00:00,81,0,106,2147,4793,7127,47662
2022-06-07 07:00:00,2022-06-07 08:00:00,84,0,259,1933,4563,6839,47441
2022-06-07 08:00:00,2022-06-07 09:00:00,82,0,314,1819,4076,6291,45680
2022-06-07 09:00:00,2022-06-07 10:00:00,84,0,388,1703,3298,5473,43428
2022-06-07 10:00:00,2022-06-07 11:00:00,84,0,476,1580,3257,5397,42072
2022-06-07 11:00:00,2022-06-07 12:00:00,83,0,581,1245,3063,4972,41262
2022-06-07 12:00:00,2022-06-07 13:00:00,82,0,612,1012,2733,4439,39594
2022-06-07 13:00:00,2022-06-07 14:00:00,80,0,823,876,2511,4290,39305
2022-06-07 14:00:00,2022-06-07 15:00:00,78,0,730,913,2072,3793,41691
2022-06-07 15:00:00,2022-06-07 16:00:00,83,0,491,1224,1676,3474,45432
2022-06-07 16:00:00,2022-06-07 17:00:00,84,0,426,1629,1248,3387,46814
2022-06-07 17:00:00,2022-06-07 18:00:00,83,0,189,1781,766,2819,48712
2022-06-07 18:00:00,2022-06-07 19:00:00,82,0,67,2150,450,2749,50051
2022-06-07 19:00:00,2022-06-07 20:00:00,82,0,7,2353,483,2925,50377
2022-06-07 20:00:00,2022-06-07 21:00:00,84,0,4,3517,347,3952,49773
2022-06-07 21:00:00,2022-06-07 22:00:00,79,0,4,3344,372,3799,47119
2022-06-07 22:00:00,2022-06-07 23:00:00,80,0,4,2847,536,3467,44273
2022-06-07 23:00:00,2022-06-08 00:00:00,82,0,4,2878,841,3805,42342
2022-06-08 00:00:00,2022-06-08 01:00:00,82,0,4,2875,1142,4103,41178
2022-06-08 01:00:00,2022-06-08 02:00:00,80,0,4,2496,1380,3960,40567
2022-06-08 02:00:00,2022-06-08 03:00:00,80,0,4,1504,1327,2915,40575
2022-06-08 03:00:00,2022-06-08 04:00:00,80,0,27,1095,1535,2737,40770
2022-06-08 04:00:00,2022-06-08 05:00:00,80,0,107,949,1713,2849,42716
2022-06-08 05:00:00,2022-06-08 06:00:00,81,0,216,871,1379,2547,45939
2022-06-08 06:00:00,2022-06-08 07:00:00,80,0,527,1209,956,2772,46378
2022-06-08 07:00:00,2022-06-08 08:00:00,80,0,714,2352,922,4068,45037
2022-06-08 08:00:00,2022-06-08 09:00:00,80,0,798,2976,1520,5374,45972
2022-06-08 09:00:00,2022-06-08 10:00:00,80,0,734,3188,2094,6096,48071
2022-06-08 10:00:00,2022-06-08 11:00:00,80,0,893,2879,2651,6503,49848
2022-06-08 11:00:00,2022-06-08 12:00:00,80,0,670,2923,3328,7001,51362
2022-06-08 12:00:00,2022-06-08 13:00:00,80,0,228,2656,2461,5425,51462
2022-06-08 13:00:00,2022-06-08 14:00:00,76,0,274,3072,1836,5258,51739
2022-06-08 14:00:00,2022-06-08 15:00:00,77,0,204,3135,1635,5051,52817
2022-06-08 15:00:00,2022-06-08 16:00:00,80,0,206,3536,1481,5303,54273
2022-06-08 16:00:00,2022-06-08 17:00:00,81,0,164,3520,2007,5772,52302
2022-06-08 17:00:00,2022-06-08 18:00:00,80,0,100,4046,3045,7271,51170
2022-06-08 18:00:00,2022-06-08 19:00:00,80,0,25,5123,3432,8660,50858
2022-06-08 19:00:00,2022-06-08 20:00:00,80,0,6,4656,3123,7865,50207
2022-06-08 20:00:00,2022-06-08 21:00:00,84,0,4,4451,3031,7570,48661
2022-06-08 21:00:00,2022-06-08 22:00:00,84,0,4,3295,3353,6736,46005
2022-06-08 22:00:00,2022-06-08 23:00:00,81,0,4,2944,2555,5584,43358
2022-06-08 23:00:00,2022-06-09 00:00:00,80,0,4,3288,2294,5666,41601
2022-06-09 00:00:00,2022-06-09 01:00:00,84,0,4,2551,2448,5087,40815
2022-06-09 01:00:00,2022-06-09 02:00:00,81,0,4,1643,2424,4152,40275
2022-06-09 02:00:00,2022-06-09 03:00:00,81,0,4,1560,1988,3633,40525
2022-06-09 03:00:00,2022-06-09 04:00:00,81,0,22,1921,2130,4154,40841
2022-06-09 04:00:00,2022-06-09 05:00:00,80,0,81,2185,1996,4342,42816
2022-06-09 05:00:00,2022-06-09 06:00:00,80,0,167,1826,1366,3439,45317
2022-06-09 06:00:00,2022-06-09 07:00:00,81,0,401,1376,1360,3218,45137
2022-06-09 07:00:00,2022-06-09 08:00:00,80,0,797,1106,1460,3443,42108
2022-06-09 08:00:00,2022-06-09 09:00:00,81,0,988,1150,1597,3816,39085
2022-06-09 09:00:00,2022-06-09 10:00:00,82,0,1055,1033,1979,4149,37515
2022-06-09 10:00:00,2022-06-09 11:00:00,80,0,1041,743,2374,4238,35840
2022-06-09 11:00:00,2022-06-09 12:00:00,80,0,1099,1403,2562,5144,35762
2022-06-09 12:00:00,2022-06-09 13:00:00,78,0,1250,1474,2458,5260,35750
2022-06-09 13:00:00,2022-06-09 14:00:00,76,0,1215,1207,2385,4883,36135
2022-06-09 14:00:00,2022-06-09 15:00:00,72,0,1163,2286,2377,5898,38282
2022-06-09 15:00:00,2022-06-09 16:00:00,71,0,844,3550,2177,6642,41981
2022-06-09 16:00:00,2022-06-09 17:00:00,70,0,611,3707,2120,6508,43711
2022-06-09 17:00:00,2022-06-09 18:00:00,69,0,313,2978,1849,5209,46374
2022-06-09 18:00:00,2022-06-09 19:00:00,70,0,91,3591,1486,5238,48974
2022-06-09 19:00:00,2022-06-09 20:00:00,69,0,11,4641,1193,5914,49676
2022-06-09 20:00:00,2022-06-09 21:00:00,72,0,4,5016,1198,6290,49229
2022-06-09 21:00:00,2022-06-09 22:00:00,70,0,4,4422,1546,6042,46569
2022-06-09 22:00:00,2022-06-09 23:00:00,71,0,4,4930,2384,7389,43850
2022-06-09 23:00:00,2022-06-10 00:00:00,73,0,4,4697,2653,7427,42165
2022-06-10 00:00:00,2022-06-10 01:00:00,73,0,4,5125,2812,8014,41110
2022-06-10 01:00:00,2022-06-10 02:00:00,74,0,4,4921,3062,8061,40435
2022-06-10 02:00:00,2022-06-10 03:00:00,75,0,4,4937,2803,7819,40581
2022-06-10 03:00:00,2022-06-10 04:00:00,74,0,27,4738,2831,7670,41153
2022-06-10 04:00:00,2022-06-10 05:00:00,75,0,123,4107,2870,7175,43596
2022-06-10 05:00:00,2022-06-10 06:00:00,75,0,324,4538,2602,7539,47699
2022-06-10 06:00:00,2022-06-10 07:00:00,72,0,332,3564,2423,6391,49286
2022-06-10 07:00:00,2022-06-10 08:00:00,72,0,409,4388,2496,7365,47873
2022-06-10 08:00:00,2022-06-10 09:00:00,73,0,505,4742,2794,8114,44244
2022-06-10 09:00:00,2022-06-10 10:00:00,73,0,497,4498,3005,8073,41058
2022-06-10 10:00:00,2022-06-10 11:00:00,72,0,729,4569,2776,8146,40617
2022-06-10 11:00:00,2022-06-10 12:00:00,73,0,745,4422,3091,8331,40383
2022-06-10 12:00:00,2022-06-10 13:00:00,72,0,573,4315,3366,8326,40563
2022-06-10 13:00:00,2022-06-10 14:00:00,69,0,545,4965,3159,8738,42990
2022-06-10 14:00:00,2022-06-10 15:00:00,67,0,564,5427,2718,8776,46379
2022-06-10 15:00:00,2022-06-10 16:00:00,79,0,599,5211,2267,8156,49058
2022-06-10 16:00:00,2022-06-10 17:00:00,82,0,417,5514,1701,7714,48621
2022-06-10 17:00:00,2022-06-10 18:00:00,80,0,117,6326,1356,7879,48961
2022-06-10 18:00:00,2022-06-10 19:00:00,80,0,32,6507,1668,8287,49547
2022-06-10 19:00:00,2022-06-10 20:00:00,80,0,4,6248,1965,8297,48959
2022-06-10 20:00:00,2022-06-10 21:00:00,80,0,4,6619,1965,8668,48263
2022-06-10 21:00:00,2022-06-10 22:00:00,76,0,4,6887,2513,9480,46038
2022-06-10 22:00:00,2022-06-10 23:00:00,76,0,4,7471,3459,11010,43462
2022-06-10 23:00:00,2022-06-11 00:00:00,81,0,4,7525,3193,10803,41617
2022-06-11 00:00:00,2022-06-11 01:00:00,84,0,4,6818,3654,10560,40271
2022-06-11 01:00:00,2022-06-11 02:00:00,84,0,4,5695,4275,10058,39563
2022-06-11 02:00:00,2022-06-11 03:00:00,82,0,4,4286,3984,8356,38995
2022-06-11 03:00:00,2022-06-11 04:00:00,84,0,28,3426,4189,7727,38117
2022-06-11 04:00:00,2022-06-11 05:00:00,84,0,132,2607,4002,6825,37410
2022-06-11 05:00:00,2022-06-11 06:00:00,81,0,366,2575,3182,6204,36643
2022-06-11 06:00:00,2022-06-11 07:00:00,81,0,663,2512,2742,5998,36008
2022-06-11 07:00:00,2022-06-11 08:00:00,80,0,914,2460,2062,5516,34541
2022-06-11 08:00:00,2022-06-11 09:00:00,81,0,1015,2552,1882,5530,32020
2022-06-11 09:00:00,2022-06-11 10:00:00,80,0,1127,2477,1970,5654,29329
2022-06-11 10:00:00,2022-06-11 11:00:00,80,0,1264,2489,2207,6040,27721
2022-06-11 11:00:00,2022-06-11 12:00:00,81,0,1150,1966,1986,5183,27072
2022-06-11 12:00:00,2022-06-11 13:00:00,81,0,1007,1769,1490,4347,27429
2022-06-11 13:00:00,2022-06-11 14:00:00,77,0,1109,2135,1808,5129,28023
2022-06-11 14:00:00,2022-06-11 15:00:00,77,0,1041,3186,2290,6594,30508
2022-06-11 15:00:00,2022-06-11 16:00:00,82,0,837,3660,2648,7227,34931
2022-06-11 16:00:00,2022-06-11 17:00:00,81,0,549,4489,2516,7635,38559
2022-06-11 17:00:00,2022-06-11 18:00:00,80,0,308,4920,2286,7594,41527
2022-06-11 18:00:00,2022-06-11 19:00:00,80,0,93,5285,1778,7236,44005
2022-06-11 19:00:00,2022-06-11 20:00:00,80,0,10,5580,1805,7475,45248
2022-06-11 20:00:00,2022-06-11 21:00:00,80,0,4,5013,2113,7210,45452
2022-06-11 21:00:00,2022-06-11 22:00:00,75,0,4,4486,2518,7083,43391
2022-06-11 22:00:00,2022-06-11 23:00:00,78,0,4,4074,2411,6567,41557
2022-06-11 23:00:00,2022-06-12 00:00:00,84,0,4,3312,2190,5590,39813
2022-06-12 00:00:00,2022-06-12 01:00:00,84,0,4,3079,1932,5099,38873
2022-06-12 01:00:00,2022-06-12 02:00:00,82,0,4,2660,1776,4522,38346
2022-06-12 02:00:00,2022-06-12 03:00:00,80,0,3,3035,1579,4697,38254
2022-06-12 03:00:00,2022-06-12 04:00:00,80,0,28,2653,1353,4114,36835
2022-06-12 04:00:00,2022-06-12 05:00:00,80,0,126,1788,1159,3153,34600
2022-06-12 05:00:00,2022-06-12 06:00:00,81,0,352,1318,855,2606,32532
2022-06-12 06:00:00,2022-06-12 07:00:00,80,0,641,824,731,2276,31075
2022-06-12 07:00:00,2022-06-12 08:00:00,80,0,889,732,780,2481,29603
2022-06-12 08:00:00,2022-06-12 09:00:00,80,0,1080,812,1029,3001,27780
2022-06-12 09:00:00,2022-06-12 10:00:00,80,0,878,1174,1711,3843,27062
2022-06-12 10:00:00,2022-06-12 11:00:00,80,0,844,1445,2440,4809,26905
2022-06-12 11:00:00,2022-06-12 12:00:00,80,0,1065,1298,3031,5474,25716
2022-06-12 12:00:00,2022-06-12 13:00:00,80,0,925,1485,2983,5473,25205
2022-06-12 13:00:00,2022-06-12 14:00:00,73,0,824,1408,2784,5089,27389
2022-06-12 14:00:00,2022-06-12 15:00:00,79,0,823,2000,2904,5806,30195
2022-06-12 15:00:00,2022-06-12 16:00:00,80,0,701,1813,2085,4679,34855
2022-06-12 16:00:00,2022-06-12 17:00:00,81,0,580,1761,1577,3999,37987
2022-06-12 17:00:00,2022-06-12 18:00:00,80,0,275,1883,1352,3590,41675
2022-06-12 18:00:00,2022-06-12 19:00:00,80,0,76,2104,1240,3500,44887
2022-06-12 19:00:00,2022-06-12 20:00:00,80,0,9,1916,1045,3050,45768
2022-06-12 20:00:00,2022-06-12 21:00:00,76,0,8,1885,965,2934,45913
2022-06-12 21:00:00,2022-06-12 22:00:00,75,0,8,1867,1298,3248,43511
2022-06-12 22:00:00,2022-06-12 23:00:00,77,0,8,1584,1746,3415,42078
2022-06-12 23:00:00,2022-06-13 00:00:00,80,0,8,1450,1405,2943,40933
2022-06-13 00:00:00,2022-06-13 01:00:00,80,0,8,1636,1408,3132,40280
2022-06-13 01:00:00,2022-06-13 02:00:00,78,0,8,2652,1799,4537,40093
2022-06-13 02:00:00,2022-06-13 03:00:00,57,0,8,4234,2355,6654,40470
2022-06-13 03:00:00,2022-06-13 04:00:00,59,0,22,3822,3293,7196,40748
2022-06-13 04:00:00,2022-06-13 05:00:00,73,0,132,4116,3227,7548,42641
2022-06-13 05:00:00,2022-06-13 06:00:00,77,0,323,3770,3629,7799,44269
2022-06-13 06:00:00,2022-06-13 07:00:00,78,0,550,3407,3626,7661,43524
2022-06-13 07:00:00,2022-06-13 08:00:00,80,0,742,3097,3541,7460,41161
2022-06-13 08:00:00,2022-06-13 09:00:00,82,0,710,2692,3708,7192,39678
2022-06-13 09:00:00,2022-06-13 10:00:00,79,0,935,2215,3744,6973,37963
2022-06-13 10:00:00,2022-06-13 11:00:00,82,0,946,1721,3556,6305,35692
2022-06-13 11:00:00,2022-06-13 12:00:00,80,0,944,1197,3176,5397,34587
2022-06-13 12:00:00,2022-06-13 13:00:00,80,0,836,933,2847,4696,34534
2022-06-13 13:00:00,2022-06-13 14:00:00,80,0,767,1087,2493,4427,35482
2022-06-13 14:00:00,2022-06-13 15:00:00,79,0,860,1138,2236,4313,38204
2022-06-13 15:00:00,2022-06-13 16:00:00,79,0,656,891,2082,3708,42243
2022-06-13 16:00:00,2022-06-13 17:00:00,80,0,514,646,1605,2845,43765
2022-06-13 17:00:00,2022-06-13 18:00:00,80,0,261,575,1171,2087,46571
2022-06-13 18:00:00,2022-06-13 19:00:00,80,0,91,520,930,1621,48688
2022-06-13 19:00:00,2022-06-13 20:00:00,80,0,13,404,805,1302,49593
2022-06-13 20:00:00,2022-06-13 21:00:00,80,0,4,339,860,1283,49252
2022-06-13 21:00:00,2022-06-13 22:00:00,74,0,4,423,804,1305,46902
2022-06-13 22:00:00,2022-06-13 23:00:00,79,0,4,435,743,1261,44470
2022-06-13 23:00:00,2022-06-14 00:00:00,83,0,4,498,753,1338,42669
2022-06-14 00:00:00,2022-06-14 01:00:00,80,0,4,426,717,1227,41878
2022-06-14 01:00:00,2022-06-14 02:00:00,80,0,4,311,625,1020,41217
2022-06-14 02:00:00,2022-06-14 03:00:00,80,0,4,220,483,787,41233
2022-06-14 03:00:00,2022-06-14 04:00:00,80,0,40,272,424,816,41365
2022-06-14 04:00:00,2022-06-14 05:00:00,79,0,157,343,526,1105,41860
2022-06-14 05:00:00,2022-06-14 06:00:00,76,0,361,528,481,1446,43135
2022-06-14 06:00:00,2022-06-14 07:00:00,76,0,650,492,381,1599,42075
2022-06-14 07:00:00,2022-06-14 08:00:00,80,0,799,342,341,1562,39384
2022-06-14 08:00:00,2022-06-14 09:00:00,80,0,822,322,332,1556,36798
2022-06-14 09:00:00,2022-06-14 10:00:00,80,0,976,266,346,1668,35776
2022-06-14 10:00:00,2022-06-14 11:00:00,80,0,820,174,381,1455,34498
2022-06-14 11:00:00,2022-06-14 12:00:00,80,0,828,193,337,1438,33886
2022-06-14 12:00:00,2022-06-14 13:00:00,80,0,917,205,337,1539,33812
2022-06-14 13:00:00,2022-06-14 14:00:00,80,0,928,139,338,1485,34694
2022-06-14 14:00:00,2022-06-14 15:00:00,80,0,719,134,377,1310,37120
2022-06-14 15:00:00,2022-06-14 16:00:00,80,0,622,352,406,1460,41190
2022-06-14 16:00:00,2022-06-14 17:00:00,80,0,486,779,503,1848,43025
2022-06-14 17:00:00,2022-06-14 18:00:00,81,0,217,987,686,1971,46021
2022-06-14 18:00:00,2022-06-14 19:00:00,80,0,72,1107,745,2004,48424
2022-06-14 19:00:00,2022-06-14 20:00:00,80,0,9,1311,943,2343,48910
2022-06-14 20:00:00,2022-06-14 21:00:00,78,0,4,1832,1242,3156,48153
2022-06-14 21:00:00,2022-06-14 22:00:00,76,0,4,2376,1477,3933,45731
2022-06-14 22:00:00,2022-06-14 23:00:00,80,0,4,1935,1498,3517,43038
2022-06-14 23:00:00,2022-06-15 00:00:00,83,0,4,2036,1469,3592,41503
2022-06-15 00:00:00,2022-06-15 01:00:00,85,0,4,1645,1300,3034,40719
2022-06-15 01:00:00,2022-06-15 02:00:00,105,0,4,1176,1067,2352,40148
2022-06-15 02:00:00,2022-06-15 03:00:00,116,0,4,751,978,1849,40062
2022-06-15 03:00:00,2022-06-15 04:00:00,114,0,30,484,821,1449,40326
2022-06-15 04:00:00,2022-06-15 05:00:00,112,0,138,323,675,1248,41451
2022-06-15 05:00:00,2022-06-15 06:00:00,110,0,343,276,419,1148,42818
2022-06-15 06:00:00,2022-06-15 07:00:00,112,0,710,252,264,1338,41714
2022-06-15 07:00:00,2022-06-15 08:00:00,114,0,949,141,318,1522,38900
2022-06-15 08:00:00,2022-06-15 09:00:00,114,0,1001,112,498,1725,35305
2022-06-15 09:00:00,2022-06-15 10:00:00,114,0,1215,97,578,2004,32697
2022-06-15 10:00:00,2022-06-15 11:00:00,114,0,1235,232,510,2091,31183
2022-06-15 11:00:00,2022-06-15 12:00:00,114,0,1218,509,526,2367,30977
2022-06-15 12:00:00,2022-06-15 13:00:00,114,0,1199,763,710,2786,31373
2022-06-15 13:00:00,2022-06-15 14:00:00,108,0,1133,979,1168,3388,33321
2022-06-15 14:00:00,2022-06-15 15:00:00,111,0,1070,1191,1406,3778,37058
2022-06-15 15:00:00,2022-06-15 16:00:00,109,0,887,1159,1402,3557,41797
2022-06-15 16:00:00,2022-06-15 17:00:00,114,0,629,1444,1461,3648,44155
2022-06-15 17:00:00,2022-06-15 18:00:00,112,0,313,1797,1655,3877,47254
2022-06-15 18:00:00,2022-06-15 19:00:00,114,0,73,1768,1827,3782,49421
2022-06-15 19:00:00,2022-06-15 20:00:00,114,0,12,1942,1872,3940,49821
2022-06-15 20:00:00,2022-06-15 21:00:00,116,0,4,2260,1877,4257,49043
2022-06-15 21:00:00,2022-06-15 22:00:00,116,0,4,2263,1633,4016,46709
2022-06-15 22:00:00,2022-06-15 23:00:00,115,0,4,1956,1762,3837,44044
2022-06-15 23:00:00,2022-06-16 00:00:00,115,0,4,1361,1535,3015,42403
2022-06-16 00:00:00,2022-06-16 01:00:00,116,0,4,779,1161,2060,41510
2022-06-16 01:00:00,2022-06-16 02:00:00,116,0,4,418,873,1411,41219
2022-06-16 02:00:00,2022-06-16 03:00:00,116,0,4,173,680,973,41190
2022-06-16 03:00:00,2022-06-16 04:00:00,114,0,28,115,537,794,41406
2022-06-16 04:00:00,2022-06-16 05:00:00,114,0,157,104,391,766,42667
2022-06-16 05:00:00,2022-06-16 06:00:00,110,0,340,91,305,846,43618
2022-06-16 06:00:00,2022-06-16 07:00:00,110,0,657,75,271,1113,42384
2022-06-16 07:00:00,2022-06-16 08:00:00,114,0,937,71,241,1363,39683
2022-06-16 08:00:00,2022-06-16 09:00:00,115,0,1142,63,245,1565,36353
2022-06-16 09:00:00,2022-06-16 10:00:00,113,0,1259,102,235,1709,33862
2022-06-16 10:00:00,2022-06-16 11:00:00,114,0,1283,268,259,1924,32120
2022-06-16 11:00:00,2022-06-16 12:00:00,114,0,1249,399,279,2041,32170
2022-06-16 12:00:00,2022-06-16 13:00:00,116,0,1093,346,327,1882,32959
2022-06-16 13:00:00,2022-06-16 14:00:00,113,0,1013,343,304,1773,35343
2022-06-16 14:00:00,2022-06-16 15:00:00,113,0,1031,180,279,1603,38744
2022-06-16 15:00:00,2022-06-16 16:00:00,113,0,833,201,260,1407,44920
2022-06-16 16:00:00,2022-06-16 17:00:00,113,0,379,225,241,958,48351
2022-06-16 17:00:00,2022-06-16 18:00:00,110,0,235,207,247,799,48833
2022-06-16 18:00:00,2022-06-16 19:00:00,110,0,118,129,239,596,51608
2022-06-16 19:00:00,2022-06-16 20:00:00,111,0,12,123,238,484,51604
2022-06-16 20:00:00,2022-06-16 21:00:00,114,0,4,299,230,647,51026
2022-06-16 21:00:00,2022-06-16 22:00:00,116,0,4,476,274,870,48610
2022-06-16 22:00:00,2022-06-16 23:00:00,115,0,4,677,399,1195,45350
2022-06-16 23:00:00,2022-06-17 00:00:00,115,0,4,638,756,1513,43457
2022-06-17 00:00:00,2022-06-17 01:00:00,116,0,4,814,905,1839,42242
2022-06-17 01:00:00,2022-06-17 02:00:00,115,0,4,1046,1096,2261,41351
2022-06-17 02:00:00,2022-06-17 03:00:00,116,0,4,1346,1556,3022,41212
2022-06-17 03:00:00,2022-06-17 04:00:00,114,0,38,1891,2093,4136,41235
2022-06-17 04:00:00,2022-06-17 05:00:00,112,0,120,2986,2388,5606,43527
2022-06-17 05:00:00,2022-06-17 06:00:00,108,0,176,3501,2274,6059,46235
2022-06-17 06:00:00,2022-06-17 07:00:00,112,0,328,3246,1765,5451,45819
2022-06-17 07:00:00,2022-06-17 08:00:00,112,0,690,2903,1465,5170,42416
2022-06-17 08:00:00,2022-06-17 09:00:00,115,0,858,2492,1525,4990,39204
2022-06-17 09:00:00,2022-06-17 10:00:00,116,0,847,2369,1444,4776,36725
2022-06-17 10:00:00,2022-06-17 11:00:00,115,0,739,2426,1554,4834,35290
2022-06-17 11:00:00,2022-06-17 12:00:00,115,0,996,2288,1579,4978,34581
2022-06-17 12:00:00,2022-06-17 13:00:00,115,0,1109,2352,1831,5407,35231
2022-06-17 13:00:00,2022-06-17 14:00:00,110,0,943,3300,2104,6457,37040
2022-06-17 14:00:00,2022-06-17 15:00:00,111,0,940,4376,2001,7428,39769
2022-06-17 15:00:00,2022-06-17 16:00:00,112,0,527,5312,1745,7696,43903
2022-06-17 16:00:00,2022-06-17 17:00:00,114,0,501,5802,1503,7920,46062
2022-06-17 17:00:00,2022-06-17 18:00:00,113,0,326,6621,1462,8522,48730
2022-06-17 18:00:00,2022-06-17 19:00:00,112,0,98,7200,1509,8919,50402
2022-06-17 19:00:00,2022-06-17 20:00:00,112,0,24,7128,2131,9395,50700
2022-06-17 20:00:00,2022-06-17 21:00:00,113,0,8,6640,2647,9408,50063
2022-06-17 21:00:00,2022-06-17 22:00:00,110,0,8,5912,3607,9637,48024
2022-06-17 22:00:00,2022-06-17 23:00:00,112,0,8,5090,4495,9705,45788
2022-06-17 23:00:00,2022-06-18 00:00:00,113,0,8,4001,4266,8388,43791
2022-06-18 00:00:00,2022-06-18 01:00:00,114,0,8,2942,3247,6311,42233
2022-06-18 01:00:00,2022-06-18 02:00:00,115,0,8,1601,2084,3808,41486
2022-06-18 02:00:00,2022-06-18 03:00:00,114,0,8,812,1268,2202,41093
2022-06-18 03:00:00,2022-06-18 04:00:00,114,0,32,703,969,1818,40330
2022-06-18 04:00:00,2022-06-18 05:00:00,113,0,127,571,522,1333,39271
2022-06-18 05:00:00,2022-06-18 06:00:00,107,0,320,459,363,1249,38337
2022-06-18 06:00:00,2022-06-18 07:00:00,108,0,578,748,378,1812,37128
2022-06-18 07:00:00,2022-06-18 08:00:00,113,0,823,1230,403,2569,35812
2022-06-18 08:00:00,2022-06-18 09:00:00,114,0,1022,1510,432,3078,33455
2022-06-18 09:00:00,2022-06-18 10:00:00,115,0,1161,2088,463,3827,31451
2022-06-18 10:00:00,2022-06-18 11:00:00,115,0,1106,1783,332,3336,29977
2022-06-18 11:00:00,2022-06-18 12:00:00,113,0,1127,2615,542,4397,29650
2022-06-18 12:00:00,2022-06-18 13:00:00,113,0,804,3366,1404,5687,30416
2022-06-18 13:00:00,2022-06-18 14:00:00,109,0,893,3497,1699,6198,31620
2022-06-18 14:00:00,2022-06-18 15:00:00,112,0,826,4332,1778,7048,34636
2022-06-18 15:00:00,2022-06-18 16:00:00,112,0,733,5959,2304,9108,39362
2022-06-18 16:00:00,2022-06-18 17:00:00,113,0,513,6584,3296,10506,42084
2022-06-18 17:00:00,2022-06-18 18:00:00,113,0,267,5984,3428,9792,44686
2022-06-18 18:00:00,2022-06-18 19:00:00,112,0,88,6362,2797,9359,46533
2022-06-18 19:00:00,2022-06-18 20:00:00,113,0,9,6897,3978,10997,47405
2022-06-18 20:00:00,2022-06-18 21:00:00,114,0,4,6708,4470,11296,47045
2022-06-18 21:00:00,2022-06-18 22:00:00,110,0,4,6881,4457,11452,44969
2022-06-18 22:00:00,2022-06-18 23:00:00,111,0,4,6985,4756,11856,42734
2022-06-18 23:00:00,2022-06-19 00:00:00,112,0,4,7019,4358,11493,40911
2022-06-19 00:00:00,2022-06-19 01:00:00,112,0,4,7068,5300,12484,39927
2022-06-19 01:00:00,2022-06-19 02:00:00,114,0,4,5308,6081,11507,39140
2022-06-19 02:00:00,2022-06-19 03:00:00,115,0,4,5630,5616,11365,38752
2022-06-19 03:00:00,2022-06-19 04:00:00,114,0,5,5722,4475,10316,37910
2022-06-19 04:00:00,2022-06-19 05:00:00,114,0,72,5452,3841,9479,36890
2022-06-19 05:00:00,2022-06-19 06:00:00,110,0,171,1609,3139,5029,36405
2022-06-19 06:00:00,2022-06-19 07:00:00,113,0,140,1941,1634,3828,38633
2022-06-19 07:00:00,2022-06-19 08:00:00,116,0,165,2297,1412,3990,40486
2022-06-19 08:00:00,2022-06-19 09:00:00,112,0,276,2343,1552,4283,39821
2022-06-19 09:00:00,2022-06-19 10:00:00,114,0,463,2937,2056,5570,36458
2022-06-19 10:00:00,2022-06-19 11:00:00,113,0,395,2425,1964,4897,35852
2022-06-19 11:00:00,2022-06-19 12:00:00,114,0,396,1451,1811,3772,33456
2022-06-19 12:00:00,2022-06-19 13:00:00,113,0,549,956,1398,3016,33424
2022-06-19 13:00:00,2022-06-19 14:00:00,108,0,455,1702,1425,3690,35626
2022-06-19 14:00:00,2022-06-19 15:00:00,112,0,652,3571,1507,5842,40342
2022-06-19 15:00:00,2022-06-19 16:00:00,115,0,273,1501,1203,3092,41228
2022-06-19 16:00:00,2022-06-19 17:00:00,115,0,232,1128,1163,2638,41456
2022-06-19 17:00:00,2022-06-19 18:00:00,116,0,173,1469,1298,3056,43904
2022-06-19 18:00:00,2022-06-19 19:00:00,116,0,46,2149,1473,3784,45179
2022-06-19 19:00:00,2022-06-19 20:00:00,116,0,5,2404,1698,4223,45521
2022-06-19 20:00:00,2022-06-19 21:00:00,114,0,4,2841,1700,4659,45799
2022-06-19 21:00:00,2022-06-19 22:00:00,111,0,4,4017,1801,5933,43867
2022-06-19 22:00:00,2022-06-19 23:00:00,114,0,4,4772,1709,6599,42118
2022-06-19 23:00:00,2022-06-20 00:00:00,114,0,4,4570,1665,6353,40829
2022-06-20 00:00:00,2022-06-20 01:00:00,110,0,4,3773,1451,5338,40122
2022-06-20 01:00:00,2022-06-20 02:00:00,106,0,4,4290,1508,5908,39972
2022-06-20 02:00:00,2022-06-20 03:00:00,106,0,4,3494,1689,5293,39961
2022-06-20 03:00:00,2022-06-20 04:00:00,107,0,33,3325,1774,5239,39980
2022-06-20 04:00:00,2022-06-20 05:00:00,103,0,142,2946,1789,4980,41534
2022-06-20 05:00:00,2022-06-20 06:00:00,98,0,349,3526,2520,6493,43455
2022-06-20 06:00:00,2022-06-20 07:00:00,99,0,644,3787,3143,7673,42887
2022-06-20 07:00:00,2022-06-20 08:00:00,101,0,758,2815,2677,6351,40417
2022-06-20 08:00:00,2022-06-20 09:00:00,100,0,773,2754,2578,6205,37537
2022-06-20 09:00:00,2022-06-20 10:00:00,100,0,964,4068,2845,7977,35632
2022-06-20 10:00:00,2022-06-20 11:00:00,101,0,945,4829,3142,9017,34849
2022-06-20 11:00:00,2022-06-20 12:00:00,100,0,970,4397,3388,8855,35856
2022-06-20 12:00:00,2022-06-20 13:00:00,100,0,998,4065,3559,8722,36032
2022-06-20 13:00:00,2022-06-20 14:00:00,96,0,732,3706,3555,8089,36324
2022-06-20 14:00:00,2022-06-20 15:00:00,102,0,603,2906,3135,6746,38080
2022-06-20 15:00:00,2022-06-20 16:00:00,104,0,764,2243,2704,5815,41967
2022-06-20 16:00:00,2022-06-20 17:00:00,104,0,508,1816,2176,4604,43327
2022-06-20 17:00:00,2022-06-20 18:00:00,104,0,243,1744,1745,3836,45856
2022-06-20 18:00:00,2022-06-20 19:00:00,104,0,91,1254,1287,2736,48205
2022-06-20 19:00:00,2022-06-20 20:00:00,104,0,11,762,955,1832,48951
2022-06-20 20:00:00,2022-06-20 21:00:00,104,0,4,491,822,1421,48808
2022-06-20 21:00:00,2022-06-20 22:00:00,100,0,4,396,725,1225,46424
2022-06-20 22:00:00,2022-06-20 23:00:00,103,0,4,347,632,1086,43893
2022-06-20 23:00:00,2022-06-21 00:00:00,104,0,4,603,569,1280,42403
2022-06-21 00:00:00,2022-06-21 01:00:00,104,0,4,524,589,1221,41738
2022-06-21 01:00:00,2022-06-21 02:00:00,104,0,4,355,544,1007,41274
2022-06-21 02:00:00,2022-06-21 03:00:00,104,0,3,265,579,951,41085
2022-06-21 03:00:00,2022-06-21 04:00:00,104,0,28,301,549,982,41126
2022-06-21 04:00:00,2022-06-21 05:00:00,102,0,132,305,534,1073,41668
2022-06-21 05:00:00,2022-06-21 06:00:00,96,0,321,387,470,1274,42632
2022-06-21 06:00:00,2022-06-21 07:00:00,98,0,602,361,441,1502,41723
2022-06-21 07:00:00,2022-06-21 08:00:00,100,0,854,190,420,1564,39187
2022-06-21 08:00:00,2022-06-21 09:00:00,101,0,1004,203,398,1706,36551
2022-06-21 09:00:00,2022-06-21 10:00:00,100,0,1073,279,384,1836,35806
2022-06-21 10:00:00,2022-06-21 11:00:00,100,0,1025,321,385,1831,36027
2022-06-21 11:00:00,2022-06-21 12:00:00,100,0,1141,313,380,1934,36987
2022-06-21 12:00:00,2022-06-21 13:00:00,100,0,1144,262,392,1898,37771
2022-06-21 13:00:00,2022-06-21 14:00:00,97,0,926,219,404,1646,39635
2022-06-21 14:00:00,2022-06-21 15:00:00,101,0,969,457,447,1974,42300
2022-06-21 15:00:00,2022-06-21 16:00:00,104,0,767,447,608,1926,45992
2022-06-21 16:00:00,2022-06-21 17:00:00,104,0,519,360,742,1725,45819
2022-06-21 17:00:00,2022-06-21 18:00:00,104,0,244,692,777,1817,47046
2022-06-21 18:00:00,2022-06-21 19:00:00,104,0,110,388,716,1318,48859
2022-06-21 19:00:00,2022-06-21 20:00:00,104,0,15,251,845,1215,49409
2022-06-21 20:00:00,2022-06-21 21:00:00,104,0,4,203,966,1277,48904
2022-06-21 21:00:00,2022-06-21 22:00:00,100,0,4,178,984,1266,46643
2022-06-21 22:00:00,2022-06-21 23:00:00,103,0,4,200,868,1175,44434
2022-06-21 23:00:00,2022-06-22 00:00:00,104,0,4,249,752,1109,42416
2022-06-22 00:00:00,2022-06-22 01:00:00,104,0,4,323,775,1206,41735
2022-06-22 01:00:00,2022-06-22 02:00:00,104,0,4,502,691,1301,41457
2022-06-22 02:00:00,2022-06-22 03:00:00,104,0,3,562,681,1350,41309
2022-06-22 03:00:00,2022-06-22 04:00:00,104,0,30,386,657,1177,41332
2022-06-22 04:00:00,2022-06-22 05:00:00,105,0,132,338,596,1171,42506
2022-06-22 05:00:00,2022-06-22 06:00:00,104,0,356,366,495,1321,43451
2022-06-22 06:00:00,2022-06-22 07:00:00,102,0,654,801,532,2089,42116
2022-06-22 07:00:00,2022-06-22 08:00:00,104,0,916,824,595,2439,39655
2022-06-22 08:00:00,2022-06-22 09:00:00,104,0,1121,762,581,2568,36122
2022-06-22 09:00:00,2022-06-22 10:00:00,104,0,1230,629,570,2533,33188
2022-06-22 10:00:00,2022-06-22 11:00:00,104,0,1268,541,608,2521,31782
2022-06-22 11:00:00,2022-06-22 12:00:00,104,0,1280,667,670,2721,31508
2022-06-22 12:00:00,2022-06-22 13:00:00,102,0,1265,830,804,3001,32003
2022-06-22 13:00:00,2022-06-22 14:00:00,96,0,1228,1230,1160,3714,33898
2022-06-22 14:00:00,2022-06-22 15:00:00,97,0,1062,1633,1481,4273,37195
2022-06-22 15:00:00,2022-06-22 16:00:00,97,0,884,1918,1750,4649,42038
2022-06-22 16:00:00,2022-06-22 17:00:00,101,0,609,2109,2074,4893,44414
2022-06-22 17:00:00,2022-06-22 18:00:00,100,0,309,2340,2250,4999,47151
2022-06-22 18:00:00,2022-06-22 19:00:00,100,0,93,2500,2095,4788,49324
2022-06-22 19:00:00,2022-06-22 20:00:00,101,0,14,2578,2285,4978,49893
2022-06-22 20:00:00,2022-06-22 21:00:00,101,0,4,2234,2421,4760,49576
2022-06-22 21:00:00,2022-06-22 22:00:00,98,0,4,2061,2511,4674,47494
2022-06-22 22:00:00,2022-06-22 23:00:00,100,0,4,1958,2445,4507,45200
2022-06-22 23:00:00,2022-06-23 00:00:00,102,0,4,1963,2308,4377,43265
2022-06-23 00:00:00,2022-06-23 01:00:00,104,0,4,1930,2373,4411,42081
2022-06-23 01:00:00,2022-06-23 02:00:00,104,0,4,1868,2664,4640,41627
2022-06-23 02:00:00,2022-06-23 03:00:00,104,0,3,1989,2386,4482,41574
2022-06-23 03:00:00,2022-06-23 04:00:00,104,0,27,2297,2493,4921,41730
2022-06-23 04:00:00,2022-06-23 05:00:00,104,0,121,1931,2204,4360,42660
2022-06-23 05:00:00,2022-06-23 06:00:00,103,0,349,1549,1479,3480,44078
2022-06-23 06:00:00,2022-06-23 07:00:00,103,0,642,1048,884,2677,43537
2022-06-23 07:00:00,2022-06-23 08:00:00,104,0,896,680,572,2252,41177
2022-06-23 08:00:00,2022-06-23 09:00:00,103,0,1091,577,513,2284,38644
2022-06-23 09:00:00,2022-06-23 10:00:00,104,0,1190,453,665,2412,37182
2022-06-23 10:00:00,2022-06-23 11:00:00,104,0,1216,357,857,2534,36414
2022-06-23 11:00:00,2022-06-23 12:00:00,104,0,1223,357,1020,2704,36786
2022-06-23 12:00:00,2022-06-23 13:00:00,102,0,1212,538,1057,2909,37798
2022-06-23 13:00:00,2022-06-23 14:00:00,95,0,1125,938,1010,3168,39711
2022-06-23 14:00:00,2022-06-23 15:00:00,101,0,1009,814,868,2792,42935
2022-06-23 15:00:00,2022-06-23 16:00:00,103,0,816,838,780,2537,47941
2022-06-23 16:00:00,2022-06-23 17:00:00,103,0,557,915,657,2232,49529
2022-06-23 17:00:00,2022-06-23 18:00:00,104,0,279,1179,632,2194,51602
2022-06-23 18:00:00,2022-06-23 19:00:00,104,0,85,1528,563,2280,53128
2022-06-23 19:00:00,2022-06-23 20:00:00,104,0,11,1759,642,2516,53235
2022-06-23 20:00:00,2022-06-23 21:00:00,102,0,4,2176,1117,3399,52391
2022-06-23 21:00:00,2022-06-23 22:00:00,96,0,4,2531,1187,3818,50778
2022-06-23 22:00:00,2022-06-23 23:00:00,103,0,4,2593,1155,3855,48037
2022-06-23 23:00:00,2022-06-24 00:00:00,104,0,4,2594,973,3675,45623
2022-06-24 00:00:00,2022-06-24 01:00:00,104,0,4,1975,784,2867,44446
2022-06-24 01:00:00,2022-06-24 02:00:00,104,0,4,1028,1117,2253,44161
2022-06-24 02:00:00,2022-06-24 03:00:00,104,0,4,1094,2414,3616,44629
2022-06-24 03:00:00,2022-06-24 04:00:00,104,0,48,959,1634,2745,44569
2022-06-24 04:00:00,2022-06-24 05:00:00,103,0,119,1258,2047,3527,47221
2022-06-24 05:00:00,2022-06-24 06:00:00,99,0,122,860,1221,2302,51387
2022-06-24 06:00:00,2022-06-24 07:00:00,102,0,130,1314,1008,2554,54128
2022-06-24 07:00:00,2022-06-24 08:00:00,104,0,209,2166,808,3287,53809
2022-06-24 08:00:00,2022-06-24 09:00:00,104,0,328,3121,1422,4975,50983
2022-06-24 09:00:00,2022-06-24 10:00:00,103,0,250,1890,1411,3654,48410
2022-06-24 10:00:00,2022-06-24 11:00:00,104,0,137,1645,1035,2921,46944
2022-06-24 11:00:00,2022-06-24 12:00:00,104,0,306,1039,872,2321,43843
2022-06-24 12:00:00,2022-06-24 13:00:00,104,0,697,1206,631,2638,42453
2022-06-24 13:00:00,2022-06-24 14:00:00,100,0,738,779,648,2265,41234
2022-06-24 14:00:00,2022-06-24 15:00:00,103,0,794,623,686,2206,43914
2022-06-24 15:00:00,2022-06-24 16:00:00,103,0,625,692,773,2193,46439
2022-06-24 16:00:00,2022-06-24 17:00:00,104,0,341,508,712,1665,48377
2022-06-24 17:00:00,2022-06-24 18:00:00,104,0,151,369,369,993,48833
2022-06-24 18:00:00,2022-06-24 19:00:00,104,0,109,318,407,938,49835
2022-06-24 19:00:00,2022-06-24 20:00:00,103,0,19,370,679,1171,49823
2022-06-24 20:00:00,2022-06-24 21:00:00,101,0,4,403,969,1477,49556
2022-06-24 21:00:00,2022-06-24 22:00:00,100,0,4,459,1305,1868,47690
2022-06-24 22:00:00,2022-06-24 23:00:00,102,0,4,632,2055,2793,44794
2022-06-24 23:00:00,2022-06-25 00:00:00,104,0,4,1209,2300,3617,42959
2022-06-25 00:00:00,2022-06-25 01:00:00,104,0,4,2263,2559,4930,41968
2022-06-25 01:00:00,2022-06-25 02:00:00,104,0,4,4199,2625,6932,41347
2022-06-25 02:00:00,2022-06-25 03:00:00,104,0,4,3612,2797,6517,40609
2022-06-25 03:00:00,2022-06-25 04:00:00,104,0,23,3414,2701,6242,39309
2022-06-25 04:00:00,2022-06-25 05:00:00,104,0,121,3041,2163,5429,38076
2022-06-25 05:00:00,2022-06-25 06:00:00,100,0,344,2886,2037,5367,37177
2022-06-25 06:00:00,2022-06-25 07:00:00,101,0,582,1865,1651,4199,37362
2022-06-25 07:00:00,2022-06-25 08:00:00,104,0,827,1531,1278,3740,38974
2022-06-25 08:00:00,2022-06-25 09:00:00,104,0,910,1287,1029,3330,39247
2022-06-25 09:00:00,2022-06-25 10:00:00,104,0,932,957,871,2864,38385
2022-06-25 10:00:00,2022-06-25 11:00:00,103,0,1016,654,607,2380,36224
2022-06-25 11:00:00,2022-06-25 12:00:00,104,0,1024,258,603,1989,35094
2022-06-25 12:00:00,2022-06-25 13:00:00,104,0,647,303,680,1734,34495
2022-06-25 13:00:00,2022-06-25 14:00:00,101,0,558,99,532,1290,36263
2022-06-25 14:00:00,2022-06-25 15:00:00,104,0,617,99,467,1287,39975
2022-06-25 15:00:00,2022-06-25 16:00:00,104,0,701,107,472,1384,44546
2022-06-25 16:00:00,2022-06-25 17:00:00,104,0,387,276,535,1302,46154
2022-06-25 17:00:00,2022-06-25 18:00:00,104,0,213,273,541,1131,46897
2022-06-25 18:00:00,2022-06-25 19:00:00,104,0,83,166,600,953,47063
2022-06-25 19:00:00,2022-06-25 20:00:00,104,0,9,263,538,914,46812
2022-06-25 20:00:00,2022-06-25 21:00:00,103,0,8,591,560,1262,46309
2022-06-25 21:00:00,2022-06-25 22:00:00,100,0,8,1095,602,1805,44890
2022-06-25 22:00:00,2022-06-25 23:00:00,101,0,8,1236,632,1977,42861
2022-06-25 23:00:00,2022-06-26 00:00:00,104,0,8,1353,1012,2477,41418
2022-06-26 00:00:00,2022-06-26 01:00:00,104,0,8,2021,1290,3423,40715
2022-06-26 01:00:00,2022-06-26 02:00:00,104,0,8,1709,1768,3589,40193
2022-06-26 02:00:00,2022-06-26 03:00:00,104,0,8,2329,1719,4160,39521
2022-06-26 03:00:00,2022-06-26 04:00:00,104,0,16,1649,1594,3363,38624
2022-06-26 04:00:00,2022-06-26 05:00:00,104,0,76,1470,1578,3228,36778
2022-06-26 05:00:00,2022-06-26 06:00:00,99,0,261,985,1252,2597,34765
2022-06-26 06:00:00,2022-06-26 07:00:00,101,0,450,1261,1005,2817,33897
2022-06-26 07:00:00,2022-06-26 08:00:00,104,0,554,619,1030,2307,33402
2022-06-26 08:00:00,2022-06-26 09:00:00,104,0,881,487,878,2350,33649
2022-06-26 09:00:00,2022-06-26 10:00:00,104,0,930,609,648,2291,34134
2022-06-26 10:00:00,2022-06-26 11:00:00,104,0,808,546,650,2108,34235
2022-06-26 11:00:00,2022-06-26 12:00:00,104,0,1004,351,817,2276,33506
2022-06-26 12:00:00,2022-06-26 13:00:00,103,0,698,241,1079,2121,33950
2022-06-26 13:00:00,2022-06-26 14:00:00,99,0,514,178,1182,1973,34610
2022-06-26 14:00:00,2022-06-26 15:00:00,99,0,427,136,1306,1968,38285
2022-06-26 15:00:00,2022-06-26 16:00:00,104,0,255,107,1312,1778,41881
2022-06-26 16:00:00,2022-06-26 17:00:00,104,0,168,110,1046,1428,43116
2022-06-26 17:00:00,2022-06-26 18:00:00,104,0,141,115,737,1097,44130
2022-06-26 18:00:00,2022-06-26 19:00:00,97,0,42,96,474,709,45610
2022-06-26 19:00:00,2022-06-26 20:00:00,88,0,8,115,423,634,46819
2022-06-26 20:00:00,2022-06-26 21:00:00,85,0,8,205,417,715,46793
2022-06-26 21:00:00,2022-06-26 22:00:00,71,0,8,236,444,759,44781
2022-06-26 22:00:00,2022-06-26 23:00:00,72,0,8,212,423,715,43853
2022-06-26 23:00:00,2022-06-27 00:00:00,64,0,6,291,390,751,42681
2022-06-27 00:00:00,2022-06-27 01:00:00,65,0,4,291,395,755,42015
2022-06-27 01:00:00,2022-06-27 02:00:00,67,0,4,317,398,786,41784
2022-06-27 02:00:00,2022-06-27 03:00:00,64,0,4,230,392,690,42072
2022-06-27 03:00:00,2022-06-27 04:00:00,66,0,5,127,415,613,42411
2022-06-27 04:00:00,2022-06-27 05:00:00,65,0,25,260,404,754,44213
2022-06-27 05:00:00,2022-06-27 06:00:00,64,0,111,243,405,823,48165
2022-06-27 06:00:00,2022-06-27 07:00:00,64,0,109,169,376,718,51237
2022-06-27 07:00:00,2022-06-27 08:00:00,64,0,200,108,351,723,51108
2022-06-27 08:00:00,2022-06-27 09:00:00,64,0,281,129,352,826,50658
2022-06-27 09:00:00,2022-06-27 10:00:00,65,0,215,173,371,824,50609
2022-06-27 10:00:00,2022-06-27 11:00:00,64,0,306,426,621,1417,50045
2022-06-27 11:00:00,2022-06-27 12:00:00,65,0,427,1048,1404,2944,51360
2022-06-27 12:00:00,2022-06-27 13:00:00,64,0,288,534,1008,1894,52110
2022-06-27 13:00:00,2022-06-27 14:00:00,62,0,245,899,758,1964,52172
2022-06-27 14:00:00,2022-06-27 15:00:00,64,0,350,1637,1966,4017,50127
2022-06-27 15:00:00,2022-06-27 16:00:00,64,0,336,3369,1350,5119,48205
2022-06-27 16:00:00,2022-06-27 17:00:00,63,0,147,3837,729,4776,46611
2022-06-27 17:00:00,2022-06-27 18:00:00,64,0,102,4970,1413,6549,47857
2022-06-27 18:00:00,2022-06-27 19:00:00,65,0,54,5170,1478,6767,49498
2022-06-27 19:00:00,2022-06-27 20:00:00,63,0,11,2988,1957,5019,49580
2022-06-27 20:00:00,2022-06-27 21:00:00,66,0,4,2795,2010,4875,49112
2022-06-27 21:00:00,2022-06-27 22:00:00,63,0,4,2497,2153,4717,46925
2022-06-27 22:00:00,2022-06-27 23:00:00,64,0,4,2801,2166,5035,44750
2022-06-27 23:00:00,2022-06-28 00:00:00,64,0,4,2746,2480,5294,42763
2022-06-28 00:00:00,2022-06-28 01:00:00,66,0,4,2184,2496,4750,41617
2022-06-28 01:00:00,2022-06-28 02:00:00,64,0,4,2056,2233,4357,41139
2022-06-28 02:00:00,2022-06-28 03:00:00,65,0,4,1654,1827,3550,41168
2022-06-28 03:00:00,2022-06-28 04:00:00,64,0,24,932,1598,2618,41328
2022-06-28 04:00:00,2022-06-28 05:00:00,64,0,114,724,1425,2327,42694
2022-06-28 05:00:00,2022-06-28 06:00:00,70,0,339,826,1052,2287,43771
2022-06-28 06:00:00,2022-06-28 07:00:00,79,0,616,876,819,2390,42860
2022-06-28 07:00:00,2022-06-28 08:00:00,83,0,817,697,614,2211,40035
2022-06-28 08:00:00,2022-06-28 09:00:00,84,0,975,627,580,2266,36527
2022-06-28 09:00:00,2022-06-28 10:00:00,84,0,1027,527,570,2208,34079
2022-06-28 10:00:00,2022-06-28 11:00:00,84,0,1038,402,756,2280,32532
2022-06-28 11:00:00,2022-06-28 12:00:00,84,0,1094,263,757,2198,32826
2022-06-28 12:00:00,2022-06-28 13:00:00,84,0,1020,139,666,1909,34379
2022-06-28 13:00:00,2022-06-28 14:00:00,82,0,975,119,539,1715,36686
2022-06-28 14:00:00,2022-06-28 15:00:00,77,0,833,108,457,1475,39672
2022-06-28 15:00:00,2022-06-28 16:00:00,80,0,764,150,343,1337,43663
2022-06-28 16:00:00,2022-06-28 17:00:00,80,0,542,233,405,1260,45537
2022-06-28 17:00:00,2022-06-28 18:00:00,80,0,249,328,426,1083,47803
2022-06-28 18:00:00,2022-06-28 19:00:00,80,0,88,468,566,1202,49984
2022-06-28 19:00:00,2022-06-28 20:00:00,80,0,14,623,1038,1755,50422
2022-06-28 20:00:00,2022-06-28 21:00:00,80,0,8,635,1632,2355,49624
2022-06-28 21:00:00,2022-06-28 22:00:00,81,0,8,1151,2262,3502,47442
2022-06-28 22:00:00,2022-06-28 23:00:00,81,0,8,1595,3087,4771,44769
2022-06-28 23:00:00,2022-06-29 00:00:00,83,0,8,1860,3952,5903,42858
2022-06-29 00:00:00,2022-06-29 01:00:00,82,0,8,1843,4133,6066,41905
2022-06-29 01:00:00,2022-06-29 02:00:00,84,0,8,1837,3917,5846,41378
2022-06-29 02:00:00,2022-06-29 03:00:00,84,0,8,2100,3397,5589,41390
2022-06-29 03:00:00,2022-06-29 04:00:00,83,0,20,1947,2592,4642,41740
2022-06-29 04:00:00,2022-06-29 05:00:00,82,0,107,1518,1974,3681,42778
2022-06-29 05:00:00,2022-06-29 06:00:00,72,0,306,1208,1345,2931,44518
2022-06-29 06:00:00,2022-06-29 07:00:00,76,0,624,1149,834,2683,44025
2022-06-29 07:00:00,2022-06-29 08:00:00,80,0,860,873,658,2471,41814
2022-06-29 08:00:00,2022-06-29 09:00:00,80,0,1051,745,646,2522,39454
2022-06-29 09:00:00,2022-06-29 10:00:00,80,0,1153,797,776,2806,37373
2022-06-29 10:00:00,2022-06-29 11:00:00,81,0,910,927,1087,3005,36491
2022-06-29 11:00:00,2022-06-29 12:00:00,80,0,898,921,1068,2967,36879
2022-06-29 12:00:00,2022-06-29 13:00:00,80,0,970,909,784,2743,37436
2022-06-29 13:00:00,2022-06-29 14:00:00,77,0,1067,703,662,2509,38546
2022-06-29 14:00:00,2022-06-29 15:00:00,77,0,908,598,744,2327,41472
2022-06-29 15:00:00,2022-06-29 16:00:00,83,0,743,480,1125,2431,45481
2022-06-29 16:00:00,2022-06-29 17:00:00,84,0,534,471,774,1863,46828
2022-06-29 17:00:00,2022-06-29 18:00:00,82,0,267,592,698,1639,49466
2022-06-29 18:00:00,2022-06-29 19:00:00,81,0,93,499,734,1407,51643
2022-06-29 19:00:00,2022-06-29 20:00:00,84,0,12,357,903,1356,52091
2022-06-29 20:00:00,2022-06-29 21:00:00,84,0,4,216,1060,1364,51253
2022-06-29 21:00:00,2022-06-29 22:00:00,82,0,4,266,1051,1403,49380
2022-06-29 22:00:00,2022-06-29 23:00:00,80,0,4,1183,1130,2397,46761
2022-06-29 23:00:00,2022-06-30 00:00:00,83,0,4,970,1223,2280,44645
2022-06-30 00:00:00,2022-06-30 01:00:00,84,0,4,1201,1862,3151,43066
2022-06-30 01:00:00,2022-06-30 02:00:00,84,0,4,1457,2265,3810,42679
2022-06-30 02:00:00,2022-06-30 03:00:00,84,0,4,1428,2061,3577,42714
2022-06-30 03:00:00,2022-06-30 04:00:00,84,0,22,1771,1983,3860,42959
2022-06-30 04:00:00,2022-06-30 05:00:00,80,0,115,1807,1682,3684,44357
2022-06-30 05:00:00,2022-06-30 06:00:00,72,0,294,1806,941,3113,45559
2022-06-30 06:00:00,2022-06-30 07:00:00,77,0,590,1696,664,3027,44247
2022-06-30 07:00:00,2022-06-30 08:00:00,80,0,864,1659,735,3338,41346
2022-06-30 08:00:00,2022-06-30 09:00:00,80,0,1067,1681,781,3609,38600
2022-06-30 09:00:00,2022-06-30 10:00:00,68,0,1166,1287,770,3291,37210
2022-06-30 10:00:00,2022-06-30 11:00:00,74,0,1057,992,688,2811,38061
2022-06-30 11:00:00,2022-06-30 12:00:00,80,0,774,684,733,2271,40531
2022-06-30 12:00:00,2022-06-30 13:00:00,80,0,839,430,1077,2426,42037
2022-06-30 13:00:00,2022-06-30 14:00:00,75,0,797,346,1530,2748,43382
2022-06-30 14:00:00,2022-06-30 15:00:00,78,0,844,285,1976,3183,46930
2022-06-30 15:00:00,2022-06-30 16:00:00,82,0,747,499,2245,3573,52033
2022-06-30 16:00:00,2022-06-30 17:00:00,80,0,513,783,3313,4689,53572
2022-06-30 17:00:00,2022-06-30 18:00:00,80,0,218,799,4891,5988,53939
2022-06-30 18:00:00,2022-06-30 19:00:00,82,0,44,994,4795,5915,53071
2022-06-30 19:00:00,2022-06-30 20:00:00,81,0,3,2105,3516,5705,51850
2022-06-30 20:00:00,2022-06-30 21:00:00,82,0,4,3244,1948,5278,50430
2022-06-30 21:00:00,2022-06-30 22:00:00,81,0,4,4432,2262,6779,48385
2022-06-30 22:00:00,2022-06-30 23:00:00,80,0,4,4854,2280,7218,45621
2022-06-30 23:00:00,2022-07-01 00:00:00,82,0,4,4352,2702,7140,43505
2022-07-01 00:00:00,2022-07-01 01:00:00,84,0,4,4337,2365,6790,42817
2022-07-01 01:00:00,2022-07-01 02:00:00,84,0,4,4157,2684,6929,42083
2022-07-01 02:00:00,2022-07-01 03:00:00,83,0,4,4569,2842,7498,42065
2022-07-01 03:00:00,2022-07-01 04:00:00,83,0,8,4894,3068,8053,42565
2022-07-01 04:00:00,2022-07-01 05:00:00,82,0,40,4547,2812,7481,44169
2022-07-01 05:00:00,2022-07-01 06:00:00,78,0,164,4728,2428,7398,46676
2022-07-01 06:00:00,2022-07-01 07:00:00,76,0,374,4388,2476,7314,45836
2022-07-01 07:00:00,2022-07-01 08:00:00,78,0,536,4268,2556,7438,42896
2022-07-01 08:00:00,2022-07-01 09:00:00,80,0,851,5045,2795,8771,39641
2022-07-01 09:00:00,2022-07-01 10:00:00,80,0,819,5101,3505,9505,38082
2022-07-01 10:00:00,2022-07-01 11:00:00,80,0,988,4806,3222,9096,37439
2022-07-01 11:00:00,2022-07-01 12:00:00,80,0,953,4550,3572,9155,37435
2022-07-01 12:00:00,2022-07-01 13:00:00,80,0,844,4526,4026,9476,37463
2022-07-01 13:00:00,2022-07-01 14:00:00,72,0,905,5491,4519,10987,38252
2022-07-01 14:00:00,2022-07-01 15:00:00,77,0,769,7248,4142,12236,41289
2022-07-01 15:00:00,2022-07-01 16:00:00,80,0,728,6904,3611,11323,44172
2022-07-01 16:00:00,2022-07-01 17:00:00,76,0,551,7483,3410,11520,44646
2022-07-01 17:00:00,2022-07-01 18:00:00,76,0,280,7644,3218,11218,46161
2022-07-01 18:00:00,2022-07-01 19:00:00,77,0,104,7204,2824,10209,47844
2022-07-01 19:00:00,2022-07-01 20:00:00,77,0,14,6929,2987,10007,48453
2022-07-01 20:00:00,2022-07-01 21:00:00,80,0,8,6485,2806,9379,48202
2022-07-01 21:00:00,2022-07-01 22:00:00,77,0,8,5856,2506,8447,46354
2022-07-01 22:00:00,2022-07-01 23:00:00,76,0,8,5564,2511,8159,44244
2022-07-01 23:00:00,2022-07-02 00:00:00,81,0,8,4745,2683,7517,42279
2022-07-02 00:00:00,2022-07-02 01:00:00,84,0,8,4542,2741,7375,41252
2022-07-02 01:00:00,2022-07-02 02:00:00,84,0,8,4278,2650,7020,40530
2022-07-02 02:00:00,2022-07-02 03:00:00,84,0,8,3888,2995,6975,40213
2022-07-02 03:00:00,2022-07-02 04:00:00,84,0,26,3917,2943,6970,39511
2022-07-02 04:00:00,2022-07-02 05:00:00,81,0,120,3832,2486,6519,38331
2022-07-02 05:00:00,2022-07-02 06:00:00,77,0,360,3379,1876,5692,36863
2022-07-02 06:00:00,2022-07-02 07:00:00,78,0,682,3524,1439,5723,35380
2022-07-02 07:00:00,2022-07-02 08:00:00,80,0,945,2837,1463,5325,33529
2022-07-02 08:00:00,2022-07-02 09:00:00,80,0,1124,2127,1731,5062,31003
2022-07-02 09:00:00,2022-07-02 10:00:00,81,0,1153,1983,1667,4884,29152
2022-07-02 10:00:00,2022-07-02 11:00:00,81,0,1091,1932,1684,4788,30495
2022-07-02 11:00:00,2022-07-02 12:00:00,80,0,840,1890,1552,4362,31318
2022-07-02 12:00:00,2022-07-02 13:00:00,80,0,635,1190,1196,3101,30970
2022-07-02 13:00:00,2022-07-02 14:00:00,74,0,679,1357,874,2984,32150
2022-07-02 14:00:00,2022-07-02 15:00:00,75,0,616,1223,670,2584,34768
2022-07-02 15:00:00,2022-07-02 16:00:00,78,0,655,1099,624,2456,38260
2022-07-02 16:00:00,2022-07-02 17:00:00,80,0,471,1278,579,2408,40920
2022-07-02 17:00:00,2022-07-02 18:00:00,80,0,271,975,371,1697,43708
2022-07-02 18:00:00,2022-07-02 19:00:00,80,0,71,762,265,1178,45459
2022-07-02 19:00:00,2022-07-02 20:00:00,80,0,8,846,229,1163,46154
2022-07-02 20:00:00,2022-07-02 21:00:00,80,0,4,1216,292,1592,46395
2022-07-02 21:00:00,2022-07-02 22:00:00,78,0,4,1805,402,2289,45259
2022-07-02 22:00:00,2022-07-02 23:00:00,78,0,4,1863,537,2482,43538
2022-07-02 23:00:00,2022-07-03 00:00:00,80,0,4,1801,685,2570,41811
2022-07-03 00:00:00,2022-07-03 01:00:00,80,0,4,1683,762,2529,40755
2022-07-03 01:00:00,2022-07-03 02:00:00,80,0,4,1605,840,2529,39988
2022-07-03 02:00:00,2022-07-03 03:00:00,80,0,4,1050,977,2111,39371
2022-07-03 03:00:00,2022-07-03 04:00:00,84,0,31,992,1031,2138,38046
2022-07-03 04:00:00,2022-07-03 05:00:00,78,0,84,847,941,1950,36242
2022-07-03 05:00:00,2022-07-03 06:00:00,76,0,286,579,851,1792,34139
2022-07-03 06:00:00,2022-07-03 07:00:00,79,0,528,541,826,1974,32722
2022-07-03 07:00:00,2022-07-03 08:00:00,80,0,568,515,909,2072,31555
2022-07-03 08:00:00,2022-07-03 09:00:00,80,0,774,717,1042,2613,30282
2022-07-03 09:00:00,2022-07-03 10:00:00,80,0,856,641,1054,2631,30080
2022-07-03 10:00:00,2022-07-03 11:00:00,80,0,926,852,1190,3048,31054
2022-07-03 11:00:00,2022-07-03 12:00:00,81,0,891,1102,1579,3653,30757
2022-07-03 12:00:00,2022-07-03 13:00:00,79,0,828,1444,1879,4230,30704
2022-07-03 13:00:00,2022-07-03 14:00:00,72,0,601,1401,2124,4198,31668
2022-07-03 14:00:00,2022-07-03 15:00:00,76,0,445,1458,2272,4251,32926
2022-07-03 15:00:00,2022-07-03 16:00:00,80,0,564,1609,2201,4454,36711
2022-07-03 16:00:00,2022-07-03 17:00:00,80,0,399,1248,1848,3575,39350
2022-07-03 17:00:00,2022-07-03 18:00:00,80,0,193,1286,1417,2976,42187
2022-07-03 18:00:00,2022-07-03 19:00:00,80,0,84,1039,1114,2317,44625
2022-07-03 19:00:00,2022-07-03 20:00:00,80,0,16,894,938,1928,45872
2022-07-03 20:00:00,2022-07-03 21:00:00,80,0,4,1138,986,2208,46338
2022-07-03 21:00:00,2022-07-03 22:00:00,77,0,4,1350,904,2335,44500
2022-07-03 22:00:00,2022-07-03 23:00:00,75,0,4,1425,901,2405,42951
2022-07-03 23:00:00,2022-07-04 00:00:00,83,0,4,1387,1171,2645,41687
2022-07-04 00:00:00,2022-07-04 01:00:00,84,0,4,1003,1294,2385,40781
2022-07-04 01:00:00,2022-07-04 02:00:00,84,0,4,1150,1302,2540,40592
2022-07-04 02:00:00,2022-07-04 03:00:00,84,0,4,1263,1326,2677,40652
2022-07-04 03:00:00,2022-07-04 04:00:00,84,0,23,1074,1315,2496,40802
2022-07-04 04:00:00,2022-07-04 05:00:00,84,0,120,1043,1420,2667,42294
2022-07-04 05:00:00,2022-07-04 06:00:00,80,0,324,826,1140,2370,44055
2022-07-04 06:00:00,2022-07-04 07:00:00,79,0,573,800,782,2234,43347
2022-07-04 07:00:00,2022-07-04 08:00:00,83,0,777,808,865,2533,41314
2022-07-04 08:00:00,2022-07-04 09:00:00,83,0,650,1147,1329,3209,40592
2022-07-04 09:00:00,2022-07-04 10:00:00,81,0,801,1589,2070,4541,38864
2022-07-04 10:00:00,2022-07-04 11:00:00,82,0,953,2009,2657,5701,36816
2022-07-04 11:00:00,2022-07-04 12:00:00,81,0,1018,2153,2902,6154,35212
2022-07-04 12:00:00,2022-07-04 13:00:00,79,0,879,2109,2935,6002,34048
2022-07-04 13:00:00,2022-07-04 14:00:00,44,0,984,2400,2972,6400,35135
2022-07-04 14:00:00,2022-07-04 15:00:00,8,0,933,2431,2782,6154,38339
2022-07-04 15:00:00,2022-07-04 16:00:00,8,0,770,2606,2310,5694,42879
2022-07-04 16:00:00,2022-07-04 17:00:00,8,0,599,2393,2099,5099,44722
2022-07-04 17:00:00,2022-07-04 18:00:00,8,0,329,2606,1742,4685,47395
2022-07-04 18:00:00,2022-07-04 19:00:00,8,0,89,2340,1378,3815,49557
2022-07-04 19:00:00,2022-07-04 20:00:00,10,0,11,1656,1187,2864,49907
2022-07-04 20:00:00,2022-07-04 21:00:00,11,0,8,1195,867,2081,49578
2022-07-04 21:00:00,2022-07-04 22:00:00,12,0,8,1074,739,1833,47144
2022-07-04 22:00:00,2022-07-04 23:00:00,12,0,8,1103,813,1936,44912
2022-07-04 23:00:00,2022-07-05 00:00:00,12,0,8,1007,881,1908,43313
2022-07-05 00:00:00,2022-07-05 01:00:00,12,0,8,995,959,1974,42147
2022-07-05 01:00:00,2022-07-05 02:00:00,9,0,8,1134,1107,2258,41832
2022-07-05 02:00:00,2022-07-05 03:00:00,55,0,8,1069,1264,2396,42052
2022-07-05 03:00:00,2022-07-05 04:00:00,124,0,21,955,1316,2416,42120
2022-07-05 04:00:00,2022-07-05 05:00:00,132,0,114,1122,1169,2537,43454
2022-07-05 05:00:00,2022-07-05 06:00:00,132,0,339,1228,1184,2883,45279
2022-07-05 06:00:00,2022-07-05 07:00:00,132,0,594,1350,1210,3286,44912
2022-07-05 07:00:00,2022-07-05 08:00:00,132,0,785,1429,1112,3458,43020
2022-07-05 08:00:00,2022-07-05 09:00:00,132,0,701,1477,1293,3603,41014
2022-07-05 09:00:00,2022-07-05 10:00:00,132,0,758,1840,1836,4566,40162
2022-07-05 10:00:00,2022-07-05 11:00:00,132,0,741,2099,2263,5235,38295
2022-07-05 11:00:00,2022-07-05 12:00:00,132,0,798,2343,2375,5648,37267
2022-07-05 12:00:00,2022-07-05 13:00:00,131,0,862,1955,2505,5453,37744
2022-07-05 13:00:00,2022-07-05 14:00:00,130,0,928,1811,2538,5407,39225
2022-07-05 14:00:00,2022-07-05 15:00:00,133,0,768,1778,2974,5653,41016
2022-07-05 15:00:00,2022-07-05 16:00:00,133,0,646,1695,3728,6202,44540
2022-07-05 16:00:00,2022-07-05 17:00:00,132,0,440,1424,3046,5042,45270
2022-07-05 17:00:00,2022-07-05 18:00:00,132,0,238,1172,2643,4185,47216
2022-07-05 18:00:00,2022-07-05 19:00:00,132,0,98,1757,2058,4045,48798
2022-07-05 19:00:00,2022-07-05 20:00:00,133,0,17,1100,1903,3153,49361
2022-07-05 20:00:00,2022-07-05 21:00:00,132,0,4,1104,1877,3117,49129
2022-07-05 21:00:00,2022-07-05 22:00:00,126,0,4,1154,1507,2791,46719
2022-07-05 22:00:00,2022-07-05 23:00:00,130,0,4,1072,1428,2634,44104
2022-07-05 23:00:00,2022-07-06 00:00:00,133,0,4,1492,1428,3057,42577
2022-07-06 00:00:00,2022-07-06 01:00:00,133,0,4,1370,1530,3037,41723
2022-07-06 01:00:00,2022-07-06 02:00:00,134,0,4,1265,1685,3088,41305
2022-07-06 02:00:00,2022-07-06 03:00:00,134,0,4,1276,1900,3314,41272
2022-07-06 03:00:00,2022-07-06 04:00:00,133,0,19,1109,1655,2916,41401
2022-07-06 04:00:00,2022-07-06 05:00:00,132,0,109,1125,1692,3058,42891
2022-07-06 05:00:00,2022-07-06 06:00:00,132,0,270,1069,1572,3043,44693
2022-07-06 06:00:00,2022-07-06 07:00:00,132,0,416,828,1320,2696,43517
2022-07-06 07:00:00,2022-07-06 08:00:00,128,0,659,527,1059,2373,41421
2022-07-06 08:00:00,2022-07-06 09:00:00,130,0,784,469,916,2299,40200
2022-07-06 09:00:00,2022-07-06 10:00:00,131,0,879,1019,845,2874,39078
2022-07-06 10:00:00,2022-07-06 11:00:00,132,0,647,1337,978,3094,37128
2022-07-06 11:00:00,2022-07-06 12:00:00,133,0,744,2826,1485,5188,36178
2022-07-06 12:00:00,2022-07-06 13:00:00,132,0,716,3212,2573,6633,38353
2022-07-06 13:00:00,2022-07-06 14:00:00,132,0,523,3190,3638,7483,42324
2022-07-06 14:00:00,2022-07-06 15:00:00,131,0,337,2906,3924,7298,46121
2022-07-06 15:00:00,2022-07-06 16:00:00,130,0,241,2602,3850,6823,50555
2022-07-06 16:00:00,2022-07-06 17:00:00,133,0,142,3205,3219,6699,50290
2022-07-06 17:00:00,2022-07-06 18:00:00,132,0,105,3504,3356,7097,50474
2022-07-06 18:00:00,2022-07-06 19:00:00,132,0,39,3979,3035,7185,51131
2022-07-06 19:00:00,2022-07-06 20:00:00,133,0,7,4499,3551,8190,50848
2022-07-06 20:00:00,2022-07-06 21:00:00,132,0,8,4298,4029,8467,49692
2022-07-06 21:00:00,2022-07-06 22:00:00,129,0,8,4852,4550,9539,47926
2022-07-06 22:00:00,2022-07-06 23:00:00,129,0,8,5625,4937,10699,45385
2022-07-06 23:00:00,2022-07-07 00:00:00,133,0,8,5943,4945,11029,43411
2022-07-07 00:00:00,2022-07-07 01:00:00,135,0,8,6908,5955,13006,42464
2022-07-07 01:00:00,2022-07-07 02:00:00,135,0,8,7297,6311,13751,42010
2022-07-07 02:00:00,2022-07-07 03:00:00,136,0,8,7583,6282,14009,42030
2022-07-07 03:00:00,2022-07-07 04:00:00,136,0,11,7650,6744,14541,43060
2022-07-07 04:00:00,2022-07-07 05:00:00,133,0,66,6976,7006,14181,45801
2022-07-07 05:00:00,2022-07-07 06:00:00,134,0,187,7052,6979,14352,48333
2022-07-07 06:00:00,2022-07-07 07:00:00,131,0,377,7848,6771,15127,48093
2022-07-07 07:00:00,2022-07-07 08:00:00,132,0,528,7905,6226,14791,47042
2022-07-07 08:00:00,2022-07-07 09:00:00,132,0,648,8373,6172,15325,45960
2022-07-07 09:00:00,2022-07-07 10:00:00,132,0,553,8247,6893,15825,46624
2022-07-07 10:00:00,2022-07-07 11:00:00,133,0,529,8367,7540,16569,46907
2022-07-07 11:00:00,2022-07-07 12:00:00,133,0,628,8097,7390,16248,46010
2022-07-07 12:00:00,2022-07-07 13:00:00,132,0,645,7991,6882,15650,44060
2022-07-07 13:00:00,2022-07-07 14:00:00,132,0,570,7198,6409,14309,44046
2022-07-07 14:00:00,2022-07-07 15:00:00,134,0,510,6610,6041,13295,45756
2022-07-07 15:00:00,2022-07-07 16:00:00,134,0,328,5711,5567,11740,48279
2022-07-07 16:00:00,2022-07-07 17:00:00,132,0,218,5181,4793,10324,48743
2022-07-07 17:00:00,2022-07-07 18:00:00,134,0,106,4752,4360,9352,49718
2022-07-07 18:00:00,2022-07-07 19:00:00,132,0,41,3794,3875,7842,50093
2022-07-07 19:00:00,2022-07-07 20:00:00,132,0,7,3496,3400,7035,49776
2022-07-07 20:00:00,2022-07-07 21:00:00,131,0,4,2812,3060,6007,48761
2022-07-07 21:00:00,2022-07-07 22:00:00,128,0,4,2249,2441,4822,46906
2022-07-07 22:00:00,2022-07-07 23:00:00,132,0,4,1988,1875,3999,44762
2022-07-07 23:00:00,2022-07-08 00:00:00,134,0,4,1539,1411,3088,43468
2022-07-08 00:00:00,2022-07-08 01:00:00,136,0,4,1156,1163,2459,42551
2022-07-08 01:00:00,2022-07-08 02:00:00,136,0,4,1213,998,2351,42121
2022-07-08 02:00:00,2022-07-08 03:00:00,136,0,4,1074,1385,2599,42087
2022-07-08 03:00:00,2022-07-08 04:00:00,136,0,22,1137,1404,2699,42285
2022-07-08 04:00:00,2022-07-08 05:00:00,136,0,112,1203,1134,2585,43158
2022-07-08 05:00:00,2022-07-08 06:00:00,132,0,323,1059,833,2347,44878
2022-07-08 06:00:00,2022-07-08 07:00:00,133,0,412,1040,737,2322,44607
2022-07-08 07:00:00,2022-07-08 08:00:00,136,0,474,994,738,2342,42365
2022-07-08 08:00:00,2022-07-08 09:00:00,136,0,517,902,872,2427,39411
2022-07-08 09:00:00,2022-07-08 10:00:00,136,0,564,903,1084,2687,37404
2022-07-08 10:00:00,2022-07-08 11:00:00,135,0,780,746,1262,2923,35895
2022-07-08 11:00:00,2022-07-08 12:00:00,135,0,947,435,1509,3026,35518
2022-07-08 12:00:00,2022-07-08 13:00:00,135,0,779,399,1720,3033,35850
2022-07-08 13:00:00,2022-07-08 14:00:00,135,0,689,344,1821,2989,37179
2022-07-08 14:00:00,2022-07-08 15:00:00,131,0,629,299,1596,2655,39776
2022-07-08 15:00:00,2022-07-08 16:00:00,132,0,621,360,1395,2508,43932
2022-07-08 16:00:00,2022-07-08 17:00:00,134,0,475,244,1075,1928,45498
2022-07-08 17:00:00,2022-07-08 18:00:00,136,0,251,192,893,1472,47864
2022-07-08 18:00:00,2022-07-08 19:00:00,134,0,95,211,680,1120,49323
2022-07-08 19:00:00,2022-07-08 20:00:00,134,0,13,139,590,876,49730
2022-07-08 20:00:00,2022-07-08 21:00:00,135,0,4,200,705,1044,49170
2022-07-08 21:00:00,2022-07-08 22:00:00,131,0,4,295,806,1236,47371
2022-07-08 22:00:00,2022-07-08 23:00:00,130,0,4,330,777,1241,45013
2022-07-08 23:00:00,2022-07-09 00:00:00,134,0,4,579,709,1426,43263
2022-07-09 00:00:00,2022-07-09 01:00:00,134,0,4,702,999,1839,42067
2022-07-09 01:00:00,2022-07-09 02:00:00,134,0,4,905,1334,2377,41672
2022-07-09 02:00:00,2022-07-09 03:00:00,134,0,4,1200,1116,2454,41548
2022-07-09 03:00:00,2022-07-09 04:00:00,134,0,17,1702,962,2815,40880
2022-07-09 04:00:00,2022-07-09 05:00:00,134,0,87,2348,1096,3665,39945
2022-07-09 05:00:00,2022-07-09 06:00:00,129,0,198,3505,1271,5103,39448
2022-07-09 06:00:00,2022-07-09 07:00:00,130,0,277,3773,1352,5532,39341
2022-07-09 07:00:00,2022-07-09 08:00:00,136,0,429,3793,1673,6031,39435
2022-07-09 08:00:00,2022-07-09 09:00:00,132,0,715,3128,1871,5846,37957
2022-07-09 09:00:00,2022-07-09 10:00:00,132,0,789,1944,2255,5120,37190
2022-07-09 10:00:00,2022-07-09 11:00:00,136,0,844,2951,3454,7385,34623
2022-07-09 11:00:00,2022-07-09 12:00:00,132,0,556,2192,3215,6095,31645
2022-07-09 12:00:00,2022-07-09 13:00:00,132,0,483,891,2551,4057,30105
2022-07-09 13:00:00,2022-07-09 14:00:00,128,0,495,1529,3145,5297,30924
2022-07-09 14:00:00,2022-07-09 15:00:00,132,0,377,3459,4202,8170,33575
2022-07-09 15:00:00,2022-07-09 16:00:00,133,0,442,3665,5682,9922,37863
2022-07-09 16:00:00,2022-07-09 17:00:00,117,0,343,4259,5394,10113,40838
2022-07-09 17:00:00,2022-07-09 18:00:00,74,0,159,3655,4910,8798,42986
2022-07-09 18:00:00,2022-07-09 19:00:00,72,0,58,3947,3748,7825,44781
2022-07-09 19:00:00,2022-07-09 20:00:00,71,0,6,3812,3286,7175,45195
2022-07-09 20:00:00,2022-07-09 21:00:00,71,0,4,3595,2713,6383,45458
2022-07-09 21:00:00,2022-07-09 22:00:00,74,0,4,3174,2447,5699,43688
2022-07-09 22:00:00,2022-07-09 23:00:00,64,0,4,2697,2393,5158,42513
2022-07-09 23:00:00,2022-07-10 00:00:00,61,0,4,2208,2310,4583,41062
2022-07-10 00:00:00,2022-07-10 01:00:00,64,0,4,2295,2276,4639,40181
2022-07-10 01:00:00,2022-07-10 02:00:00,61,0,4,2342,2165,4572,39489
2022-07-10 02:00:00,2022-07-10 03:00:00,64,0,4,2295,2376,4739,39020
2022-07-10 03:00:00,2022-07-10 04:00:00,64,0,21,2194,2715,4994,38082
2022-07-10 04:00:00,2022-07-10 05:00:00,63,0,78,2105,2674,4920,37346
2022-07-10 05:00:00,2022-07-10 06:00:00,64,0,108,1998,2970,5140,36837
2022-07-10 06:00:00,2022-07-10 07:00:00,62,0,192,1729,3244,5227,37294
2022-07-10 07:00:00,2022-07-10 08:00:00,64,0,419,1555,3069,5107,37677
2022-07-10 08:00:00,2022-07-10 09:00:00,64,0,426,505,2789,3784,37176
2022-07-10 09:00:00,2022-07-10 10:00:00,64,0,526,347,2307,3244,36205
2022-07-10 10:00:00,2022-07-10 11:00:00,64,0,585,420,2301,3370,34810
2022-07-10 11:00:00,2022-07-10 12:00:00,64,0,552,433,1974,3023,34117
2022-07-10 12:00:00,2022-07-10 13:00:00,64,0,552,671,1960,3247,32917
2022-07-10 13:00:00,2022-07-10 14:00:00,64,0,532,567,1815,2978,33203
2022-07-10 14:00:00,2022-07-10 15:00:00,63,0,491,495,2116,3165,35320
2022-07-10 15:00:00,2022-07-10 16:00:00,64,0,403,511,2575,3553,40455
2022-07-10 16:00:00,2022-07-10 17:00:00,64,0,196,928,2226,3414,42514
2022-07-10 17:00:00,2022-07-10 18:00:00,64,0,101,771,1889,2825,43349
2022-07-10 18:00:00,2022-07-10 19:00:00,64,0,32,578,1483,2157,45348
2022-07-10 19:00:00,2022-07-10 20:00:00,64,0,9,435,1427,1935,46502
2022-07-10 20:00:00,2022-07-10 21:00:00,64,0,8,499,1326,1897,46582
2022-07-10 21:00:00,2022-07-10 22:00:00,64,0,8,342,968,1382,44865
2022-07-10 22:00:00,2022-07-10 23:00:00,55,0,8,305,640,1008,43561
2022-07-10 23:00:00,2022-07-11 00:00:00,61,0,8,314,569,952,42284
2022-07-11 00:00:00,2022-07-11 01:00:00,63,0,8,411,523,1005,41624
2022-07-11 01:00:00,2022-07-11 02:00:00,62,0,8,449,525,1044,41335
2022-07-11 02:00:00,2022-07-11 03:00:00,56,0,8,581,566,1211,41543
2022-07-11 03:00:00,2022-07-11 04:00:00,22,0,10,676,706,1414,42468
2022-07-11 04:00:00,2022-07-11 05:00:00,41,0,54,677,819,1591,45077
2022-07-11 05:00:00,2022-07-11 06:00:00,132,0,172,537,747,1588,48092
2022-07-11 06:00:00,2022-07-11 07:00:00,129,0,315,537,581,1562,49203
2022-07-11 07:00:00,2022-07-11 08:00:00,132,0,346,349,620,1447,48527
2022-07-11 08:00:00,2022-07-11 09:00:00,131,0,434,277,548,1390,47526
2022-07-11 09:00:00,2022-07-11 10:00:00,128,0,470,247,439,1284,46435
2022-07-11 10:00:00,2022-07-11 11:00:00,144,0,523,230,443,1340,44303
2022-07-11 11:00:00,2022-07-11 12:00:00,165,0,564,173,459,1361,42385
2022-07-11 12:00:00,2022-07-11 13:00:00,143,0,611,136,480,1370,40982
2022-07-11 13:00:00,2022-07-11 14:00:00,116,0,593,113,447,1269,40567
2022-07-11 14:00:00,2022-07-11 15:00:00,81,0,585,139,459,1264,41598
2022-07-11 15:00:00,2022-07-11 16:00:00,74,0,517,79,457,1127,44915
2022-07-11 16:00:00,2022-07-11 17:00:00,84,0,286,82,432,884,46577
2022-07-11 17:00:00,2022-07-11 18:00:00,82,0,149,94,411,736,49559
2022-07-11 18:00:00,2022-07-11 19:00:00,78,0,57,128,404,667,51488
2022-07-11 19:00:00,2022-07-11 20:00:00,80,0,8,340,444,872,51746
2022-07-11 20:00:00,2022-07-11 21:00:00,81,0,4,301,472,858,51043
2022-07-11 21:00:00,2022-07-11 22:00:00,79,0,4,253,548,884,48290
2022-07-11 22:00:00,2022-07-11 23:00:00,69,0,4,613,580,1266,45816
2022-07-11 23:00:00,2022-07-12 00:00:00,67,0,4,836,916,1823,44112
2022-07-12 00:00:00,2022-07-12 01:00:00,63,0,4,820,981,1868,43225
2022-07-12 01:00:00,2022-07-12 02:00:00,63,0,4,910,856,1833,42678
2022-07-12 02:00:00,2022-07-12 03:00:00,63,0,4,853,808,1728,42606
2022-07-12 03:00:00,2022-07-12 04:00:00,63,0,18,719,762,1562,42687
2022-07-12 04:00:00,2022-07-12 05:00:00,60,0,95,695,681,1531,43560
2022-07-12 05:00:00,2022-07-12 06:00:00,60,0,248,792,646,1746,45198
2022-07-12 06:00:00,2022-07-12 07:00:00,63,0,497,861,662,2083,45109
2022-07-12 07:00:00,2022-07-12 08:00:00,62,0,794,1074,679,2609,43021
2022-07-12 08:00:00,2022-07-12 09:00:00,63,0,957,1000,660,2680,39598
2022-07-12 09:00:00,2022-07-12 10:00:00,62,0,1014,1098,582,2756,36802
2022-07-12 10:00:00,2022-07-12 11:00:00,61,0,1102,1305,542,3010,35523
2022-07-12 11:00:00,2022-07-12 12:00:00,60,0,1008,1424,565,3057,35696
2022-07-12 12:00:00,2022-07-12 13:00:00,61,0,1097,1652,468,3278,38496
2022-07-12 13:00:00,2022-07-12 14:00:00,60,0,778,1702,398,2938,42684
2022-07-12 14:00:00,2022-07-12 15:00:00,60,0,558,1535,489,2642,46965
2022-07-12 15:00:00,2022-07-12 16:00:00,61,0,423,1569,483,2536,51462
2022-07-12 16:00:00,2022-07-12 17:00:00,61,0,234,1169,398,1862,52400
2022-07-12 17:00:00,2022-07-12 18:00:00,61,0,159,1245,370,1835,52970
2022-07-12 18:00:00,2022-07-12 19:00:00,63,0,67,990,399,1519,53317
2022-07-12 19:00:00,2022-07-12 20:00:00,61,0,9,1086,506,1662,53351
2022-07-12 20:00:00,2022-07-12 21:00:00,63,0,8,1358,783,2212,52063
2022-07-12 21:00:00,2022-07-12 22:00:00,60,0,8,1581,1218,2867,49181
2022-07-12 22:00:00,2022-07-12 23:00:00,63,0,8,2007,1858,3936,46467
2022-07-12 23:00:00,2022-07-13 00:00:00,62,0,8,1836,2792,4698,44781
2022-07-13 00:00:00,2022-07-13 01:00:00,63,0,8,1951,2425,4447,43856
2022-07-13 01:00:00,2022-07-13 02:00:00,62,0,8,1676,3205,4951,43256
2022-07-13 02:00:00,2022-07-13 03:00:00,62,0,8,1171,3382,4623,43337
2022-07-13 03:00:00,2022-07-13 04:00:00,62,0,10,1306,2974,4352,43620
2022-07-13 04:00:00,2022-07-13 05:00:00,61,0,59,1916,2356,4392,46867
2022-07-13 05:00:00,2022-07-13 06:00:00,61,0,169,1410,1577,3217,49810
2022-07-13 06:00:00,2022-07-13 07:00:00,61,0,406,1115,786,2368,49324
2022-07-13 07:00:00,2022-07-13 08:00:00,61,0,675,944,616,2296,46443
2022-07-13 08:00:00,2022-07-13 09:00:00,62,0,925,1062,630,2679,43332
2022-07-13 09:00:00,2022-07-13 10:00:00,61,0,1062,1402,1008,3533,41186
2022-07-13 10:00:00,2022-07-13 11:00:00,62,0,1093,1679,1601,4435,39466
2022-07-13 11:00:00,2022-07-13 12:00:00,61,0,1042,2360,2028,5491,39146
2022-07-13 12:00:00,2022-07-13 13:00:00,60,0,1034,2451,2122,5667,40540
2022-07-13 13:00:00,2022-07-13 14:00:00,60,0,1095,1767,1941,4863,41706
2022-07-13 14:00:00,2022-07-13 15:00:00,60,0,979,1919,2289,5247,42588
2022-07-13 15:00:00,2022-07-13 16:00:00,63,0,800,1769,2579,5211,46210
2022-07-13 16:00:00,2022-07-13 17:00:00,61,0,535,1443,2568,4607,47987
2022-07-13 17:00:00,2022-07-13 18:00:00,62,0,278,1358,2126,3824,50237
2022-07-13 18:00:00,2022-07-13 19:00:00,62,0,108,1576,1488,3234,52284
2022-07-13 19:00:00,2022-07-13 20:00:00,63,0,15,1320,1129,2527,52924
2022-07-13 20:00:00,2022-07-13 21:00:00,63,0,8,1184,978,2233,52209
2022-07-13 21:00:00,2022-07-13 22:00:00,64,0,8,856,774,1702,49893
2022-07-13 22:00:00,2022-07-13 23:00:00,61,0,8,506,558,1133,46646
2022-07-13 23:00:00,2022-07-14 00:00:00,61,0,8,404,455,928,45001
2022-07-14 00:00:00,2022-07-14 01:00:00,64,0,8,381,423,876,44248
2022-07-14 01:00:00,2022-07-14 02:00:00,64,0,8,311,437,820,43841
2022-07-14 02:00:00,2022-07-14 03:00:00,64,0,8,352,471,895,43819
2022-07-14 03:00:00,2022-07-14 04:00:00,64,0,20,510,452,1046,43948
2022-07-14 04:00:00,2022-07-14 05:00:00,64,0,99,535,498,1196,44954
2022-07-14 05:00:00,2022-07-14 06:00:00,60,0,304,411,454,1229,45739
2022-07-14 06:00:00,2022-07-14 07:00:00,60,0,541,564,428,1593,44668
2022-07-14 07:00:00,2022-07-14 08:00:00,64,0,713,864,417,2058,42174
2022-07-14 08:00:00,2022-07-14 09:00:00,61,0,848,1255,439,2603,39202
2022-07-14 09:00:00,2022-07-14 10:00:00,62,0,783,1438,535,2818,37953
2022-07-14 10:00:00,2022-07-14 11:00:00,61,0,778,965,613,2417,38295
2022-07-14 11:00:00,2022-07-14 12:00:00,63,0,782,944,863,2652,37619
2022-07-14 12:00:00,2022-07-14 13:00:00,62,0,646,880,1183,2771,37173
2022-07-14 13:00:00,2022-07-14 14:00:00,62,0,526,1010,1666,3264,39714
2022-07-14 14:00:00,2022-07-14 15:00:00,60,0,613,1254,3277,5204,41884
2022-07-14 15:00:00,2022-07-14 16:00:00,62,0,545,1499,3582,5688,44971
2022-07-14 16:00:00,2022-07-14 17:00:00,63,0,430,1576,3079,5148,46333
2022-07-14 17:00:00,2022-07-14 18:00:00,64,0,218,2085,2776,5143,49228
2022-07-14 18:00:00,2022-07-14 19:00:00,64,0,92,2557,2632,5345,51307
2022-07-14 19:00:00,2022-07-14 20:00:00,64,0,9,2321,2500,4894,51525
2022-07-14 20:00:00,2022-07-14 21:00:00,64,0,4,2808,1798,4674,51058
2022-07-14 21:00:00,2022-07-14 22:00:00,63,0,4,2118,1437,3622,49043
2022-07-14 22:00:00,2022-07-14 23:00:00,64,0,4,2135,1312,3515,46328
2022-07-14 23:00:00,2022-07-15 00:00:00,64,0,4,2042,1295,3405,44428
2022-07-15 00:00:00,2022-07-15 01:00:00,64,0,4,1948,1476,3492,43587
2022-07-15 01:00:00,2022-07-15 02:00:00,64,0,4,2242,1465,3775,43081
2022-07-15 02:00:00,2022-07-15 03:00:00,64,0,4,2113,1080,3261,43163
2022-07-15 03:00:00,2022-07-15 04:00:00,64,0,13,1784,793,2654,43477
2022-07-15 04:00:00,2022-07-15 05:00:00,63,0,70,1580,695,2408,44356
2022-07-15 05:00:00,2022-07-15 06:00:00,63,0,196,1648,649,2556,45003
2022-07-15 06:00:00,2022-07-15 07:00:00,61,0,396,1198,586,2241,44226
2022-07-15 07:00:00,2022-07-15 08:00:00,60,0,599,652,632,1943,41963
2022-07-15 08:00:00,2022-07-15 09:00:00,59,0,596,829,883,2367,40147
2022-07-15 09:00:00,2022-07-15 10:00:00,60,0,607,1303,1074,3044,38673
2022-07-15 10:00:00,2022-07-15 11:00:00,60,0,685,1193,1193,3131,37761
2022-07-15 11:00:00,2022-07-15 12:00:00,60,0,532,840,1434,2866,38383
2022-07-15 12:00:00,2022-07-15 13:00:00,63,0,488,867,1718,3136,39894
2022-07-15 13:00:00,2022-07-15 14:00:00,62,0,530,963,1959,3514,39838
2022-07-15 14:00:00,2022-07-15 15:00:00,62,0,568,1076,1936,3642,40538
2022-07-15 15:00:00,2022-07-15 16:00:00,62,0,461,1415,1940,3878,43066
2022-07-15 16:00:00,2022-07-15 17:00:00,64,0,338,1566,2126,4094,45197
2022-07-15 17:00:00,2022-07-15 18:00:00,64,0,158,1945,1916,4083,48203
2022-07-15 18:00:00,2022-07-15 19:00:00,64,0,56,1565,1559,3244,49885
2022-07-15 19:00:00,2022-07-15 20:00:00,64,0,5,1855,1618,3542,49576
2022-07-15 20:00:00,2022-07-15 21:00:00,64,0,4,3264,2111,5443,48773
2022-07-15 21:00:00,2022-07-15 22:00:00,62,0,4,2489,2338,4893,46663
2022-07-15 22:00:00,2022-07-15 23:00:00,63,0,4,2972,3107,6146,44129
2022-07-15 23:00:00,2022-07-16 00:00:00,64,0,4,2929,3765,6762,42342
2022-07-16 00:00:00,2022-07-16 01:00:00,64,0,4,3122,3253,6443,41450
2022-07-16 01:00:00,2022-07-16 02:00:00,64,0,4,3467,2748,6283,40615
2022-07-16 02:00:00,2022-07-16 03:00:00,64,0,4,3990,2811,6869,40351
2022-07-16 03:00:00,2022-07-16 04:00:00,64,0,13,3253,3127,6457,39949
2022-07-16 04:00:00,2022-07-16 05:00:00,63,0,91,3007,3569,6730,39508
2022-07-16 05:00:00,2022-07-16 06:00:00,62,0,278,2788,3093,6221,38223
2022-07-16 06:00:00,2022-07-16 07:00:00,60,0,521,2503,3014,6098,36598
2022-07-16 07:00:00,2022-07-16 08:00:00,58,0,685,2072,2804,5619,34827
2022-07-16 08:00:00,2022-07-16 09:00:00,60,0,686,1421,2124,4291,32040
2022-07-16 09:00:00,2022-07-16 10:00:00,60,0,865,1491,1881,4297,29843
2022-07-16 10:00:00,2022-07-16 11:00:00,63,0,912,1218,1423,3616,28095
2022-07-16 11:00:00,2022-07-16 12:00:00,63,0,934,819,1465,3281,26513
2022-07-16 12:00:00,2022-07-16 13:00:00,63,0,856,802,1400,3121,25853
2022-07-16 13:00:00,2022-07-16 14:00:00,60,0,805,997,1248,3110,26636
2022-07-16 14:00:00,2022-07-16 15:00:00,61,0,788,635,1128,2612,29325
2022-07-16 15:00:00,2022-07-16 16:00:00,64,0,732,1028,1202,3026,34510
2022-07-16 16:00:00,2022-07-16 17:00:00,62,0,587,1026,1089,2764,38535
2022-07-16 17:00:00,2022-07-16 18:00:00,64,0,287,982,1046,2379,42107
2022-07-16 18:00:00,2022-07-16 19:00:00,64,0,77,892,875,1908,45148
2022-07-16 19:00:00,2022-07-16 20:00:00,64,0,9,756,751,1580,46554
2022-07-16 20:00:00,2022-07-16 21:00:00,63,0,4,623,591,1281,46427
2022-07-16 21:00:00,2022-07-16 22:00:00,63,0,4,548,515,1130,44774
2022-07-16 22:00:00,2022-07-16 23:00:00,62,0,4,434,465,965,42953
2022-07-16 23:00:00,2022-07-17 00:00:00,64,0,4,203,471,742,41351
2022-07-17 00:00:00,2022-07-17 01:00:00,64,0,4,216,469,753,40452
2022-07-17 01:00:00,2022-07-17 02:00:00,64,0,4,173,485,726,39894
2022-07-17 02:00:00,2022-07-17 03:00:00,64,0,4,99,472,639,39647
2022-07-17 03:00:00,2022-07-17 04:00:00,64,0,9,72,437,582,38870
2022-07-17 04:00:00,2022-07-17 05:00:00,63,0,78,127,435,703,36810
2022-07-17 05:00:00,2022-07-17 06:00:00,60,0,215,237,431,943,34299
2022-07-17 06:00:00,2022-07-17 07:00:00,60,0,556,286,405,1307,32287
2022-07-17 07:00:00,2022-07-17 08:00:00,60,0,566,439,395,1460,30056
2022-07-17 08:00:00,2022-07-17 09:00:00,63,0,1001,251,390,1705,27213
2022-07-17 09:00:00,2022-07-17 10:00:00,63,0,1179,290,401,1933,25193
2022-07-17 10:00:00,2022-07-17 11:00:00,61,0,1206,390,458,2115,23985
2022-07-17 11:00:00,2022-07-17 12:00:00,62,0,1211,524,413,2210,23429
2022-07-17 12:00:00,2022-07-17 13:00:00,60,0,1210,527,437,2234,23844
2022-07-17 13:00:00,2022-07-17 14:00:00,60,0,1163,402,394,2019,25798
2022-07-17 14:00:00,2022-07-17 15:00:00,60,0,971,430,397,1858,29903
2022-07-17 15:00:00,2022-07-17 16:00:00,61,0,745,491,428,1725,35605
2022-07-17 16:00:00,2022-07-17 17:00:00,61,0,580,537,457,1635,39491
2022-07-17 17:00:00,2022-07-17 18:00:00,61,0,314,391,505,1271,42733
2022-07-17 18:00:00,2022-07-17 19:00:00,61,0,74,308,553,996,45819
2022-07-17 19:00:00,2022-07-17 20:00:00,62,0,7,343,656,1068,47852
2022-07-17 20:00:00,2022-07-17 21:00:00,61,0,4,380,659,1104,47773
2022-07-17 21:00:00,2022-07-17 22:00:00,60,0,4,452,583,1099,45769
2022-07-17 22:00:00,2022-07-17 23:00:00,62,0,4,652,654,1372,43924
2022-07-17 23:00:00,2022-07-18 00:00:00,62,0,4,1165,886,2117,42122
2022-07-18 00:00:00,2022-07-18 01:00:00,62,0,4,1653,1178,2897,41327
2022-07-18 01:00:00,2022-07-18 02:00:00,63,0,4,2349,1258,3674,40772
2022-07-18 02:00:00,2022-07-18 03:00:00,64,0,4,2779,1561,4408,40882
2022-07-18 03:00:00,2022-07-18 04:00:00,63,0,19,2801,1786,4669,41875
2022-07-18 04:00:00,2022-07-18 05:00:00,63,0,106,2127,1650,3946,43859
2022-07-18 05:00:00,2022-07-18 06:00:00,57,0,242,1887,1686,3872,45131
2022-07-18 06:00:00,2022-07-18 07:00:00,58,0,528,1759,1143,3488,44703
2022-07-18 07:00:00,2022-07-18 08:00:00,60,0,770,1292,587,2709,41996
2022-07-18 08:00:00,2022-07-18 09:00:00,62,0,857,1176,499,2594,39876
2022-07-18 09:00:00,2022-07-18 10:00:00,61,0,948,1090,460,2559,37964
2022-07-18 10:00:00,2022-07-18 11:00:00,62,0,1160,1280,400,2902,36438
2022-07-18 11:00:00,2022-07-18 12:00:00,62,0,1215,1113,396,2786,36098
2022-07-18 12:00:00,2022-07-18 13:00:00,61,0,1211,974,388,2634,36160
2022-07-18 13:00:00,2022-07-18 14:00:00,60,0,1073,705,384,2222,37721
2022-07-18 14:00:00,2022-07-18 15:00:00,60,0,997,397,381,1835,40756
2022-07-18 15:00:00,2022-07-18 16:00:00,63,0,899,293,376,1631,45485
2022-07-18 16:00:00,2022-07-18 17:00:00,63,0,643,180,364,1250,48471
2022-07-18 17:00:00,2022-07-18 18:00:00,64,0,304,324,369,1061,51491
2022-07-18 18:00:00,2022-07-18 19:00:00,63,0,83,359,367,872,54233
2022-07-18 19:00:00,2022-07-18 20:00:00,64,0,9,642,394,1109,54558
2022-07-18 20:00:00,2022-07-18 21:00:00,63,0,8,955,519,1545,53422
2022-07-18 21:00:00,2022-07-18 22:00:00,61,0,8,1337,631,2037,50759
2022-07-18 22:00:00,2022-07-18 23:00:00,64,0,8,1446,916,2434,48107
2022-07-18 23:00:00,2022-07-19 00:00:00,64,0,8,1440,1050,2562,46384
2022-07-19 00:00:00,2022-07-19 01:00:00,64,0,8,1639,1075,2786,45098
2022-07-19 01:00:00,2022-07-19 02:00:00,64,0,8,1857,1261,3190,44496
2022-07-19 02:00:00,2022-07-19 03:00:00,64,0,8,2031,1423,3526,44679
2022-07-19 03:00:00,2022-07-19 04:00:00,64,0,16,1967,1436,3483,45566
2022-07-19 04:00:00,2022-07-19 05:00:00,64,0,90,1791,1382,3327,47060
2022-07-19 05:00:00,2022-07-19 06:00:00,60,0,293,1948,1271,3572,47847
2022-07-19 06:00:00,2022-07-19 07:00:00,57,0,578,2215,1140,3990,47547
2022-07-19 07:00:00,2022-07-19 08:00:00,61,0,789,1851,874,3575,45362
2022-07-19 08:00:00,2022-07-19 09:00:00,62,0,972,1596,627,3257,42449
2022-07-19 09:00:00,2022-07-19 10:00:00,59,0,1106,1344,656,3165,40196
2022-07-19 10:00:00,2022-07-19 11:00:00,56,0,1174,1153,912,3295,38305
2022-07-19 11:00:00,2022-07-19 12:00:00,60,0,1192,912,1187,3351,37537
2022-07-19 12:00:00,2022-07-19 13:00:00,61,0,1165,936,1345,3507,37749
2022-07-19 13:00:00,2022-07-19 14:00:00,60,0,1150,1283,1277,3770,39324
2022-07-19 14:00:00,2022-07-19 15:00:00,60,0,1034,1481,1228,3803,42471
2022-07-19 15:00:00,2022-07-19 16:00:00,63,0,837,1850,1339,4089,47043
2022-07-19 16:00:00,2022-07-19 17:00:00,64,0,582,1998,1297,3941,49649
2022-07-19 17:00:00,2022-07-19 18:00:00,64,0,285,2222,1159,3730,52663
2022-07-19 18:00:00,2022-07-19 19:00:00,64,0,86,2667,1507,4324,54998
2022-07-19 19:00:00,2022-07-19 20:00:00,64,0,8,2986,2210,5268,55809
2022-07-19 20:00:00,2022-07-19 21:00:00,64,0,4,3389,3130,6587,53902
2022-07-19 21:00:00,2022-07-19 22:00:00,63,0,4,4108,3728,7903,50545
2022-07-19 22:00:00,2022-07-19 23:00:00,61,0,4,4380,4052,8497,47732
2022-07-19 23:00:00,2022-07-20 00:00:00,63,0,4,5024,3966,9057,46365
2022-07-20 00:00:00,2022-07-20 01:00:00,64,0,4,6732,5059,11859,45538
2022-07-20 01:00:00,2022-07-20 02:00:00,64,0,4,5202,4890,10160,44794
2022-07-20 02:00:00,2022-07-20 03:00:00,64,0,4,5327,3945,9340,44945
2022-07-20 03:00:00,2022-07-20 04:00:00,64,0,13,5833,3390,9300,45970
2022-07-20 04:00:00,2022-07-20 05:00:00,64,0,96,5732,2795,8687,47450
2022-07-20 05:00:00,2022-07-20 06:00:00,63,0,312,7222,3022,10619,49014
2022-07-20 06:00:00,2022-07-20 07:00:00,60,0,616,7704,3298,11678,49729
2022-07-20 07:00:00,2022-07-20 08:00:00,62,0,859,5125,4176,10222,46907
2022-07-20 08:00:00,2022-07-20 09:00:00,64,0,1033,4198,3985,9280,45059
2022-07-20 09:00:00,2022-07-20 10:00:00,61,0,1146,3708,3018,7933,42974
2022-07-20 10:00:00,2022-07-20 11:00:00,62,0,1236,2570,2817,6685,40830
2022-07-20 11:00:00,2022-07-20 12:00:00,60,0,1258,2929,2370,6617,40309
2022-07-20 12:00:00,2022-07-20 13:00:00,60,0,1223,3425,1779,6487,42183
2022-07-20 13:00:00,2022-07-20 14:00:00,60,0,1117,2699,2207,6083,42880
2022-07-20 14:00:00,2022-07-20 15:00:00,60,0,950,2447,1987,5444,45018
2022-07-20 15:00:00,2022-07-20 16:00:00,64,0,712,2340,1362,4478,48738
2022-07-20 16:00:00,2022-07-20 17:00:00,64,0,413,2188,1098,3763,50580
2022-07-20 17:00:00,2022-07-20 18:00:00,64,0,96,1996,1315,3471,53119
2022-07-20 18:00:00,2022-07-20 19:00:00,64,0,46,2179,1604,3893,54565
2022-07-20 19:00:00,2022-07-20 20:00:00,64,0,10,1852,1590,3516,54837
2022-07-20 20:00:00,2022-07-20 21:00:00,64,0,8,1790,1248,3110,53258
2022-07-20 21:00:00,2022-07-20 22:00:00,63,0,8,2883,1240,4194,50441
2022-07-20 22:00:00,2022-07-20 23:00:00,63,0,8,3315,1420,4806,47758
2022-07-20 23:00:00,2022-07-21 00:00:00,64,0,8,3074,1224,4370,45990
2022-07-21 00:00:00,2022-07-21 01:00:00,64,0,8,2346,970,3388,44894
2022-07-21 01:00:00,2022-07-21 02:00:00,64,0,8,2075,1223,3370,44254
2022-07-21 02:00:00,2022-07-21 03:00:00,64,0,8,3013,1153,4238,44449
2022-07-21 03:00:00,2022-07-21 04:00:00,64,0,8,2717,1002,3791,45370
2022-07-21 04:00:00,2022-07-21 05:00:00,64,0,42,2714,1067,3887,47786
2022-07-21 05:00:00,2022-07-21 06:00:00,60,0,156,2599,1169,3984,50826
2022-07-21 06:00:00,2022-07-21 07:00:00,60,0,182,2561,1386,4189,53183
2022-07-21 07:00:00,2022-07-21 08:00:00,60,0,387,3215,1546,5208,54926
2022-07-21 08:00:00,2022-07-21 09:00:00,60,0,597,3222,1543,5422,55080
2022-07-21 09:00:00,2022-07-21 10:00:00,59,0,557,3661,1816,6093,55417
2022-07-21 10:00:00,2022-07-21 11:00:00,59,0,429,4178,2018,6684,55515
2022-07-21 11:00:00,2022-07-21 12:00:00,59,0,536,4701,2104,7400,54872
2022-07-21 12:00:00,2022-07-21 13:00:00,59,0,497,5838,2150,8544,53286
2022-07-21 13:00:00,2022-07-21 14:00:00,62,0,595,5915,2716,9288,52906
2022-07-21 14:00:00,2022-07-21 15:00:00,60,0,507,5449,3804,9820,53146
2022-07-21 15:00:00,2022-07-21 16:00:00,59,0,475,5060,5140,10734,54705
2022-07-21 16:00:00,2022-07-21 17:00:00,61,0,210,4728,5691,10690,53714
2022-07-21 17:00:00,2022-07-21 18:00:00,62,0,84,4291,4830,9267,52827
2022-07-21 18:00:00,2022-07-21 19:00:00,61,0,16,3462,3753,7292,51668
2022-07-21 19:00:00,2022-07-21 20:00:00,60,0,4,3377,3091,6532,50590
2022-07-21 20:00:00,2022-07-21 21:00:00,63,0,4,3341,2606,6014,49474
2022-07-21 21:00:00,2022-07-21 22:00:00,62,0,4,2789,2234,5089,47844
2022-07-21 22:00:00,2022-07-21 23:00:00,60,0,4,2571,1952,4587,45428
2022-07-21 23:00:00,2022-07-22 00:00:00,64,0,4,2428,1602,4098,43762
2022-07-22 00:00:00,2022-07-22 01:00:00,63,0,4,2089,1300,3456,42896
2022-07-22 01:00:00,2022-07-22 02:00:00,62,0,4,1573,1293,2932,42510
2022-07-22 02:00:00,2022-07-22 03:00:00,62,0,4,1423,1082,2571,42798
2022-07-22 03:00:00,2022-07-22 04:00:00,61,0,5,1388,1040,2494,43887
2022-07-22 04:00:00,2022-07-22 05:00:00,60,0,50,1100,667,1877,45715
2022-07-22 05:00:00,2022-07-22 06:00:00,60,0,148,986,625,1819,47861
2022-07-22 06:00:00,2022-07-22 07:00:00,61,0,285,809,581,1736,48359
2022-07-22 07:00:00,2022-07-22 08:00:00,62,0,464,846,568,1940,47566
2022-07-22 08:00:00,2022-07-22 09:00:00,60,0,481,705,735,1981,45341
2022-07-22 09:00:00,2022-07-22 10:00:00,60,0,539,690,599,1888,43309
2022-07-22 10:00:00,2022-07-22 11:00:00,62,0,629,593,453,1737,41129
2022-07-22 11:00:00,2022-07-22 12:00:00,63,0,517,532,507,1619,40356
2022-07-22 12:00:00,2022-07-22 13:00:00,62,0,574,730,555,1921,39954
2022-07-22 13:00:00,2022-07-22 14:00:00,61,0,599,994,595,2249,41088
2022-07-22 14:00:00,2022-07-22 15:00:00,61,0,404,1215,664,2344,42372
2022-07-22 15:00:00,2022-07-22 16:00:00,64,0,298,1284,755,2401,45494
2022-07-22 16:00:00,2022-07-22 17:00:00,63,0,194,1379,886,2522,46932
2022-07-22 17:00:00,2022-07-22 18:00:00,63,0,109,1505,834,2511,48615
2022-07-22 18:00:00,2022-07-22 19:00:00,64,0,48,1468,728,2308,49345
2022-07-22 19:00:00,2022-07-22 20:00:00,63,0,9,1035,677,1784,49346
2022-07-22 20:00:00,2022-07-22 21:00:00,61,0,4,653,589,1307,48406
2022-07-22 21:00:00,2022-07-22 22:00:00,61,0,4,656,558,1279,46453
2022-07-22 22:00:00,2022-07-22 23:00:00,60,0,4,596,509,1169,43952
2022-07-22 23:00:00,2022-07-23 00:00:00,64,0,4,591,532,1191,42383
2022-07-23 00:00:00,2022-07-23 01:00:00,61,0,4,376,513,954,41595
2022-07-23 01:00:00,2022-07-23 02:00:00,62,0,4,160,472,698,40707
2022-07-23 02:00:00,2022-07-23 03:00:00,62,0,4,139,428,633,40324
2022-07-23 03:00:00,2022-07-23 04:00:00,60,0,9,209,447,725,39889
2022-07-23 04:00:00,2022-07-23 05:00:00,61,0,92,332,553,1038,38741
2022-07-23 05:00:00,2022-07-23 06:00:00,60,0,294,478,613,1445,36764
2022-07-23 06:00:00,2022-07-23 07:00:00,60,0,558,343,535,1496,35320
2022-07-23 07:00:00,2022-07-23 08:00:00,62,0,809,478,487,1836,33533
2022-07-23 08:00:00,2022-07-23 09:00:00,60,0,854,337,493,1744,30935
2022-07-23 09:00:00,2022-07-23 10:00:00,61,0,1011,303,494,1869,28524
2022-07-23 10:00:00,2022-07-23 11:00:00,60,0,991,246,516,1813,26869
2022-07-23 11:00:00,2022-07-23 12:00:00,60,0,1001,141,535,1737,25790
2022-07-23 12:00:00,2022-07-23 13:00:00,61,0,1013,98,531,1703,26133
2022-07-23 13:00:00,2022-07-23 14:00:00,61,0,965,94,503,1623,28116
2022-07-23 14:00:00,2022-07-23 15:00:00,60,0,952,94,484,1590,31836
2022-07-23 15:00:00,2022-07-23 16:00:00,60,0,829,100,438,1427,36304
2022-07-23 16:00:00,2022-07-23 17:00:00,64,0,580,116,408,1168,39943
2022-07-23 17:00:00,2022-07-23 18:00:00,62,0,245,498,407,1212,43222
2022-07-23 18:00:00,2022-07-23 19:00:00,62,0,76,966,427,1531,45935
2022-07-23 19:00:00,2022-07-23 20:00:00,62,0,5,1354,481,1902,47095
2022-07-23 20:00:00,2022-07-23 21:00:00,62,0,4,2023,789,2878,46779
2022-07-23 21:00:00,2022-07-23 22:00:00,60,0,4,2854,1169,4087,45085
2022-07-23 22:00:00,2022-07-23 23:00:00,60,0,4,3373,1681,5118,42766
2022-07-23 23:00:00,2022-07-24 00:00:00,64,0,4,3550,2280,5898,41089
2022-07-24 00:00:00,2022-07-24 01:00:00,64,0,4,3593,2480,6141,39857
2022-07-24 01:00:00,2022-07-24 02:00:00,63,0,4,3410,2633,6110,39262
2022-07-24 02:00:00,2022-07-24 03:00:00,64,0,4,3655,2142,5865,38929
2022-07-24 03:00:00,2022-07-24 04:00:00,62,0,15,3834,1976,5887,38294
2022-07-24 04:00:00,2022-07-24 05:00:00,60,0,79,4032,2220,6391,37168
2022-07-24 05:00:00,2022-07-24 06:00:00,60,0,282,4106,2350,6798,34782
2022-07-24 06:00:00,2022-07-24 07:00:00,60,0,578,4303,2237,7178,33552
2022-07-24 07:00:00,2022-07-24 08:00:00,63,0,875,4494,2132,7564,31164
2022-07-24 08:00:00,2022-07-24 09:00:00,60,0,801,3916,2587,7364,28742
2022-07-24 09:00:00,2022-07-24 10:00:00,62,0,598,2622,2337,5619,26730
2022-07-24 10:00:00,2022-07-24 11:00:00,64,0,618,2382,2159,5223,25392
2022-07-24 11:00:00,2022-07-24 12:00:00,64,0,613,995,1951,3623,24503
2022-07-24 12:00:00,2022-07-24 13:00:00,63,0,719,1629,1852,4263,26286
2022-07-24 13:00:00,2022-07-24 14:00:00,60,0,992,2910,2033,5995,26679
2022-07-24 14:00:00,2022-07-24 15:00:00,60,0,1101,3416,2227,6804,30232
2022-07-24 15:00:00,2022-07-24 16:00:00,60,0,878,3388,1673,5999,35593
2022-07-24 16:00:00,2022-07-24 17:00:00,60,0,597,2687,1686,5030,40299
2022-07-24 17:00:00,2022-07-24 18:00:00,60,0,282,2413,1336,4091,44385
2022-07-24 18:00:00,2022-07-24 19:00:00,60,0,83,2081,943,3167,47519
2022-07-24 19:00:00,2022-07-24 20:00:00,61,0,5,1475,1100,2641,48854
2022-07-24 20:00:00,2022-07-24 21:00:00,64,0,4,1315,1528,2911,48845
2022-07-24 21:00:00,2022-07-24 22:00:00,60,0,4,1675,2022,3761,46906
2022-07-24 22:00:00,2022-07-24 23:00:00,61,0,4,1448,2060,3573,44459
2022-07-24 23:00:00,2022-07-25 00:00:00,64,0,4,1136,2180,3384,43187
2022-07-25 00:00:00,2022-07-25 01:00:00,64,0,4,782,1698,2548,42602
2022-07-25 01:00:00,2022-07-25 02:00:00,64,0,4,1349,985,2402,42523
2022-07-25 02:00:00,2022-07-25 03:00:00,64,0,4,2307,1119,3494,42887
2022-07-25 03:00:00,2022-07-25 04:00:00,64,0,7,2503,1613,4187,43523
2022-07-25 04:00:00,2022-07-25 05:00:00,63,0,108,3092,1826,5089,45103
2022-07-25 05:00:00,2022-07-25 06:00:00,60,0,283,4055,2211,6609,47160
2022-07-25 06:00:00,2022-07-25 07:00:00,59,0,493,4685,2532,7769,48827
2022-07-25 07:00:00,2022-07-25 08:00:00,63,0,631,4833,2695,8222,47539
2022-07-25 08:00:00,2022-07-25 09:00:00,60,0,584,6456,3374,10474,44487
2022-07-25 09:00:00,2022-07-25 10:00:00,60,0,654,7501,4429,12644,42622
2022-07-25 10:00:00,2022-07-25 11:00:00,61,0,695,8020,5545,14321,42911
2022-07-25 11:00:00,2022-07-25 12:00:00,60,0,737,7894,5971,14662,43653
2022-07-25 12:00:00,2022-07-25 13:00:00,60,0,783,8052,6693,15588,42493
2022-07-25 13:00:00,2022-07-25 14:00:00,60,0,682,8045,7301,16088,41678
2022-07-25 14:00:00,2022-07-25 15:00:00,61,0,783,8203,7193,16240,42265
2022-07-25 15:00:00,2022-07-25 16:00:00,61,0,629,8388,7232,16310,46446
2022-07-25 16:00:00,2022-07-25 17:00:00,60,0,364,7973,7213,15610,48300
2022-07-25 17:00:00,2022-07-25 18:00:00,61,0,161,8095,6712,15029,50058
2022-07-25 18:00:00,2022-07-25 19:00:00,60,0,45,7402,5733,13240,50405
2022-07-25 19:00:00,2022-07-25 20:00:00,61,0,5,6554,5314,11934,50201
2022-07-25 20:00:00,2022-07-25 21:00:00,62,0,4,5122,4885,10073,49009
2022-07-25 21:00:00,2022-07-25 22:00:00,61,0,4,3079,4123,7267,46850
2022-07-25 22:00:00,2022-07-25 23:00:00,61,0,4,3753,3403,7221,44443
2022-07-25 23:00:00,2022-07-26 00:00:00,64,0,4,5859,3072,8999,43267
2022-07-26 00:00:00,2022-07-26 01:00:00,62,0,4,5476,2836,8378,42675
2022-07-26 01:00:00,2022-07-26 02:00:00,64,0,4,4017,2604,6689,41956
2022-07-26 02:00:00,2022-07-26 03:00:00,64,0,4,3569,2498,6135,42109
2022-07-26 03:00:00,2022-07-26 04:00:00,64,0,6,3318,2135,5523,42492
2022-07-26 04:00:00,2022-07-26 05:00:00,62,0,83,2969,2057,5171,44559
2022-07-26 05:00:00,2022-07-26 06:00:00,59,0,168,3698,2078,6003,47029
2022-07-26 06:00:00,2022-07-26 07:00:00,63,0,339,4040,2279,6721,48504
2022-07-26 07:00:00,2022-07-26 08:00:00,64,0,486,4256,2256,7062,47005
2022-07-26 08:00:00,2022-07-26 09:00:00,64,0,683,3766,2312,6825,45474
2022-07-26 09:00:00,2022-07-26 10:00:00,63,0,716,3143,2683,6605,44540
2022-07-26 10:00:00,2022-07-26 11:00:00,64,0,719,2918,2295,5996,42689
2022-07-26 11:00:00,2022-07-26 12:00:00,64,0,754,2400,2239,5457,41661
2022-07-26 12:00:00,2022-07-26 13:00:00,61,0,781,2185,2354,5381,40994
2022-07-26 13:00:00,2022-07-26 14:00:00,60,0,844,2150,2427,5481,40957
2022-07-26 14:00:00,2022-07-26 15:00:00,60,0,865,2186,2765,5876,42246
2022-07-26 15:00:00,2022-07-26 16:00:00,60,0,657,1999,2751,5467,45246
2022-07-26 16:00:00,2022-07-26 17:00:00,60,0,406,1970,2617,5053,46754
2022-07-26 17:00:00,2022-07-26 18:00:00,60,0,194,2305,2287,4846,47949
2022-07-26 18:00:00,2022-07-26 19:00:00,60,0,61,2035,1906,4062,48766
2022-07-26 19:00:00,2022-07-26 20:00:00,60,0,5,1592,1944,3601,48954
2022-07-26 20:00:00,2022-07-26 21:00:00,61,0,4,1399,1641,3105,48274
2022-07-26 21:00:00,2022-07-26 22:00:00,61,0,4,1414,1308,2787,46487
2022-07-26 22:00:00,2022-07-26 23:00:00,61,0,4,1428,1089,2582,44144
2022-07-26 23:00:00,2022-07-27 00:00:00,61,0,4,1262,1092,2419,42826
2022-07-27 00:00:00,2022-07-27 01:00:00,60,0,4,951,1416,2431,41957
2022-07-27 01:00:00,2022-07-27 02:00:00,60,0,4,1223,1304,2591,41488
2022-07-27 02:00:00,2022-07-27 03:00:00,60,0,4,1561,1421,3046,41430
2022-07-27 03:00:00,2022-07-27 04:00:00,60,0,8,1828,1360,3256,42159
2022-07-27 04:00:00,2022-07-27 05:00:00,60,0,72,2135,1258,3525,43631
2022-07-27 05:00:00,2022-07-27 06:00:00,60,0,216,1983,1176,3435,44296
2022-07-27 06:00:00,2022-07-27 07:00:00,60,0,381,1400,923,2764,43087
2022-07-27 07:00:00,2022-07-27 08:00:00,62,0,641,1243,1019,2965,41418
2022-07-27 08:00:00,2022-07-27 09:00:00,61,0,700,1329,1047,3137,39728
2022-07-27 09:00:00,2022-07-27 10:00:00,61,0,827,1098,1194,3180,38317
2022-07-27 10:00:00,2022-07-27 11:00:00,60,0,915,889,1209,3073,37203
2022-07-27 11:00:00,2022-07-27 12:00:00,61,0,876,804,1241,2982,37420
2022-07-27 12:00:00,2022-07-27 13:00:00,60,0,911,1102,1438,3511,37906
2022-07-27 13:00:00,2022-07-27 14:00:00,61,0,787,1173,1557,3578,37816
2022-07-27 14:00:00,2022-07-27 15:00:00,60,0,656,1344,1749,3809,39672
2022-07-27 15:00:00,2022-07-27 16:00:00,61,0,696,1472,1936,4165,43347
2022-07-27 16:00:00,2022-07-27 17:00:00,61,0,465,1621,2227,4374,44795
2022-07-27 17:00:00,2022-07-27 18:00:00,62,0,196,1877,2185,4320,46871
2022-07-27 18:00:00,2022-07-27 19:00:00,62,0,53,2441,1959,4515,48543
2022-07-27 19:00:00,2022-07-27 20:00:00,61,0,4,2438,1639,4142,49297
2022-07-27 20:00:00,2022-07-27 21:00:00,62,0,4,2433,1683,4182,48180
2022-07-27 21:00:00,2022-07-27 22:00:00,61,0,4,2579,1629,4273,45826
2022-07-27 22:00:00,2022-07-27 23:00:00,61,0,4,2835,1654,4554,43659
2022-07-27 23:00:00,2022-07-28 00:00:00,63,0,4,3157,1664,4888,42051
2022-07-28 00:00:00,2022-07-28 01:00:00,63,0,4,3138,1580,4785,41192
2022-07-28 01:00:00,2022-07-28 02:00:00,63,0,4,3172,1422,4661,40741
2022-07-28 02:00:00,2022-07-28 03:00:00,62,0,4,2810,1401,4277,40785
2022-07-28 03:00:00,2022-07-28 04:00:00,62,0,3,2860,1489,4414,41502
2022-07-28 04:00:00,2022-07-28 05:00:00,62,0,40,2947,1462,4511,42709
2022-07-28 05:00:00,2022-07-28 06:00:00,61,0,180,2933,1259,4433,43150
2022-07-28 06:00:00,2022-07-28 07:00:00,61,0,368,2694,1131,4254,42559
2022-07-28 07:00:00,2022-07-28 08:00:00,62,0,570,2686,1217,4535,39231
2022-07-28 08:00:00,2022-07-28 09:00:00,62,0,696,2462,1517,4737,35826
2022-07-28 09:00:00,2022-07-28 10:00:00,60,0,817,2407,1766,5050,33625
2022-07-28 10:00:00,2022-07-28 11:00:00,61,0,1013,2594,1859,5527,32298
2022-07-28 11:00:00,2022-07-28 12:00:00,60,0,961,2792,1671,5484,31925
2022-07-28 12:00:00,2022-07-28 13:00:00,59,0,1054,2707,1846,5666,33246
2022-07-28 13:00:00,2022-07-28 14:00:00,60,0,937,3052,1994,6043,36019
2022-07-28 14:00:00,2022-07-28 15:00:00,61,0,871,3059,2118,6109,39446
2022-07-28 15:00:00,2022-07-28 16:00:00,64,0,741,3337,2287,6429,44256
2022-07-28 16:00:00,2022-07-28 17:00:00,64,0,546,3574,2415,6599,46255
2022-07-28 17:00:00,2022-07-28 18:00:00,63,0,207,3245,2660,6175,47906
2022-07-28 18:00:00,2022-07-28 19:00:00,64,0,58,3247,2877,6246,48952
2022-07-28 19:00:00,2022-07-28 20:00:00,64,0,4,3693,3315,7076,49085
2022-07-28 20:00:00,2022-07-28 21:00:00,64,0,4,3769,3577,7414,47593
2022-07-28 21:00:00,2022-07-28 22:00:00,63,0,4,3442,3676,7185,45599
2022-07-28 22:00:00,2022-07-28 23:00:00,63,0,4,3072,3665,6804,43462
2022-07-28 23:00:00,2022-07-29 00:00:00,64,0,4,2727,3498,6293,41973
2022-07-29 00:00:00,2022-07-29 01:00:00,64,0,4,2275,3353,5696,41103
2022-07-29 01:00:00,2022-07-29 02:00:00,63,0,4,1739,3398,5204,40662
2022-07-29 02:00:00,2022-07-29 03:00:00,64,0,4,1354,2833,4255,40720
2022-07-29 03:00:00,2022-07-29 04:00:00,63,0,4,1126,2558,3751,41607
2022-07-29 04:00:00,2022-07-29 05:00:00,62,0,63,1321,2257,3703,43035
2022-07-29 05:00:00,2022-07-29 06:00:00,60,0,187,1201,1770,3218,44623
2022-07-29 06:00:00,2022-07-29 07:00:00,61,0,327,1189,1265,2842,44599
2022-07-29 07:00:00,2022-07-29 08:00:00,64,0,535,1263,931,2793,42380
2022-07-29 08:00:00,2022-07-29 09:00:00,64,0,640,1405,683,2792,39350
2022-07-29 09:00:00,2022-07-29 10:00:00,64,0,690,1475,641,2870,37015
2022-07-29 10:00:00,2022-07-29 11:00:00,61,0,697,1587,678,3023,34353
2022-07-29 11:00:00,2022-07-29 12:00:00,62,0,725,1632,821,3240,32377
2022-07-29 12:00:00,2022-07-29 13:00:00,60,0,798,1740,687,3285,31966
2022-07-29 13:00:00,2022-07-29 14:00:00,60,0,946,2073,751,3830,33365
2022-07-29 14:00:00,2022-07-29 15:00:00,62,0,891,2205,830,3988,36369
2022-07-29 15:00:00,2022-07-29 16:00:00,64,0,696,2124,1000,3884,40417
2022-07-29 16:00:00,2022-07-29 17:00:00,64,0,533,1963,1194,3754,43282
2022-07-29 17:00:00,2022-07-29 18:00:00,64,0,256,1656,1335,3311,46108
2022-07-29 18:00:00,2022-07-29 19:00:00,64,0,56,1583,1408,3111,47953
2022-07-29 19:00:00,2022-07-29 20:00:00,64,0,5,1380,1331,2780,48167
2022-07-29 20:00:00,2022-07-29 21:00:00,64,0,4,960,1177,2205,47271
2022-07-29 21:00:00,2022-07-29 22:00:00,60,0,4,589,923,1576,45697
2022-07-29 22:00:00,2022-07-29 23:00:00,63,0,4,303,792,1162,43183
2022-07-29 23:00:00,2022-07-30 00:00:00,64,0,4,243,612,923,41403
2022-07-30 00:00:00,2022-07-30 01:00:00,64,0,4,203,809,1080,40520
2022-07-30 01:00:00,2022-07-30 02:00:00,64,0,4,171,951,1190,40068
2022-07-30 02:00:00,2022-07-30 03:00:00,64,0,4,190,899,1157,39912
2022-07-30 03:00:00,2022-07-30 04:00:00,65,0,7,230,928,1230,39587
2022-07-30 04:00:00,2022-07-30 05:00:00,63,0,71,211,947,1292,38547
2022-07-30 05:00:00,2022-07-30 06:00:00,60,0,266,167,917,1410,36864
2022-07-30 06:00:00,2022-07-30 07:00:00,60,0,573,113,1091,1837,35527
2022-07-30 07:00:00,2022-07-30 08:00:00,61,0,871,163,862,1957,33458
2022-07-30 08:00:00,2022-07-30 09:00:00,64,0,1070,284,695,2113,30081
2022-07-30 09:00:00,2022-07-30 10:00:00,64,0,1183,372,763,2382,27624
2022-07-30 10:00:00,2022-07-30 11:00:00,63,0,1152,310,710,2235,27523
2022-07-30 11:00:00,2022-07-30 12:00:00,63,0,1140,280,778,2261,28152
2022-07-30 12:00:00,2022-07-30 13:00:00,60,0,1095,268,877,2300,29279
2022-07-30 13:00:00,2022-07-30 14:00:00,61,0,1086,241,888,2276,31109
2022-07-30 14:00:00,2022-07-30 15:00:00,60,0,897,334,700,1991,35255
2022-07-30 15:00:00,2022-07-30 16:00:00,60,0,649,646,805,2160,39907
2022-07-30 16:00:00,2022-07-30 17:00:00,60,0,358,590,762,1770,42853
2022-07-30 17:00:00,2022-07-30 18:00:00,63,0,135,881,550,1629,44968
2022-07-30 18:00:00,2022-07-30 19:00:00,61,0,54,1096,528,1739,46110
2022-07-30 19:00:00,2022-07-30 20:00:00,64,0,4,1730,722,2520,46542
2022-07-30 20:00:00,2022-07-30 21:00:00,63,0,4,1917,867,2851,45659
2022-07-30 21:00:00,2022-07-30 22:00:00,59,0,4,1558,979,2600,43885
2022-07-30 22:00:00,2022-07-30 23:00:00,60,0,4,1386,1072,2522,41886
2022-07-30 23:00:00,2022-07-31 00:00:00,65,0,4,1212,1409,2690,40746
2022-07-31 00:00:00,2022-07-31 01:00:00,64,0,4,1537,1556,3161,39950
2022-07-31 01:00:00,2022-07-31 02:00:00,64,0,4,1890,1430,3388,39628
2022-07-31 02:00:00,2022-07-31 03:00:00,64,0,4,2228,1277,3573,39314
2022-07-31 03:00:00,2022-07-31 04:00:00,64,0,6,2193,1251,3514,38824
2022-07-31 04:00:00,2022-07-31 05:00:00,64,0,79,2219,1608,3970,38215
2022-07-31 05:00:00,2022-07-31 06:00:00,62,0,168,2806,1658,4694,38312
2022-07-31 06:00:00,2022-07-31 07:00:00,62,0,256,3139,1662,5119,38647
2022-07-31 07:00:00,2022-07-31 08:00:00,60,0,332,4698,1931,7021,39032
2022-07-31 08:00:00,2022-07-31 09:00:00,63,0,511,5291,2411,8276,39565
2022-07-31 09:00:00,2022-07-31 10:00:00,62,0,346,4800,3128,8336,40438
2022-07-31 10:00:00,2022-07-31 11:00:00,63,0,444,5518,4088,10113,40831
2022-07-31 11:00:00,2022-07-31 12:00:00,62,0,305,5648,5197,11212,40956
2022-07-31 12:00:00,2022-07-31 13:00:00,62,0,284,6205,5499,12050,40606
2022-07-31 13:00:00,2022-07-31 14:00:00,60,0,265,5896,5540,11761,40736
2022-07-31 14:00:00,2022-07-31 15:00:00,62,0,311,6403,5462,12238,41460
2022-07-31 15:00:00,2022-07-31 16:00:00,61,0,327,6348,5451,12187,44343
2022-07-31 16:00:00,2022-07-31 17:00:00,62,0,248,6040,5723,12073,45431
2022-07-31 17:00:00,2022-07-31 18:00:00,63,0,125,4751,5031,9970,45441
2022-07-31 18:00:00,2022-07-31 19:00:00,62,0,26,3460,4433,7981,45781
2022-07-31 19:00:00,2022-07-31 20:00:00,64,0,5,1903,3532,5504,45932
2022-07-31 20:00:00,2022-07-31 21:00:00,63,0,4,2406,2703,5176,45243
2022-07-31 21:00:00,2022-07-31 22:00:00,61,0,4,2203,2195,4463,43517
2022-07-31 22:00:00,2022-07-31 23:00:00,61,0,4,2480,1472,4017,42124
2022-07-31 23:00:00,2022-08-01 00:00:00,64,0,4,2437,1178,3683,41103
2022-08-01 00:00:00,2022-08-01 01:00:00,64,0,4,1848,1304,3220,40758
2022-08-01 01:00:00,2022-08-01 02:00:00,66,0,4,1884,1251,3205,40448
2022-08-01 02:00:00,2022-08-01 03:00:00,64,0,4,1809,1275,3152,40430
2022-08-01 03:00:00,2022-08-01 04:00:00,64,0,7,1851,1389,3311,41362
2022-08-01 04:00:00,2022-08-01 05:00:00,64,0,55,1495,1337,2951,43269
2022-08-01 05:00:00,2022-08-01 06:00:00,62,0,126,1040,1525,2753,45279
2022-08-01 06:00:00,2022-08-01 07:00:00,61,0,258,861,1799,2979,45792
2022-08-01 07:00:00,2022-08-01 08:00:00,64,0,481,736,1374,2655,43557
2022-08-01 08:00:00,2022-08-01 09:00:00,64,0,836,581,1127,2608,40268
2022-08-01 09:00:00,2022-08-01 10:00:00,64,0,980,484,993,2521,37986
2022-08-01 10:00:00,2022-08-01 11:00:00,63,0,1048,211,864,2186,36609
2022-08-01 11:00:00,2022-08-01 12:00:00,64,0,1091,101,752,2008,35433
2022-08-01 12:00:00,2022-08-01 13:00:00,64,0,1100,68,714,1946,34706
2022-08-01 13:00:00,2022-08-01 14:00:00,60,0,1174,84,713,2031,34302
2022-08-01 14:00:00,2022-08-01 15:00:00,61,0,1009,89,666,1825,35810
2022-08-01 15:00:00,2022-08-01 16:00:00,60,0,923,78,695,1756,39624
2022-08-01 16:00:00,2022-08-01 17:00:00,63,0,594,126,628,1411,42356
2022-08-01 17:00:00,2022-08-01 18:00:00,64,0,262,245,460,1031,45870
2022-08-01 18:00:00,2022-08-01 19:00:00,64,0,52,263,410,789,48700
2022-08-01 19:00:00,2022-08-01 20:00:00,63,0,4,424,488,979,49365
2022-08-01 20:00:00,2022-08-01 21:00:00,62,0,4,592,645,1303,47818
2022-08-01 21:00:00,2022-08-01 22:00:00,60,0,4,878,881,1823,45613
2022-08-01 22:00:00,2022-08-01 23:00:00,62,0,4,1333,1231,2630,43144
2022-08-01 23:00:00,2022-08-02 00:00:00,63,0,4,1871,1621,3559,41233
2022-08-02 00:00:00,2022-08-02 01:00:00,64,0,4,1630,1994,3692,40110
2022-08-02 01:00:00,2022-08-02 02:00:00,64,0,4,1519,2294,3881,39772
2022-08-02 02:00:00,2022-08-02 03:00:00,64,0,4,2708,2398,5174,39743
2022-08-02 03:00:00,2022-08-02 04:00:00,63,0,7,3761,3031,6862,40568
2022-08-02 04:00:00,2022-08-02 05:00:00,62,0,75,4377,3488,8002,41881
2022-08-02 05:00:00,2022-08-02 06:00:00,60,0,202,4433,3299,7994,42161
2022-08-02 06:00:00,2022-08-02 07:00:00,61,0,469,4897,2630,8057,41103
2022-08-02 07:00:00,2022-08-02 08:00:00,62,0,719,5858,2331,8970,38638
2022-08-02 08:00:00,2022-08-02 09:00:00,61,0,917,6489,2506,9973,36053
2022-08-02 09:00:00,2022-08-02 10:00:00,62,0,1011,7806,2810,11689,34937
2022-08-02 10:00:00,2022-08-02 11:00:00,60,0,1022,7897,2923,11902,34261
2022-08-02 11:00:00,2022-08-02 12:00:00,63,0,886,7530,3044,11523,34865
2022-08-02 12:00:00,2022-08-02 13:00:00,61,0,785,7875,3201,11922,34923
2022-08-02 13:00:00,2022-08-02 14:00:00,61,0,602,8741,3647,13051,35892
2022-08-02 14:00:00,2022-08-02 15:00:00,60,0,537,8484,3864,12945,38099
2022-08-02 15:00:00,2022-08-02 16:00:00,61,0,639,8208,4030,12938,42406
2022-08-02 16:00:00,2022-08-02 17:00:00,63,0,439,7776,5023,13301,45319
2022-08-02 17:00:00,2022-08-02 18:00:00,61,0,180,7191,4456,11888,48292
2022-08-02 18:00:00,2022-08-02 19:00:00,63,0,37,7108,4076,11284,50487
2022-08-02 19:00:00,2022-08-02 20:00:00,61,0,4,6756,3277,10098,51071
2022-08-02 20:00:00,2022-08-02 21:00:00,60,0,4,5976,3348,9388,49454
2022-08-02 21:00:00,2022-08-02 22:00:00,60,0,4,5291,3028,8383,47006
2022-08-02 22:00:00,2022-08-02 23:00:00,62,0,4,5358,2758,8182,44921
2022-08-02 23:00:00,2022-08-03 00:00:00,63,0,4,5368,2369,7804,43285
2022-08-03 00:00:00,2022-08-03 01:00:00,63,0,4,4680,2595,7342,42515
2022-08-03 01:00:00,2022-08-03 02:00:00,63,0,4,3998,2699,6764,41993
2022-08-03 02:00:00,2022-08-03 03:00:00,62,0,4,4113,2802,6981,41914
2022-08-03 03:00:00,2022-08-03 04:00:00,63,0,4,4391,2765,7223,42544
2022-08-03 04:00:00,2022-08-03 05:00:00,60,0,44,4019,2742,6865,43653
2022-08-03 05:00:00,2022-08-03 06:00:00,60,0,189,4444,2365,7058,44522
2022-08-03 06:00:00,2022-08-03 07:00:00,60,0,409,4929,2095,7493,43804
2022-08-03 07:00:00,2022-08-03 08:00:00,60,0,682,5145,1776,7663,41679
2022-08-03 08:00:00,2022-08-03 09:00:00,61,0,958,5196,1709,7924,38603
2022-08-03 09:00:00,2022-08-03 10:00:00,62,0,1033,5077,1780,7952,35535
2022-08-03 10:00:00,2022-08-03 11:00:00,60,0,1121,4782,1803,7766,33567
2022-08-03 11:00:00,2022-08-03 12:00:00,60,0,1127,4253,1715,7155,33147
2022-08-03 12:00:00,2022-08-03 13:00:00,60,0,1134,3831,1802,6827,34179
2022-08-03 13:00:00,2022-08-03 14:00:00,60,0,978,3296,2242,6576,35994
2022-08-03 14:00:00,2022-08-03 15:00:00,60,0,801,2517,2404,5782,39042
2022-08-03 15:00:00,2022-08-03 16:00:00,60,0,653,1927,2045,4685,43221
2022-08-03 16:00:00,2022-08-03 17:00:00,60,0,426,1426,1243,3155,46233
2022-08-03 17:00:00,2022-08-03 18:00:00,60,0,184,1174,765,2183,49649
2022-08-03 18:00:00,2022-08-03 19:00:00,60,0,37,868,523,1488,51743
2022-08-03 19:00:00,2022-08-03 20:00:00,60,0,4,494,465,1023,52268
2022-08-03 20:00:00,2022-08-03 21:00:00,60,0,4,424,502,990,51067
2022-08-03 21:00:00,2022-08-03 22:00:00,60,0,4,589,631,1284,48708
2022-08-03 22:00:00,2022-08-03 23:00:00,59,0,4,960,843,1866,46101
2022-08-03 23:00:00,2022-08-04 00:00:00,62,0,4,1199,871,2136,44512
2022-08-04 00:00:00,2022-08-04 01:00:00,60,0,4,1125,1082,2271,43554
2022-08-04 01:00:00,2022-08-04 02:00:00,62,0,4,987,1196,2249,43226
2022-08-04 02:00:00,2022-08-04 03:00:00,61,0,4,1231,1061,2357,43159
2022-08-04 03:00:00,2022-08-04 04:00:00,61,0,5,1911,787,2764,43883
2022-08-04 04:00:00,2022-08-04 05:00:00,60,0,53,1681,814,2608,45068
2022-08-04 05:00:00,2022-08-04 06:00:00,60,0,170,1091,757,2078,46328
2022-08-04 06:00:00,2022-08-04 07:00:00,61,0,455,433,678,1627,45935
2022-08-04 07:00:00,2022-08-04 08:00:00,60,0,687,211,716,1674,43764
2022-08-04 08:00:00,2022-08-04 09:00:00,60,0,824,254,833,1971,40964
2022-08-04 09:00:00,2022-08-04 10:00:00,60,0,967,413,870,2310,43472
2022-08-04 10:00:00,2022-08-04 11:00:00,60,0,905,313,811,2089,44274
2022-08-04 11:00:00,2022-08-04 12:00:00,60,0,788,524,932,2304,40842
2022-08-04 12:00:00,2022-08-04 13:00:00,61,0,519,437,1059,2076,38556
2022-08-04 13:00:00,2022-08-04 14:00:00,61,0,987,377,1155,2580,38742
2022-08-04 14:00:00,2022-08-04 15:00:00,61,0,950,213,1319,2543,41293
2022-08-04 15:00:00,2022-08-04 16:00:00,63,0,678,220,1434,2395,44952
2022-08-04 16:00:00,2022-08-04 17:00:00,63,0,397,429,1268,2157,47446
2022-08-04 17:00:00,2022-08-04 18:00:00,63,0,195,465,1296,2019,50049
2022-08-04 18:00:00,2022-08-04 19:00:00,61,0,44,625,1378,2108,51737
2022-08-04 19:00:00,2022-08-04 20:00:00,64,0,4,796,1243,2107,51569
2022-08-04 20:00:00,2022-08-04 21:00:00,63,0,4,1046,1158,2271,49835
2022-08-04 21:00:00,2022-08-04 22:00:00,62,0,4,834,935,1835,47625
2022-08-04 22:00:00,2022-08-04 23:00:00,63,0,4,669,853,1589,45093
2022-08-04 23:00:00,2022-08-05 00:00:00,64,0,4,736,866,1670,43621
2022-08-05 00:00:00,2022-08-05 01:00:00,64,0,4,1000,743,1811,42858
2022-08-05 01:00:00,2022-08-05 02:00:00,64,0,4,1431,727,2226,42349
2022-08-05 02:00:00,2022-08-05 03:00:00,64,0,4,1420,763,2251,42249
2022-08-05 03:00:00,2022-08-05 04:00:00,64,0,4,1234,792,2094,43081
2022-08-05 04:00:00,2022-08-05 05:00:00,63,0,27,932,1042,2064,44523
2022-08-05 05:00:00,2022-08-05 06:00:00,62,0,137,1116,1438,2753,45457
2022-08-05 06:00:00,2022-08-05 07:00:00,61,0,398,1249,1517,3225,44753
2022-08-05 07:00:00,2022-08-05 08:00:00,63,0,620,420,1724,2827,42998
2022-08-05 08:00:00,2022-08-05 09:00:00,64,0,715,538,1862,3179,41812
2022-08-05 09:00:00,2022-08-05 10:00:00,63,0,803,815,2153,3834,41264
2022-08-05 10:00:00,2022-08-05 11:00:00,63,0,1159,965,2238,4425,38489
2022-08-05 11:00:00,2022-08-05 12:00:00,60,0,1143,1367,2866,5436,36408
2022-08-05 12:00:00,2022-08-05 13:00:00,62,0,917,2493,3336,6808,35009
2022-08-05 13:00:00,2022-08-05 14:00:00,60,0,788,3408,3293,7549,35028
2022-08-05 14:00:00,2022-08-05 15:00:00,63,0,878,2944,3701,7586,37110
2022-08-05 15:00:00,2022-08-05 16:00:00,62,0,713,2792,3898,7465,40514
2022-08-05 16:00:00,2022-08-05 17:00:00,61,0,533,1914,3937,6445,42665
2022-08-05 17:00:00,2022-08-05 18:00:00,61,0,213,1372,3146,4792,44907
2022-08-05 18:00:00,2022-08-05 19:00:00,63,0,51,1315,2256,3685,47072
2022-08-05 19:00:00,2022-08-05 20:00:00,63,0,3,1241,1928,3235,47699
2022-08-05 20:00:00,2022-08-05 21:00:00,62,0,4,1279,1716,3061,46714
2022-08-05 21:00:00,2022-08-05 22:00:00,61,0,4,947,1525,2537,45054
2022-08-05 22:00:00,2022-08-05 23:00:00,62,0,4,845,1229,2140,43193
2022-08-05 23:00:00,2022-08-06 00:00:00,64,0,4,753,1053,1874,41854
2022-08-06 00:00:00,2022-08-06 01:00:00,64,0,4,724,1012,1804,40868
2022-08-06 01:00:00,2022-08-06 02:00:00,64,0,4,810,998,1876,40213
2022-08-06 02:00:00,2022-08-06 03:00:00,64,0,4,911,1049,2028,40036
2022-08-06 03:00:00,2022-08-06 04:00:00,64,0,5,704,1039,1812,39903
2022-08-06 04:00:00,2022-08-06 05:00:00,63,0,63,665,988,1779,39098
2022-08-06 05:00:00,2022-08-06 06:00:00,61,0,250,381,739,1431,36936
2022-08-06 06:00:00,2022-08-06 07:00:00,60,0,523,287,745,1615,34755
2022-08-06 07:00:00,2022-08-06 08:00:00,62,0,880,305,791,2038,32968
2022-08-06 08:00:00,2022-08-06 09:00:00,61,0,914,304,898,2177,30883
2022-08-06 09:00:00,2022-08-06 10:00:00,60,0,861,274,832,2027,28433
2022-08-06 10:00:00,2022-08-06 11:00:00,60,0,976,227,830,2093,27235
2022-08-06 11:00:00,2022-08-06 12:00:00,62,0,1047,205,749,2063,26593
2022-08-06 12:00:00,2022-08-06 13:00:00,62,0,1085,190,831,2168,26907
2022-08-06 13:00:00,2022-08-06 14:00:00,61,0,1022,174,921,2178,28469
2022-08-06 14:00:00,2022-08-06 15:00:00,63,0,1044,141,1036,2284,31267
2022-08-06 15:00:00,2022-08-06 16:00:00,64,0,703,206,1191,2164,35285
2022-08-06 16:00:00,2022-08-06 17:00:00,61,0,495,259,1166,1981,38529
2022-08-06 17:00:00,2022-08-06 18:00:00,62,0,228,234,943,1467,42152
2022-08-06 18:00:00,2022-08-06 19:00:00,61,0,50,382,743,1236,44586
2022-08-06 19:00:00,2022-08-06 20:00:00,60,0,4,420,639,1123,45604
2022-08-06 20:00:00,2022-08-06 21:00:00,60,0,4,290,602,956,44887
2022-08-06 21:00:00,2022-08-06 22:00:00,62,0,4,250,516,832,43380
2022-08-06 22:00:00,2022-08-06 23:00:00,61,0,4,245,433,743,41785
2022-08-06 23:00:00,2022-08-07 00:00:00,64,0,4,255,394,717,40522
2022-08-07 00:00:00,2022-08-07 01:00:00,63,0,4,221,387,675,39597
2022-08-07 01:00:00,2022-08-07 02:00:00,64,0,4,184,400,652,39023
2022-08-07 02:00:00,2022-08-07 03:00:00,64,0,4,188,422,678,38676
2022-08-07 03:00:00,2022-08-07 04:00:00,63,0,4,265,452,784,38394
2022-08-07 04:00:00,2022-08-07 05:00:00,61,0,55,301,438,855,36798
2022-08-07 05:00:00,2022-08-07 06:00:00,63,0,253,228,445,989,34177
2022-08-07 06:00:00,2022-08-07 07:00:00,63,0,587,236,461,1347,31583
2022-08-07 07:00:00,2022-08-07 08:00:00,64,0,905,269,501,1739,28960
2022-08-07 08:00:00,2022-08-07 09:00:00,63,0,1122,363,540,2088,26095
2022-08-07 09:00:00,2022-08-07 10:00:00,63,0,1086,453,620,2222,23830
2022-08-07 10:00:00,2022-08-07 11:00:00,63,0,1140,541,627,2371,22677
2022-08-07 11:00:00,2022-08-07 12:00:00,63,0,1047,801,677,2588,21991
2022-08-07 12:00:00,2022-08-07 13:00:00,64,0,1272,814,952,3102,22496
2022-08-07 13:00:00,2022-08-07 14:00:00,62,0,1100,515,1130,2807,24574
2022-08-07 14:00:00,2022-08-07 15:00:00,63,0,1013,455,1367,2898,28853
2022-08-07 15:00:00,2022-08-07 16:00:00,64,0,649,374,1341,2428,33947
2022-08-07 16:00:00,2022-08-07 17:00:00,64,0,414,291,1227,1996,38224
2022-08-07 17:00:00,2022-08-07 18:00:00,64,0,218,320,967,1569,41579
2022-08-07 18:00:00,2022-08-07 19:00:00,64,0,34,253,652,1003,44795
2022-08-07 19:00:00,2022-08-07 20:00:00,62,0,8,157,551,778,46121
2022-08-07 20:00:00,2022-08-07 21:00:00,63,0,8,155,515,741,45109
2022-08-07 21:00:00,2022-08-07 22:00:00,60,0,8,158,503,729,43519
2022-08-07 22:00:00,2022-08-07 23:00:00,60,0,8,155,511,734,42056
2022-08-07 23:00:00,2022-08-08 00:00:00,60,0,8,209,484,761,40714
2022-08-08 00:00:00,2022-08-08 01:00:00,63,0,8,259,492,822,40128
2022-08-08 01:00:00,2022-08-08 02:00:00,64,0,8,287,516,875,39611
2022-08-08 02:00:00,2022-08-08 03:00:00,64,0,8,258,520,850,39683
2022-08-08 03:00:00,2022-08-08 04:00:00,64,0,7,305,471,847,40884
2022-08-08 04:00:00,2022-08-08 05:00:00,63,0,47,406,473,989,42049
2022-08-08 05:00:00,2022-08-08 06:00:00,63,0,223,198,473,957,42431
2022-08-08 06:00:00,2022-08-08 07:00:00,62,0,490,119,473,1144,41150
2022-08-08 07:00:00,2022-08-08 08:00:00,64,0,773,112,533,1482,38689
2022-08-08 08:00:00,2022-08-08 09:00:00,64,0,887,103,516,1570,36863
2022-08-08 09:00:00,2022-08-08 10:00:00,63,0,839,102,555,1559,36382
2022-08-08 10:00:00,2022-08-08 11:00:00,62,0,701,101,760,1624,35960
2022-08-08 11:00:00,2022-08-08 12:00:00,64,0,870,111,873,1918,35731
2022-08-08 12:00:00,2022-08-08 13:00:00,64,0,837,125,1047,2073,35211
2022-08-08 13:00:00,2022-08-08 14:00:00,62,0,705,159,1440,2366,35802
2022-08-08 14:00:00,2022-08-08 15:00:00,61,0,731,360,1626,2778,38016
2022-08-08 15:00:00,2022-08-08 16:00:00,64,0,581,729,1732,3106,41538
2022-08-08 16:00:00,2022-08-08 17:00:00,64,0,479,1113,1970,3626,43744
2022-08-08 17:00:00,2022-08-08 18:00:00,64,0,209,1552,1830,3655,46439
2022-08-08 18:00:00,2022-08-08 19:00:00,64,0,35,1904,1767,3770,48551
2022-08-08 19:00:00,2022-08-08 20:00:00,64,0,4,2025,1689,3782,48888
2022-08-08 20:00:00,2022-08-08 21:00:00,64,0,4,2014,1647,3729,47083
2022-08-08 21:00:00,2022-08-08 22:00:00,63,0,4,1790,1603,3460,45130
2022-08-08 22:00:00,2022-08-08 23:00:00,60,0,4,1755,1333,3152,43255
2022-08-08 23:00:00,2022-08-09 00:00:00,61,0,4,1642,1349,3056,41723
2022-08-09 00:00:00,2022-08-09 01:00:00,61,0,4,1220,1377,2662,40911
2022-08-09 01:00:00,2022-08-09 02:00:00,60,0,4,1215,1222,2501,40441
2022-08-09 02:00:00,2022-08-09 03:00:00,61,0,4,965,1174,2204,40566
2022-08-09 03:00:00,2022-08-09 04:00:00,62,0,4,775,1045,1886,41563
2022-08-09 04:00:00,2022-08-09 05:00:00,60,0,52,877,1019,2008,42368
2022-08-09 05:00:00,2022-08-09 06:00:00,60,0,242,1023,889,2214,42587
2022-08-09 06:00:00,2022-08-09 07:00:00,61,0,590,1152,688,2491,40747
2022-08-09 07:00:00,2022-08-09 08:00:00,62,0,834,911,841,2648,37783
2022-08-09 08:00:00,2022-08-09 09:00:00,64,0,1012,857,1070,3003,34529
2022-08-09 09:00:00,2022-08-09 10:00:00,64,0,1218,1002,1112,3396,31719
2022-08-09 10:00:00,2022-08-09 11:00:00,63,0,1257,1267,1185,3772,29720
2022-08-09 11:00:00,2022-08-09 12:00:00,64,0,1233,1796,1348,4441,29297
2022-08-09 12:00:00,2022-08-09 13:00:00,64,0,1296,2109,1776,5245,29608
2022-08-09 13:00:00,2022-08-09 14:00:00,61,0,1242,2602,2312,6217,31636
2022-08-09 14:00:00,2022-08-09 15:00:00,61,0,1122,3018,2614,6815,35452
2022-08-09 15:00:00,2022-08-09 16:00:00,61,0,872,3566,2875,7374,40481
2022-08-09 16:00:00,2022-08-09 17:00:00,64,0,542,3885,3215,7706,43643
2022-08-09 17:00:00,2022-08-09 18:00:00,62,0,202,4324,3157,7745,47178
2022-08-09 18:00:00,2022-08-09 19:00:00,62,0,28,3866,2585,6541,49350
2022-08-09 19:00:00,2022-08-09 20:00:00,64,0,4,3769,2638,6475,49738
2022-08-09 20:00:00,2022-08-09 21:00:00,64,0,4,3848,3048,6964,47876
2022-08-09 21:00:00,2022-08-09 22:00:00,62,0,4,3553,2994,6613,46043
2022-08-09 22:00:00,2022-08-09 23:00:00,63,0,4,3014,2908,5989,43716
2022-08-09 23:00:00,2022-08-10 00:00:00,64,0,4,2834,2825,5727,42103
2022-08-10 00:00:00,2022-08-10 01:00:00,64,0,4,2086,2881,5035,41011
2022-08-10 01:00:00,2022-08-10 02:00:00,65,0,4,1754,2845,4668,40420
2022-08-10 02:00:00,2022-08-10 03:00:00,62,0,4,1676,2611,4353,40561
2022-08-10 03:00:00,2022-08-10 04:00:00,63,0,3,1358,2248,3672,41717
2022-08-10 04:00:00,2022-08-10 05:00:00,64,0,45,1115,2065,3289,42931
2022-08-10 05:00:00,2022-08-10 06:00:00,64,0,240,1286,1722,3312,42717
2022-08-10 06:00:00,2022-08-10 07:00:00,64,0,584,1092,1140,2880,41284
2022-08-10 07:00:00,2022-08-10 08:00:00,64,0,895,1079,803,2841,38558
2022-08-10 08:00:00,2022-08-10 09:00:00,64,0,1138,1274,774,3250,35046
2022-08-10 09:00:00,2022-08-10 10:00:00,64,0,1267,1276,914,3521,32368
2022-08-10 10:00:00,2022-08-10 11:00:00,64,0,1302,1330,1030,3726,30682
2022-08-10 11:00:00,2022-08-10 12:00:00,64,0,1307,1428,1071,3870,30310
2022-08-10 12:00:00,2022-08-10 13:00:00,63,0,1290,1687,1046,4086,30777
2022-08-10 13:00:00,2022-08-10 14:00:00,61,0,1236,1996,1306,4599,32833
2022-08-10 14:00:00,2022-08-10 15:00:00,62,0,1102,2293,1531,4988,36603
2022-08-10 15:00:00,2022-08-10 16:00:00,63,0,841,2448,1937,5289,41744
2022-08-10 16:00:00,2022-08-10 17:00:00,63,0,520,3151,2286,6020,44946
2022-08-10 17:00:00,2022-08-10 18:00:00,60,0,193,3978,1997,6228,48585
2022-08-10 18:00:00,2022-08-10 19:00:00,62,0,29,4152,2131,6374,50747
2022-08-10 19:00:00,2022-08-10 20:00:00,64,0,8,4445,2578,7095,50984
2022-08-10 20:00:00,2022-08-10 21:00:00,63,0,8,4040,3102,7213,49184
2022-08-10 21:00:00,2022-08-10 22:00:00,62,0,8,3438,3296,6804,46817
2022-08-10 22:00:00,2022-08-10 23:00:00,63,0,8,3183,3218,6472,44154
2022-08-10 23:00:00,2022-08-11 00:00:00,64,0,8,2592,3085,5749,42486
2022-08-11 00:00:00,2022-08-11 01:00:00,64,0,8,1969,2977,5018,41640
2022-08-11 01:00:00,2022-08-11 02:00:00,64,0,8,1784,2621,4477,41035
2022-08-11 02:00:00,2022-08-11 03:00:00,64,0,8,1375,2338,3785,41044
2022-08-11 03:00:00,2022-08-11 04:00:00,63,0,7,939,2151,3160,42110
2022-08-11 04:00:00,2022-08-11 05:00:00,62,0,47,922,1678,2709,43515
2022-08-11 05:00:00,2022-08-11 06:00:00,60,0,235,589,1339,2223,43621
2022-08-11 06:00:00,2022-08-11 07:00:00,62,0,586,384,855,1887,42319
2022-08-11 07:00:00,2022-08-11 08:00:00,64,0,898,344,548,1854,39840
2022-08-11 08:00:00,2022-08-11 09:00:00,63,0,1128,317,451,1959,36662
2022-08-11 09:00:00,2022-08-11 10:00:00,61,0,1251,289,584,2185,34228
2022-08-11 10:00:00,2022-08-11 11:00:00,60,0,1286,362,893,2601,32499
2022-08-11 11:00:00,2022-08-11 12:00:00,61,0,1291,630,1095,3077,32161
2022-08-11 12:00:00,2022-08-11 13:00:00,61,0,1275,1005,1144,3485,32578
2022-08-11 13:00:00,2022-08-11 14:00:00,60,0,1226,1310,1401,3997,34647
2022-08-11 14:00:00,2022-08-11 15:00:00,61,0,1099,2047,1909,5116,38113
2022-08-11 15:00:00,2022-08-11 16:00:00,62,0,844,2652,2434,5992,42838
2022-08-11 16:00:00,2022-08-11 17:00:00,64,0,506,3375,2443,6388,46344
2022-08-11 17:00:00,2022-08-11 18:00:00,61,0,185,4061,2299,6606,49847
2022-08-11 18:00:00,2022-08-11 19:00:00,61,0,26,4693,2529,7309,51894
2022-08-11 19:00:00,2022-08-11 20:00:00,63,0,8,4949,3262,8282,52097
2022-08-11 20:00:00,2022-08-11 21:00:00,62,0,8,4787,3980,8837,49951
2022-08-11 21:00:00,2022-08-11 22:00:00,60,0,8,3878,4300,8246,47329
2022-08-11 22:00:00,2022-08-11 23:00:00,62,0,8,2777,4380,7227,44877
2022-08-11 23:00:00,2022-08-12 00:00:00,64,0,8,2853,3896,6821,43033
2022-08-12 00:00:00,2022-08-12 01:00:00,64,0,8,2780,3357,6209,42019
2022-08-12 01:00:00,2022-08-12 02:00:00,64,0,4,2014,2869,4951,41354
2022-08-12 02:00:00,2022-08-12 03:00:00,64,0,4,1807,2529,4404,41300
2022-08-12 03:00:00,2022-08-12 04:00:00,63,0,3,1550,2132,3748,42259
2022-08-12 04:00:00,2022-08-12 05:00:00,61,0,44,1249,1942,3296,43869
2022-08-12 05:00:00,2022-08-12 06:00:00,60,0,233,1101,1445,2839,44191
2022-08-12 06:00:00,2022-08-12 07:00:00,63,0,568,929,913,2473,43028
2022-08-12 07:00:00,2022-08-12 08:00:00,64,0,885,807,580,2336,40615
2022-08-12 08:00:00,2022-08-12 09:00:00,62,0,1115,714,549,2440,37392
2022-08-12 09:00:00,2022-08-12 10:00:00,63,0,1243,607,605,2518,34988
2022-08-12 10:00:00,2022-08-12 11:00:00,62,0,1281,786,842,2971,33389
2022-08-12 11:00:00,2022-08-12 12:00:00,62,0,1284,950,1144,3440,32991
2022-08-12 12:00:00,2022-08-12 13:00:00,61,0,1265,1102,1233,3661,33326
2022-08-12 13:00:00,2022-08-12 14:00:00,61,0,1213,1674,1393,4341,34906
2022-08-12 14:00:00,2022-08-12 15:00:00,63,0,1073,1981,1676,4793,38392
2022-08-12 15:00:00,2022-08-12 16:00:00,62,0,812,2438,2105,5417,43122
2022-08-12 16:00:00,2022-08-12 17:00:00,64,0,479,3496,2303,6342,46691
2022-08-12 17:00:00,2022-08-12 18:00:00,64,0,174,4559,2206,7003,50261
2022-08-12 18:00:00,2022-08-12 19:00:00,64,0,25,5057,2663,7809,52082
2022-08-12 19:00:00,2022-08-12 20:00:00,64,0,4,5241,3183,8492,51902
2022-08-12 20:00:00,2022-08-12 21:00:00,64,0,4,5489,3570,9127,49927
2022-08-12 21:00:00,2022-08-12 22:00:00,63,0,4,4781,3701,8549,47797
2022-08-12 22:00:00,2022-08-12 23:00:00,64,0,4,3263,3216,6547,44893
2022-08-12 23:00:00,2022-08-13 00:00:00,64,0,4,2353,2818,5239,42756
2022-08-13 00:00:00,2022-08-13 01:00:00,63,0,4,1691,2679,4437,41958
2022-08-13 01:00:00,2022-08-13 02:00:00,63,0,4,1787,2575,4429,41257
2022-08-13 02:00:00,2022-08-13 03:00:00,64,0,4,1247,2005,3320,40848
2022-08-13 03:00:00,2022-08-13 04:00:00,64,0,4,831,1498,2397,40653
2022-08-13 04:00:00,2022-08-13 05:00:00,60,0,41,622,1318,2041,40129
2022-08-13 05:00:00,2022-08-13 06:00:00,60,0,232,556,1283,2131,38520
2022-08-13 06:00:00,2022-08-13 07:00:00,62,0,566,513,1047,2188,36685
2022-08-13 07:00:00,2022-08-13 08:00:00,64,0,887,453,692,2096,34696
2022-08-13 08:00:00,2022-08-13 09:00:00,63,0,1123,437,650,2273,31761
2022-08-13 09:00:00,2022-08-13 10:00:00,62,0,1246,231,799,2338,29332
2022-08-13 10:00:00,2022-08-13 11:00:00,63,0,1285,261,1158,2767,27543
2022-08-13 11:00:00,2022-08-13 12:00:00,64,0,1277,278,1261,2880,26869
2022-08-13 12:00:00,2022-08-13 13:00:00,64,0,1241,216,1060,2581,27345
2022-08-13 13:00:00,2022-08-13 14:00:00,61,0,1140,238,818,2257,29258
2022-08-13 14:00:00,2022-08-13 15:00:00,60,0,959,676,788,2483,33033
2022-08-13 15:00:00,2022-08-13 16:00:00,62,0,726,1140,920,2848,37979
2022-08-13 16:00:00,2022-08-13 17:00:00,63,0,417,1699,1103,3282,42634
2022-08-13 17:00:00,2022-08-13 18:00:00,63,0,151,1994,1190,3398,46675
2022-08-13 18:00:00,2022-08-13 19:00:00,64,0,20,2067,1563,3714,49142
2022-08-13 19:00:00,2022-08-13 20:00:00,63,0,4,2672,1866,4605,49626
2022-08-13 20:00:00,2022-08-13 21:00:00,64,0,4,2859,2503,5430,48189
2022-08-13 21:00:00,2022-08-13 22:00:00,62,0,4,2736,3084,5886,46288
2022-08-13 22:00:00,2022-08-13 23:00:00,63,0,4,2706,3149,5922,44119
2022-08-13 23:00:00,2022-08-14 00:00:00,64,0,4,2891,3771,6730,42348
2022-08-14 00:00:00,2022-08-14 01:00:00,64,0,4,3397,3543,7008,41301
2022-08-14 01:00:00,2022-08-14 02:00:00,63,0,4,2994,3271,6332,40640
2022-08-14 02:00:00,2022-08-14 03:00:00,64,0,4,2346,2734,5148,40218
2022-08-14 03:00:00,2022-08-14 04:00:00,64,0,4,1623,2439,4130,39877
2022-08-14 04:00:00,2022-08-14 05:00:00,62,0,35,1052,2191,3340,38844
2022-08-14 05:00:00,2022-08-14 06:00:00,60,0,211,763,1903,2937,36813
2022-08-14 06:00:00,2022-08-14 07:00:00,61,0,521,518,1328,2428,34542
2022-08-14 07:00:00,2022-08-14 08:00:00,62,0,825,445,865,2197,32289
2022-08-14 08:00:00,2022-08-14 09:00:00,60,0,1089,515,794,2458,29773
2022-08-14 09:00:00,2022-08-14 10:00:00,60,0,1220,507,931,2718,27965
2022-08-14 10:00:00,2022-08-14 11:00:00,63,0,1257,548,941,2809,27185
2022-08-14 11:00:00,2022-08-14 12:00:00,64,0,1223,390,876,2553,27025
2022-08-14 12:00:00,2022-08-14 13:00:00,64,0,1090,379,833,2366,28110
2022-08-14 13:00:00,2022-08-14 14:00:00,63,0,971,460,790,2284,30987
2022-08-14 14:00:00,2022-08-14 15:00:00,58,0,861,670,699,2288,35655
2022-08-14 15:00:00,2022-08-14 16:00:00,60,0,610,1263,658,2591,41785
2022-08-14 16:00:00,2022-08-14 17:00:00,63,0,309,1699,675,2746,45617
2022-08-14 17:00:00,2022-08-14 18:00:00,64,0,114,2226,687,3091,48767
2022-08-14 18:00:00,2022-08-14 19:00:00,64,0,17,2682,788,3551,50522
2022-08-14 19:00:00,2022-08-14 20:00:00,63,0,8,2807,866,3744,50815
2022-08-14 20:00:00,2022-08-14 21:00:00,63,0,8,1803,965,2839,49138
2022-08-14 21:00:00,2022-08-14 22:00:00,61,0,8,1331,1191,2591,46870
2022-08-14 22:00:00,2022-08-14 23:00:00,62,0,8,1840,1175,3085,45160
2022-08-14 23:00:00,2022-08-15 00:00:00,64,0,8,1442,1070,2584,43797
2022-08-15 00:00:00,2022-08-15 01:00:00,64,0,8,857,998,1927,42930
2022-08-15 01:00:00,2022-08-15 02:00:00,64,0,8,1469,815,2356,42328
2022-08-15 02:00:00,2022-08-15 03:00:00,62,0,8,1591,772,2433,42659
2022-08-15 03:00:00,2022-08-15 04:00:00,61,0,7,2008,1205,3281,44227
2022-08-15 04:00:00,2022-08-15 05:00:00,60,0,43,1494,1132,2729,46354
2022-08-15 05:00:00,2022-08-15 06:00:00,60,0,112,1524,1049,2745,47919
2022-08-15 06:00:00,2022-08-15 07:00:00,60,0,312,1146,994,2512,48462
2022-08-15 07:00:00,2022-08-15 08:00:00,61,0,555,1383,1494,3493,47130
2022-08-15 08:00:00,2022-08-15 09:00:00,60,0,788,2206,1455,4509,46365
2022-08-15 09:00:00,2022-08-15 10:00:00,60,0,942,2895,1268,5165,45414
2022-08-15 10:00:00,2022-08-15 11:00:00,60,0,811,1797,1063,3731,45178
2022-08-15 11:00:00,2022-08-15 12:00:00,60,0,664,1122,904,2750,45447
2022-08-15 12:00:00,2022-08-15 13:00:00,60,0,764,778,949,2551,44455
2022-08-15 13:00:00,2022-08-15 14:00:00,60,0,772,858,1640,3330,44109
2022-08-15 14:00:00,2022-08-15 15:00:00,59,0,843,766,1288,2956,45905
2022-08-15 15:00:00,2022-08-15 16:00:00,60,0,519,1154,1003,2736,48447
2022-08-15 16:00:00,2022-08-15 17:00:00,60,0,166,1611,977,2814,50653
2022-08-15 17:00:00,2022-08-15 18:00:00,61,0,96,1867,518,2542,52506
2022-08-15 18:00:00,2022-08-15 19:00:00,63,0,23,1969,479,2534,53445
2022-08-15 19:00:00,2022-08-15 20:00:00,61,0,8,2064,432,2565,53273
2022-08-15 20:00:00,2022-08-15 21:00:00,63,0,8,2744,449,3264,50970
2022-08-15 21:00:00,2022-08-15 22:00:00,62,0,8,2343,612,3025,48310
2022-08-15 22:00:00,2022-08-15 23:00:00,62,0,8,1797,956,2823,45093
2022-08-15 23:00:00,2022-08-16 00:00:00,62,0,8,1813,1445,3328,43551
2022-08-16 00:00:00,2022-08-16 01:00:00,63,0,8,1309,1679,3059,42774
2022-08-16 01:00:00,2022-08-16 02:00:00,64,0,8,950,1733,2755,42256
2022-08-16 02:00:00,2022-08-16 03:00:00,64,0,8,1221,1820,3113,42172
2022-08-16 03:00:00,2022-08-16 04:00:00,64,0,8,1363,1824,3259,43168
2022-08-16 04:00:00,2022-08-16 05:00:00,63,0,24,1054,2124,3265,45180
2022-08-16 05:00:00,2022-08-16 06:00:00,61,0,177,769,1934,2941,46146
2022-08-16 06:00:00,2022-08-16 07:00:00,61,0,503,578,1446,2588,45213
2022-08-16 07:00:00,2022-08-16 08:00:00,64,0,818,524,1024,2430,42524
2022-08-16 08:00:00,2022-08-16 09:00:00,64,0,1056,759,948,2827,39438
2022-08-16 09:00:00,2022-08-16 10:00:00,63,0,1186,632,1243,3124,37864
2022-08-16 10:00:00,2022-08-16 11:00:00,62,0,1203,488,1481,3234,37592
2022-08-16 11:00:00,2022-08-16 12:00:00,61,0,1172,559,1216,3008,38528
2022-08-16 12:00:00,2022-08-16 13:00:00,62,0,1131,552,1104,2849,39237
2022-08-16 13:00:00,2022-08-16 14:00:00,60,0,1011,528,890,2489,41529
2022-08-16 14:00:00,2022-08-16 15:00:00,57,0,747,571,732,2107,45785
2022-08-16 15:00:00,2022-08-16 16:00:00,60,0,487,499,561,1607,49613
2022-08-16 16:00:00,2022-08-16 17:00:00,62,0,261,273,557,1153,50954
2022-08-16 17:00:00,2022-08-16 18:00:00,61,0,130,240,506,937,52597
2022-08-16 18:00:00,2022-08-16 19:00:00,61,0,20,192,412,685,53275
2022-08-16 19:00:00,2022-08-16 20:00:00,61,0,4,118,411,594,52881
2022-08-16 20:00:00,2022-08-16 21:00:00,61,0,4,99,469,633,50886
2022-08-16 21:00:00,2022-08-16 22:00:00,63,0,4,137,726,930,48379
2022-08-16 22:00:00,2022-08-16 23:00:00,61,0,4,232,921,1218,45820
2022-08-16 23:00:00,2022-08-17 00:00:00,64,0,4,944,1111,2123,43635
2022-08-17 00:00:00,2022-08-17 01:00:00,64,0,4,598,1210,1876,42701
2022-08-17 01:00:00,2022-08-17 02:00:00,63,0,4,675,1441,2183,42336
2022-08-17 02:00:00,2022-08-17 03:00:00,64,0,4,485,1613,2166,42636
2022-08-17 03:00:00,2022-08-17 04:00:00,63,0,4,585,1203,1855,43990
2022-08-17 04:00:00,2022-08-17 05:00:00,62,0,16,743,1237,2058,46379
2022-08-17 05:00:00,2022-08-17 06:00:00,57,0,53,1416,1413,2939,49662
2022-08-17 06:00:00,2022-08-17 07:00:00,60,0,97,1240,2016,3413,51404
2022-08-17 07:00:00,2022-08-17 08:00:00,61,0,324,558,2001,2944,52332
2022-08-17 08:00:00,2022-08-17 09:00:00,61,0,461,244,2471,3237,50781
2022-08-17 09:00:00,2022-08-17 10:00:00,60,0,520,287,2820,3687,51144
2022-08-17 10:00:00,2022-08-17 11:00:00,60,0,612,235,2812,3719,52025
2022-08-17 11:00:00,2022-08-17 12:00:00,60,0,655,273,2395,3383,52344
2022-08-17 12:00:00,2022-08-17 13:00:00,60,0,485,783,2202,3530,52308
2022-08-17 13:00:00,2022-08-17 14:00:00,59,0,381,1044,2022,3506,51358
2022-08-17 14:00:00,2022-08-17 15:00:00,62,0,174,839,2476,3551,50878
2022-08-17 15:00:00,2022-08-17 16:00:00,64,0,50,1166,2599,3879,52738
2022-08-17 16:00:00,2022-08-17 17:00:00,64,0,45,1156,2594,3859,51989
2022-08-17 17:00:00,2022-08-17 18:00:00,63,0,26,624,1874,2587,52048
2022-08-17 18:00:00,2022-08-17 19:00:00,62,0,10,732,1457,2261,51979
2022-08-17 19:00:00,2022-08-17 20:00:00,63,0,8,964,1738,2773,51535
2022-08-17 20:00:00,2022-08-17 21:00:00,63,0,8,1262,1555,2888,49452
2022-08-17 21:00:00,2022-08-17 22:00:00,61,0,8,1199,1048,2316,46759
2022-08-17 22:00:00,2022-08-17 23:00:00,58,0,8,1076,848,1990,44711
2022-08-17 23:00:00,2022-08-18 00:00:00,62,0,8,929,703,1702,43747
2022-08-18 00:00:00,2022-08-18 01:00:00,64,0,8,816,606,1494,42929
2022-08-18 01:00:00,2022-08-18 02:00:00,64,0,8,1208,486,1766,42706
2022-08-18 02:00:00,2022-08-18 03:00:00,64,0,8,1558,469,2099,43021
2022-08-18 03:00:00,2022-08-18 04:00:00,64,0,8,1440,422,1934,44183
2022-08-18 04:00:00,2022-08-18 05:00:00,60,0,12,1136,483,1691,46037
2022-08-18 05:00:00,2022-08-18 06:00:00,57,0,95,1223,480,1855,47656
2022-08-18 06:00:00,2022-08-18 07:00:00,58,0,249,1029,677,2013,47622
2022-08-18 07:00:00,2022-08-18 08:00:00,58,0,333,912,868,2171,45871
2022-08-18 08:00:00,2022-08-18 09:00:00,61,0,534,727,794,2116,43850
2022-08-18 09:00:00,2022-08-18 10:00:00,60,0,582,584,739,1965,42744
2022-08-18 10:00:00,2022-08-18 11:00:00,60,0,671,237,671,1639,41596
2022-08-18 11:00:00,2022-08-18 12:00:00,61,0,732,147,546,1486,41045
2022-08-18 12:00:00,2022-08-18 13:00:00,62,0,1105,135,565,1867,40930
2022-08-18 13:00:00,2022-08-18 14:00:00,60,0,1057,161,531,1809,42731
2022-08-18 14:00:00,2022-08-18 15:00:00,60,0,852,94,506,1512,43269
2022-08-18 15:00:00,2022-08-18 16:00:00,64,0,768,125,531,1488,45901
2022-08-18 16:00:00,2022-08-18 17:00:00,64,0,440,126,553,1183,48294
2022-08-18 17:00:00,2022-08-18 18:00:00,64,0,144,125,450,783,51035
2022-08-18 18:00:00,2022-08-18 19:00:00,64,0,16,127,404,611,52765
2022-08-18 19:00:00,2022-08-18 20:00:00,64,0,8,232,483,787,52715
2022-08-18 20:00:00,2022-08-18 21:00:00,64,0,8,831,598,1501,50769
2022-08-18 21:00:00,2022-08-18 22:00:00,62,0,8,1625,724,2419,48442
2022-08-18 22:00:00,2022-08-18 23:00:00,61,0,8,1611,970,2650,45892
2022-08-18 23:00:00,2022-08-19 00:00:00,64,0,8,1024,1184,2280,44195
2022-08-19 00:00:00,2022-08-19 01:00:00,64,0,8,874,901,1847,43244
2022-08-19 01:00:00,2022-08-19 02:00:00,64,0,8,987,792,1851,42922
2022-08-19 02:00:00,2022-08-19 03:00:00,64,0,8,1148,909,2129,42573
2022-08-19 03:00:00,2022-08-19 04:00:00,64,0,8,1300,1062,2434,43759
2022-08-19 04:00:00,2022-08-19 05:00:00,63,0,14,1288,1022,2387,45533
2022-08-19 05:00:00,2022-08-19 06:00:00,61,0,173,1455,1056,2745,46078
2022-08-19 06:00:00,2022-08-19 07:00:00,61,0,499,1347,842,2749,45960
2022-08-19 07:00:00,2022-08-19 08:00:00,64,0,816,1320,922,3122,44801
2022-08-19 08:00:00,2022-08-19 09:00:00,63,0,1075,875,767,2780,42314
2022-08-19 09:00:00,2022-08-19 10:00:00,64,0,1171,768,593,2596,41109
2022-08-19 10:00:00,2022-08-19 11:00:00,63,0,1188,692,620,2563,40265
2022-08-19 11:00:00,2022-08-19 12:00:00,63,0,1069,673,768,2573,39980
2022-08-19 12:00:00,2022-08-19 13:00:00,64,0,874,753,997,2688,40524
2022-08-19 13:00:00,2022-08-19 14:00:00,62,0,798,887,1010,2757,42807
2022-08-19 14:00:00,2022-08-19 15:00:00,59,0,486,1110,1166,2821,45435
2022-08-19 15:00:00,2022-08-19 16:00:00,62,0,286,1774,1156,3278,49730
2022-08-19 16:00:00,2022-08-19 17:00:00,63,0,179,1317,1267,2826,50843
2022-08-19 17:00:00,2022-08-19 18:00:00,60,0,44,1586,1079,2769,51478
2022-08-19 18:00:00,2022-08-19 19:00:00,62,0,8,1269,1061,2400,51786
2022-08-19 19:00:00,2022-08-19 20:00:00,60,0,4,1239,1618,2921,51113
2022-08-19 20:00:00,2022-08-19 21:00:00,60,0,4,1551,1547,3162,49262
2022-08-19 21:00:00,2022-08-19 22:00:00,60,0,4,1024,982,2070,47095
2022-08-19 22:00:00,2022-08-19 23:00:00,62,0,4,952,833,1851,44689
2022-08-19 23:00:00,2022-08-20 00:00:00,64,0,4,1052,865,1985,43009
2022-08-20 00:00:00,2022-08-20 01:00:00,64,0,4,717,682,1467,42214
2022-08-20 01:00:00,2022-08-20 02:00:00,64,0,4,526,584,1178,41836
2022-08-20 02:00:00,2022-08-20 03:00:00,64,0,4,591,543,1202,41491
2022-08-20 03:00:00,2022-08-20 04:00:00,64,0,4,390,501,959,41605
2022-08-20 04:00:00,2022-08-20 05:00:00,62,0,14,276,437,789,41520
2022-08-20 05:00:00,2022-08-20 06:00:00,60,0,97,203,384,744,40005
2022-08-20 06:00:00,2022-08-20 07:00:00,60,0,437,279,286,1062,38051
2022-08-20 07:00:00,2022-08-20 08:00:00,60,0,685,667,261,1673,35995
2022-08-20 08:00:00,2022-08-20 09:00:00,60,0,1058,943,352,2413,32480
2022-08-20 09:00:00,2022-08-20 10:00:00,61,0,1207,1039,692,2999,30381
2022-08-20 10:00:00,2022-08-20 11:00:00,63,0,1093,1255,1017,3428,29257
2022-08-20 11:00:00,2022-08-20 12:00:00,64,0,869,1781,1207,3921,28994
2022-08-20 12:00:00,2022-08-20 13:00:00,62,0,911,2211,1249,4433,28810
2022-08-20 13:00:00,2022-08-20 14:00:00,58,0,850,2173,1373,4454,29858
2022-08-20 14:00:00,2022-08-20 15:00:00,57,0,775,2387,1539,4758,32696
2022-08-20 15:00:00,2022-08-20 16:00:00,61,0,527,2608,1982,5178,36985
2022-08-20 16:00:00,2022-08-20 17:00:00,63,0,318,2740,1854,4975,40554
2022-08-20 17:00:00,2022-08-20 18:00:00,60,0,126,2513,1094,3793,43968
2022-08-20 18:00:00,2022-08-20 19:00:00,60,0,11,2694,891,3656,46146
2022-08-20 19:00:00,2022-08-20 20:00:00,60,0,4,3429,853,4346,46701
2022-08-20 20:00:00,2022-08-20 21:00:00,64,0,4,4398,850,5316,45229
2022-08-20 21:00:00,2022-08-20 22:00:00,60,0,4,4273,1031,5368,43499
2022-08-20 22:00:00,2022-08-20 23:00:00,62,0,4,3880,1232,5178,41604
2022-08-20 23:00:00,2022-08-21 00:00:00,64,0,4,3143,1525,4736,39961
2022-08-21 00:00:00,2022-08-21 01:00:00,64,0,4,2648,1528,4244,38825
2022-08-21 01:00:00,2022-08-21 02:00:00,64,0,4,2596,1631,4295,38360
2022-08-21 02:00:00,2022-08-21 03:00:00,64,0,4,2618,1895,4581,38081
2022-08-21 03:00:00,2022-08-21 04:00:00,64,0,4,2269,2275,4612,38009
2022-08-21 04:00:00,2022-08-21 05:00:00,63,0,25,2156,2185,4429,37231
2022-08-21 05:00:00,2022-08-21 06:00:00,61,0,184,1969,2236,4450,35207
2022-08-21 06:00:00,2022-08-21 07:00:00,61,0,519,1774,1854,4208,32966
2022-08-21 07:00:00,2022-08-21 08:00:00,64,0,880,1492,1351,3787,30986
2022-08-21 08:00:00,2022-08-21 09:00:00,64,0,1083,1466,1351,3964,29274
2022-08-21 09:00:00,2022-08-21 10:00:00,64,0,1044,1152,1617,3877,28159
2022-08-21 10:00:00,2022-08-21 11:00:00,64,0,1214,1571,1560,4409,27546
2022-08-21 11:00:00,2022-08-21 12:00:00,63,0,1007,1774,1451,4295,27147
2022-08-21 12:00:00,2022-08-21 13:00:00,61,0,780,1483,1544,3868,27797
2022-08-21 13:00:00,2022-08-21 14:00:00,59,0,628,841,1444,2972,30008
2022-08-21 14:00:00,2022-08-21 15:00:00,57,0,679,677,1188,2601,34008
2022-08-21 15:00:00,2022-08-21 16:00:00,61,0,317,314,1203,1895,38883
2022-08-21 16:00:00,2022-08-21 17:00:00,60,0,149,242,1024,1475,42885
2022-08-21 17:00:00,2022-08-21 18:00:00,59,0,83,273,664,1079,45541
2022-08-21 18:00:00,2022-08-21 19:00:00,60,0,7,175,426,668,47441
2022-08-21 19:00:00,2022-08-21 20:00:00,60,0,4,124,370,558,47504
2022-08-21 20:00:00,2022-08-21 21:00:00,60,0,4,118,360,542,45935
2022-08-21 21:00:00,2022-08-21 22:00:00,59,0,4,100,386,549,43890
2022-08-21 22:00:00,2022-08-21 23:00:00,54,0,4,119,426,603,42521
2022-08-21 23:00:00,2022-08-22 00:00:00,62,0,4,122,453,641,41270
2022-08-22 00:00:00,2022-08-22 01:00:00,64,0,4,120,430,618,40558
2022-08-22 01:00:00,2022-08-22 02:00:00,64,0,4,161,406,635,40371
2022-08-22 02:00:00,2022-08-22 03:00:00,64,0,4,340,424,832,40649
2022-08-22 03:00:00,2022-08-22 04:00:00,64,0,4,306,478,852,42073
2022-08-22 04:00:00,2022-08-22 05:00:00,62,0,23,273,561,919,44579
2022-08-22 05:00:00,2022-08-22 06:00:00,59,0,110,266,514,949,47520
2022-08-22 06:00:00,2022-08-22 07:00:00,61,0,190,325,497,1073,47509
2022-08-22 07:00:00,2022-08-22 08:00:00,63,0,367,574,459,1463,44387
2022-08-22 08:00:00,2022-08-22 09:00:00,64,0,704,596,571,1935,40621
2022-08-22 09:00:00,2022-08-22 10:00:00,62,0,915,479,449,1905,37984
2022-08-22 10:00:00,2022-08-22 11:00:00,61,0,964,275,444,1744,36102
2022-08-22 11:00:00,2022-08-22 12:00:00,61,0,1100,330,359,1850,36104
2022-08-22 12:00:00,2022-08-22 13:00:00,62,0,1064,419,333,1878,37465
2022-08-22 13:00:00,2022-08-22 14:00:00,61,0,1120,673,348,2202,38813
2022-08-22 14:00:00,2022-08-22 15:00:00,60,0,915,1337,431,2743,41677
2022-08-22 15:00:00,2022-08-22 16:00:00,60,0,568,1841,573,3042,46152
2022-08-22 16:00:00,2022-08-22 17:00:00,63,0,318,1989,759,3129,48307
2022-08-22 17:00:00,2022-08-22 18:00:00,61,0,146,1512,925,2644,51376
2022-08-22 18:00:00,2022-08-22 19:00:00,61,0,8,1633,1115,2817,52717
2022-08-22 19:00:00,2022-08-22 20:00:00,64,0,4,1463,1250,2781,52004
2022-08-22 20:00:00,2022-08-22 21:00:00,62,0,4,1226,1535,2827,49394
2022-08-22 21:00:00,2022-08-22 22:00:00,58,0,4,1254,1756,3072,46864
2022-08-22 22:00:00,2022-08-22 23:00:00,62,0,4,1138,1531,2735,44472
2022-08-22 23:00:00,2022-08-23 00:00:00,59,0,4,1066,1313,2442,42945
2022-08-23 00:00:00,2022-08-23 01:00:00,60,0,4,682,1100,1846,42118
2022-08-23 01:00:00,2022-08-23 02:00:00,60,0,4,582,860,1506,41587
2022-08-23 02:00:00,2022-08-23 03:00:00,60,0,4,506,736,1306,41768
2022-08-23 03:00:00,2022-08-23 04:00:00,60,0,4,280,646,990,43482
2022-08-23 04:00:00,2022-08-23 05:00:00,59,0,23,206,565,853,46071
2022-08-23 05:00:00,2022-08-23 06:00:00,59,0,161,447,483,1150,48458
2022-08-23 06:00:00,2022-08-23 07:00:00,59,0,473,433,412,1377,47593
2022-08-23 07:00:00,2022-08-23 08:00:00,63,0,782,670,351,1866,44364
2022-08-23 08:00:00,2022-08-23 09:00:00,64,0,1065,905,309,2343,41256
2022-08-23 09:00:00,2022-08-23 10:00:00,62,0,1226,646,368,2302,38814
2022-08-23 10:00:00,2022-08-23 11:00:00,60,0,1272,735,458,2525,37428
2022-08-23 11:00:00,2022-08-23 12:00:00,60,0,1256,705,578,2599,38586
2022-08-23 12:00:00,2022-08-23 13:00:00,60,0,1068,717,480,2325,39727
2022-08-23 13:00:00,2022-08-23 14:00:00,60,0,912,600,422,1994,40419
2022-08-23 14:00:00,2022-08-23 15:00:00,59,0,628,683,432,1802,43318
2022-08-23 15:00:00,2022-08-23 16:00:00,57,0,632,1365,494,2548,48287
2022-08-23 16:00:00,2022-08-23 17:00:00,60,0,284,1696,550,2590,51039
2022-08-23 17:00:00,2022-08-23 18:00:00,60,0,97,1295,678,2130,53863
2022-08-23 18:00:00,2022-08-23 19:00:00,60,0,9,1156,564,1789,55335
2022-08-23 19:00:00,2022-08-23 20:00:00,60,0,4,1259,475,1798,55037
2022-08-23 20:00:00,2022-08-23 21:00:00,60,0,4,1406,426,1896,52811
2022-08-23 21:00:00,2022-08-23 22:00:00,60,0,4,1055,408,1527,50134
2022-08-23 22:00:00,2022-08-23 23:00:00,60,0,4,899,376,1339,47511
2022-08-23 23:00:00,2022-08-24 00:00:00,60,0,4,788,373,1225,45435
2022-08-24 00:00:00,2022-08-24 01:00:00,60,0,4,608,388,1060,44257
2022-08-24 01:00:00,2022-08-24 02:00:00,60,0,4,637,420,1121,43784
2022-08-24 02:00:00,2022-08-24 03:00:00,60,0,4,842,476,1382,43718
2022-08-24 03:00:00,2022-08-24 04:00:00,60,0,4,792,471,1327,45173
2022-08-24 04:00:00,2022-08-24 05:00:00,60,0,19,758,570,1407,47758
2022-08-24 05:00:00,2022-08-24 06:00:00,58,0,160,763,615,1596,49271
2022-08-24 06:00:00,2022-08-24 07:00:00,60,0,473,654,486,1673,48042
2022-08-24 07:00:00,2022-08-24 08:00:00,61,0,823,358,434,1676,45111
2022-08-24 08:00:00,2022-08-24 09:00:00,60,0,1089,247,375,1771,41716
2022-08-24 09:00:00,2022-08-24 10:00:00,60,0,1241,229,394,1924,39522
2022-08-24 10:00:00,2022-08-24 11:00:00,60,0,1294,234,348,1936,38866
2022-08-24 11:00:00,2022-08-24 12:00:00,60,0,1240,115,333,1748,39818
2022-08-24 12:00:00,2022-08-24 13:00:00,63,0,1196,105,340,1704,41116
2022-08-24 13:00:00,2022-08-24 14:00:00,60,0,921,120,371,1472,43116
2022-08-24 14:00:00,2022-08-24 15:00:00,58,0,795,173,428,1454,46100
2022-08-24 15:00:00,2022-08-24 16:00:00,58,0,619,308,502,1487,50845
2022-08-24 16:00:00,2022-08-24 17:00:00,62,0,263,384,848,1557,52590
2022-08-24 17:00:00,2022-08-24 18:00:00,63,0,77,758,1197,2095,55137
2022-08-24 18:00:00,2022-08-24 19:00:00,60,0,7,1418,1462,2947,56335
2022-08-24 19:00:00,2022-08-24 20:00:00,61,0,4,2088,2063,4216,55410
2022-08-24 20:00:00,2022-08-24 21:00:00,62,0,4,2808,2675,5549,52704
2022-08-24 21:00:00,2022-08-24 22:00:00,61,0,4,3241,2813,6119,50002
2022-08-24 22:00:00,2022-08-24 23:00:00,60,0,4,3180,2629,5873,46893
2022-08-24 23:00:00,2022-08-25 00:00:00,63,0,4,2679,2351,5097,45162
2022-08-25 00:00:00,2022-08-25 01:00:00,62,0,4,2386,2248,4700,44152
2022-08-25 01:00:00,2022-08-25 02:00:00,61,0,4,2221,2386,4672,43501
2022-08-25 02:00:00,2022-08-25 03:00:00,62,0,4,1962,2436,4464,43513
2022-08-25 03:00:00,2022-08-25 04:00:00,62,0,4,1701,2341,4108,44156
2022-08-25 04:00:00,2022-08-25 05:00:00,60,0,18,1751,2360,4189,46906
2022-08-25 05:00:00,2022-08-25 06:00:00,60,0,160,1529,2370,4119,48903
2022-08-25 06:00:00,2022-08-25 07:00:00,59,0,459,1957,1978,4453,47805
2022-08-25 07:00:00,2022-08-25 08:00:00,60,0,810,1689,1323,3882,44663
2022-08-25 08:00:00,2022-08-25 09:00:00,62,0,1070,1884,1107,4123,41453
2022-08-25 09:00:00,2022-08-25 10:00:00,62,0,1273,2400,1094,4829,39407
2022-08-25 10:00:00,2022-08-25 11:00:00,64,0,1333,2822,1388,5607,38069
2022-08-25 11:00:00,2022-08-25 12:00:00,63,0,1325,2739,1248,5375,37753
2022-08-25 12:00:00,2022-08-25 13:00:00,62,0,1292,3537,1214,6105,38291
2022-08-25 13:00:00,2022-08-25 14:00:00,57,0,1224,4249,1109,6639,40765
2022-08-25 14:00:00,2022-08-25 15:00:00,57,0,987,3807,1670,6521,45055
2022-08-25 15:00:00,2022-08-25 16:00:00,61,0,667,3559,1345,5632,50237
2022-08-25 16:00:00,2022-08-25 17:00:00,60,0,349,3557,1228,5194,53369
2022-08-25 17:00:00,2022-08-25 18:00:00,62,0,88,3599,1700,5449,56064
2022-08-25 18:00:00,2022-08-25 19:00:00,61,0,4,4379,2234,6678,56603
2022-08-25 19:00:00,2022-08-25 20:00:00,62,0,4,4797,3055,7918,55434
2022-08-25 20:00:00,2022-08-25 21:00:00,59,0,4,5141,3611,8815,52535
2022-08-25 21:00:00,2022-08-25 22:00:00,60,0,4,4651,4097,8812,49426
2022-08-25 22:00:00,2022-08-25 23:00:00,62,0,4,4315,3833,8214,46598
2022-08-25 23:00:00,2022-08-26 00:00:00,63,0,4,4248,3543,7858,44758
2022-08-26 00:00:00,2022-08-26 01:00:00,62,0,4,3850,3130,7046,43308
2022-08-26 01:00:00,2022-08-26 02:00:00,63,0,4,3747,3027,6841,42883
2022-08-26 02:00:00,2022-08-26 03:00:00,62,0,4,3692,2892,6650,42901
2022-08-26 03:00:00,2022-08-26 04:00:00,62,0,4,3440,2695,6201,44283
2022-08-26 04:00:00,2022-08-26 05:00:00,61,0,14,3055,2728,5858,47004
2022-08-26 05:00:00,2022-08-26 06:00:00,58,0,80,3319,2781,6238,50583
2022-08-26 06:00:00,2022-08-26 07:00:00,57,0,169,4024,2738,6988,52736
2022-08-26 07:00:00,2022-08-26 08:00:00,60,0,296,3737,2838,6931,52928
2022-08-26 08:00:00,2022-08-26 09:00:00,62,0,401,2853,2757,6073,52039
2022-08-26 09:00:00,2022-08-26 10:00:00,62,0,316,2352,2710,5440,51489
2022-08-26 10:00:00,2022-08-26 11:00:00,62,0,400,1797,2633,4892,50200
2022-08-26 11:00:00,2022-08-26 12:00:00,61,0,469,1708,2388,4626,49834
2022-08-26 12:00:00,2022-08-26 13:00:00,62,0,429,1885,2491,4867,49303
2022-08-26 13:00:00,2022-08-26 14:00:00,61,0,470,1878,2688,5097,48753
2022-08-26 14:00:00,2022-08-26 15:00:00,58,0,304,1974,2957,5293,47873
2022-08-26 15:00:00,2022-08-26 16:00:00,62,0,223,1790,2992,5067,49353
2022-08-26 16:00:00,2022-08-26 17:00:00,64,0,129,1708,2712,4613,49939
2022-08-26 17:00:00,2022-08-26 18:00:00,64,0,44,1646,2390,4144,50918
2022-08-26 18:00:00,2022-08-26 19:00:00,63,0,5,1290,2170,3528,51044
2022-08-26 19:00:00,2022-08-26 20:00:00,62,0,4,1125,1873,3064,49872
2022-08-26 20:00:00,2022-08-26 21:00:00,62,0,4,1029,1505,2600,47846
2022-08-26 21:00:00,2022-08-26 22:00:00,60,0,4,728,1172,1964,46009
2022-08-26 22:00:00,2022-08-26 23:00:00,61,0,4,667,901,1633,43403
2022-08-26 23:00:00,2022-08-27 00:00:00,64,0,4,639,769,1476,41496
2022-08-27 00:00:00,2022-08-27 01:00:00,63,0,4,869,806,1742,40787
2022-08-27 01:00:00,2022-08-27 02:00:00,63,0,4,1087,800,1954,40114
2022-08-27 02:00:00,2022-08-27 03:00:00,64,0,4,1180,857,2105,39762
2022-08-27 03:00:00,2022-08-27 04:00:00,63,0,4,1445,904,2416,39851
2022-08-27 04:00:00,2022-08-27 05:00:00,62,0,10,1666,1102,2840,40168
2022-08-27 05:00:00,2022-08-27 06:00:00,61,0,147,1802,1070,3080,39779
2022-08-27 06:00:00,2022-08-27 07:00:00,58,0,402,1758,1078,3296,38970
2022-08-27 07:00:00,2022-08-27 08:00:00,62,0,542,1813,1304,3721,37703
2022-08-27 08:00:00,2022-08-27 09:00:00,64,0,653,2040,1524,4281,36420
2022-08-27 09:00:00,2022-08-27 10:00:00,63,0,720,2090,1517,4390,35939
2022-08-27 10:00:00,2022-08-27 11:00:00,61,0,852,2203,1629,4745,35011
2022-08-27 11:00:00,2022-08-27 12:00:00,62,0,938,2306,1718,5024,34291
2022-08-27 12:00:00,2022-08-27 13:00:00,62,0,937,2658,2021,5678,33999
2022-08-27 13:00:00,2022-08-27 14:00:00,61,0,940,2875,2127,6003,35666
2022-08-27 14:00:00,2022-08-27 15:00:00,59,0,746,3511,2854,7170,38926
2022-08-27 15:00:00,2022-08-27 16:00:00,63,0,441,4193,3428,8125,42376
2022-08-27 16:00:00,2022-08-27 17:00:00,64,0,195,4875,3676,8810,43985
2022-08-27 17:00:00,2022-08-27 18:00:00,64,0,77,5019,3224,8384,45360
2022-08-27 18:00:00,2022-08-27 19:00:00,64,0,9,5293,3064,8430,46478
2022-08-27 19:00:00,2022-08-27 20:00:00,63,0,8,5419,2881,8371,46143
2022-08-27 20:00:00,2022-08-27 21:00:00,64,0,8,5095,2472,7639,44505
2022-08-27 21:00:00,2022-08-27 22:00:00,60,0,8,5482,2289,7839,42557
2022-08-27 22:00:00,2022-08-27 23:00:00,59,0,8,5069,2273,7409,41045
2022-08-27 23:00:00,2022-08-28 00:00:00,63,0,8,4698,2305,7074,39705
2022-08-28 00:00:00,2022-08-28 01:00:00,60,0,8,4417,2370,6855,38587
2022-08-28 01:00:00,2022-08-28 02:00:00,64,0,8,4283,2230,6585,38065
2022-08-28 02:00:00,2022-08-28 03:00:00,62,0,8,4332,2194,6596,37744
2022-08-28 03:00:00,2022-08-28 04:00:00,60,0,8,4355,2288,6711,37876
2022-08-28 04:00:00,2022-08-28 05:00:00,60,0,18,4613,2366,7057,37792
2022-08-28 05:00:00,2022-08-28 06:00:00,59,0,156,4758,2443,7416,36164
2022-08-28 06:00:00,2022-08-28 07:00:00,63,0,488,4588,2176,7315,33810
2022-08-28 07:00:00,2022-08-28 08:00:00,64,0,753,3881,2523,7221,31278
2022-08-28 08:00:00,2022-08-28 09:00:00,64,0,929,3487,2884,7364,29570
2022-08-28 09:00:00,2022-08-28 10:00:00,64,0,907,3357,2767,7095,28260
2022-08-28 10:00:00,2022-08-28 11:00:00,63,0,995,3027,2586,6671,28080
2022-08-28 11:00:00,2022-08-28 12:00:00,63,0,1013,2332,2384,5792,27773
2022-08-28 12:00:00,2022-08-28 13:00:00,63,0,849,2227,2260,5399,28154
2022-08-28 13:00:00,2022-08-28 14:00:00,64,0,795,2816,2408,6083,29437
2022-08-28 14:00:00,2022-08-28 15:00:00,63,0,593,3898,2727,7281,32519
2022-08-28 15:00:00,2022-08-28 16:00:00,63,0,412,4094,2851,7420,37782
2022-08-28 16:00:00,2022-08-28 17:00:00,61,0,228,4197,2881,7367,41486
2022-08-28 17:00:00,2022-08-28 18:00:00,62,0,61,4147,2633,6903,45204
2022-08-28 18:00:00,2022-08-28 19:00:00,63,0,4,4026,2546,6639,46849
2022-08-28 19:00:00,2022-08-28 20:00:00,64,0,4,3607,2172,5847,46400
2022-08-28 20:00:00,2022-08-28 21:00:00,62,0,4,3092,1741,4899,44530
2022-08-28 21:00:00,2022-08-28 22:00:00,59,0,4,2613,1323,3999,42456
2022-08-28 22:00:00,2022-08-28 23:00:00,62,0,4,2369,1394,3829,41161
2022-08-28 23:00:00,2022-08-29 00:00:00,63,0,4,2195,1259,3521,40140
2022-08-29 00:00:00,2022-08-29 01:00:00,62,0,4,2363,833,3262,39472
2022-08-29 01:00:00,2022-08-29 02:00:00,62,0,4,2206,701,2973,39423
2022-08-29 02:00:00,2022-08-29 03:00:00,61,0,4,1563,646,2274,39555
2022-08-29 03:00:00,2022-08-29 04:00:00,60,0,4,1045,651,1760,41091
2022-08-29 04:00:00,2022-08-29 05:00:00,60,0,18,1129,641,1848,44642
2022-08-29 05:00:00,2022-08-29 06:00:00,59,0,139,1472,801,2471,47653
2022-08-29 06:00:00,2022-08-29 07:00:00,61,0,345,1437,755,2598,47644
2022-08-29 07:00:00,2022-08-29 08:00:00,62,0,401,1519,786,2768,45428
2022-08-29 08:00:00,2022-08-29 09:00:00,61,0,642,1127,805,2635,42815
2022-08-29 09:00:00,2022-08-29 10:00:00,60,0,572,933,792,2357,41624
2022-08-29 10:00:00,2022-08-29 11:00:00,61,0,683,1000,832,2576,39692
2022-08-29 11:00:00,2022-08-29 12:00:00,63,0,863,922,971,2819,38277
2022-08-29 12:00:00,2022-08-29 13:00:00,64,0,838,1127,1161,3190,37354
2022-08-29 13:00:00,2022-08-29 14:00:00,63,0,698,1450,1442,3653,38102
2022-08-29 14:00:00,2022-08-29 15:00:00,61,0,617,2061,1738,4477,40735
2022-08-29 15:00:00,2022-08-29 16:00:00,61,0,451,2539,1884,4935,45540
2022-08-29 16:00:00,2022-08-29 17:00:00,61,0,284,2809,2150,5304,47983
2022-08-29 17:00:00,2022-08-29 18:00:00,25,0,93,3253,1902,5273,50597
2022-08-29 18:00:00,2022-08-29 19:00:00,8,0,4,3850,2216,6078,51899
2022-08-29 19:00:00,2022-08-29 20:00:00,12,0,4,4813,2607,7436,50394
2022-08-29 20:00:00,2022-08-29 21:00:00,10,0,4,4521,2673,7208,47587
2022-08-29 21:00:00,2022-08-29 22:00:00,8,0,4,3982,2755,6749,45254
2022-08-29 22:00:00,2022-08-29 23:00:00,8,0,4,4542,2473,7027,42934
2022-08-29 23:00:00,2022-08-30 00:00:00,8,0,4,4765,2197,6974,41454
2022-08-30 00:00:00,2022-08-30 01:00:00,5,0,4,4203,2160,6372,40558
2022-08-30 01:00:00,2022-08-30 02:00:00,4,0,4,3456,2156,5620,39983
2022-08-30 02:00:00,2022-08-30 03:00:00,4,0,4,2715,1980,4703,40171
2022-08-30 03:00:00,2022-08-30 04:00:00,4,0,4,2641,1914,4563,41244
2022-08-30 04:00:00,2022-08-30 05:00:00,4,0,8,3198,1966,5176,44418
2022-08-30 05:00:00,2022-08-30 06:00:00,4,0,139,3635,2011,5789,46706
2022-08-30 06:00:00,2022-08-30 07:00:00,5,0,467,3805,1660,5937,44937
2022-08-30 07:00:00,2022-08-30 08:00:00,4,0,834,4376,1892,7106,41263
2022-08-30 08:00:00,2022-08-30 09:00:00,4,0,1090,4407,2669,8170,37684
2022-08-30 09:00:00,2022-08-30 10:00:00,4,0,1253,4253,3123,8633,34694
2022-08-30 10:00:00,2022-08-30 11:00:00,4,0,1303,4335,3006,8648,32631
2022-08-30 11:00:00,2022-08-30 12:00:00,4,0,1279,5034,2688,9005,32370
2022-08-30 12:00:00,2022-08-30 13:00:00,4,0,1103,6068,2477,9652,33003
2022-08-30 13:00:00,2022-08-30 14:00:00,4,0,1031,6637,2345,10017,35579
2022-08-30 14:00:00,2022-08-30 15:00:00,4,0,886,7321,2522,10733,40220
2022-08-30 15:00:00,2022-08-30 16:00:00,4,0,629,7584,2791,11008,45528
2022-08-30 16:00:00,2022-08-30 17:00:00,4,0,298,7942,3048,11292,48052
2022-08-30 17:00:00,2022-08-30 18:00:00,4,0,73,8471,3114,11662,50581
2022-08-30 18:00:00,2022-08-30 19:00:00,4,0,5,8308,3402,11719,51842
2022-08-30 19:00:00,2022-08-30 20:00:00,4,0,4,8085,3801,11894,50399
2022-08-30 20:00:00,2022-08-30 21:00:00,4,0,4,8059,3868,11935,47429
2022-08-30 21:00:00,2022-08-30 22:00:00,4,0,4,7766,3886,11660,44965
2022-08-30 22:00:00,2022-08-30 23:00:00,4,0,4,7402,3907,11317,42590
2022-08-30 23:00:00,2022-08-31 00:00:00,4,0,4,6922,3758,10688,41041
2022-08-31 00:00:00,2022-08-31 01:00:00,4,0,4,6379,3509,9896,40150
2022-08-31 01:00:00,2022-08-31 02:00:00,4,0,4,5898,3412,9318,39649
2022-08-31 02:00:00,2022-08-31 03:00:00,4,0,4,5698,3499,9205,39600
2022-08-31 03:00:00,2022-08-31 04:00:00,4,0,4,5142,3726,8876,40872
2022-08-31 04:00:00,2022-08-31 05:00:00,4,0,11,5295,3949,9259,44136
2022-08-31 05:00:00,2022-08-31 06:00:00,4,0,134,6147,3594,9879,46978
2022-08-31 06:00:00,2022-08-31 07:00:00,4,0,470,6852,3046,10372,45518
2022-08-31 07:00:00,2022-08-31 08:00:00,4,0,852,7349,2991,11196,41558
2022-08-31 08:00:00,2022-08-31 09:00:00,4,0,1157,7684,3937,12782,37575
2022-08-31 09:00:00,2022-08-31 10:00:00,4,0,1300,7771,4132,13207,34699
2022-08-31 10:00:00,2022-08-31 11:00:00,4,0,1353,7240,4151,12748,32447
2022-08-31 11:00:00,2022-08-31 12:00:00,4,0,1394,7128,3893,12419,31928
2022-08-31 12:00:00,2022-08-31 13:00:00,4,0,1362,7202,3809,12377,32994
2022-08-31 13:00:00,2022-08-31 14:00:00,4,0,1273,6867,3396,11540,35666
2022-08-31 14:00:00,2022-08-31 15:00:00,4,0,1041,7262,3296,11603,39830
2022-08-31 15:00:00,2022-08-31 16:00:00,4,0,687,7575,3418,11684,45222
2022-08-31 16:00:00,2022-08-31 17:00:00,4,0,331,7872,3643,11850,48366
2022-08-31 17:00:00,2022-08-31 18:00:00,4,0,70,8117,3721,11912,51330
2022-08-31 18:00:00,2022-08-31 19:00:00,4,0,4,8236,4492,12736,52451
2022-08-31 19:00:00,2022-08-31 20:00:00,4,0,4,7837,5028,12873,50910
2022-08-31 20:00:00,2022-08-31 21:00:00,4,0,4,8077,5018,13103,48161
2022-08-31 21:00:00,2022-08-31 22:00:00,4,0,4,7979,4851,12838,45536
2022-08-31 22:00:00,2022-08-31 23:00:00,4,0,4,7586,4738,12332,43098
2022-08-31 23:00:00,2022-09-01 00:00:00,4,0,4,7010,4514,11532,41481
2022-09-01 00:00:00,2022-09-01 01:00:00,4,0,4,5805,4037,9850,40451
2022-09-01 01:00:00,2022-09-01 02:00:00,4,0,4,4809,3658,8475,39769
2022-09-01 02:00:00,2022-09-01 03:00:00,4,0,4,3651,3212,6871,39799
2022-09-01 03:00:00,2022-09-01 04:00:00,4,0,4,3159,2902,6069,41221
2022-09-01 04:00:00,2022-09-01 05:00:00,4,0,12,3011,2783,5810,44705
2022-09-01 05:00:00,2022-09-01 06:00:00,4,0,133,2751,2433,5321,47045
2022-09-01 06:00:00,2022-09-01 07:00:00,4,0,431,2488,1736,4659,45591
2022-09-01 07:00:00,2022-09-01 08:00:00,4,0,782,2302,1168,4256,41477
2022-09-01 08:00:00,2022-09-01 09:00:00,4,0,1124,2031,1168,4327,37026
2022-09-01 09:00:00,2022-09-01 10:00:00,4,0,1306,1891,1877,5078,33920
2022-09-01 10:00:00,2022-09-01 11:00:00,4,0,1290,2198,2262,5754,32338
2022-09-01 11:00:00,2022-09-01 12:00:00,4,0,1264,2390,2246,5904,32106
2022-09-01 12:00:00,2022-09-01 13:00:00,4,0,1132,2284,2137,5557,32971
2022-09-01 13:00:00,2022-09-01 14:00:00,4,0,1038,2256,2075,5373,35342
2022-09-01 14:00:00,2022-09-01 15:00:00,4,0,891,2431,1946,5272,39419
2022-09-01 15:00:00,2022-09-01 16:00:00,4,0,684,2880,1932,5500,44900
2022-09-01 16:00:00,2022-09-01 17:00:00,4,0,309,3726,2251,6290,48890
2022-09-01 17:00:00,2022-09-01 18:00:00,4,0,62,4462,2351,6879,52427
2022-09-01 18:00:00,2022-09-01 19:00:00,4,0,3,4682,3269,7958,53408
2022-09-01 19:00:00,2022-09-01 20:00:00,4,0,4,4847,3953,8808,51296
2022-09-01 20:00:00,2022-09-01 21:00:00,4,0,4,4621,4536,9165,47979
2022-09-01 21:00:00,2022-09-01 22:00:00,4,0,4,4425,4898,9331,45419
2022-09-01 22:00:00,2022-09-01 23:00:00,4,0,4,4476,4889,9373,43200
2022-09-01 23:00:00,2022-09-02 00:00:00,4,0,4,4706,4579,9293,41477
2022-09-02 00:00:00,2022-09-02 01:00:00,4,0,4,3801,4168,7977,40491
2022-09-02 01:00:00,2022-09-02 02:00:00,4,0,4,3172,3880,7060,39918
2022-09-02 02:00:00,2022-09-02 03:00:00,4,0,4,2542,3605,6155,39708
2022-09-02 03:00:00,2022-09-02 04:00:00,4,0,4,1764,3474,5246,40738
2022-09-02 04:00:00,2022-09-02 05:00:00,4,0,11,1375,3427,4817,44217
2022-09-02 05:00:00,2022-09-02 06:00:00,4,0,130,1412,2974,4520,47012
2022-09-02 06:00:00,2022-09-02 07:00:00,4,0,426,1376,2283,4089,46829
2022-09-02 07:00:00,2022-09-02 08:00:00,4,0,786,1492,1675,3957,43883
2022-09-02 08:00:00,2022-09-02 09:00:00,4,0,1079,1580,1599,4262,40066
2022-09-02 09:00:00,2022-09-02 10:00:00,4,0,1267,1843,1901,5015,37340
2022-09-02 10:00:00,2022-09-02 11:00:00,4,0,1159,2167,2464,5794,34708
2022-09-02 11:00:00,2022-09-02 12:00:00,4,0,1337,2444,2593,6378,34208
2022-09-02 12:00:00,2022-09-02 13:00:00,4,0,1280,2556,2408,6248,35975
2022-09-02 13:00:00,2022-09-02 14:00:00,4,0,1021,2484,1642,5151,37546
2022-09-02 14:00:00,2022-09-02 15:00:00,4,0,902,2485,1602,4993,40812
2022-09-02 15:00:00,2022-09-02 16:00:00,8,0,546,2362,1839,4755,45928
2022-09-02 16:00:00,2022-09-02 17:00:00,8,0,197,2794,2048,5047,49054
2022-09-02 17:00:00,2022-09-02 18:00:00,8,0,64,4294,2323,6689,51495
2022-09-02 18:00:00,2022-09-02 19:00:00,9,0,4,3733,3212,6958,52250
2022-09-02 19:00:00,2022-09-02 20:00:00,8,0,4,2515,4121,6648,50079
2022-09-02 20:00:00,2022-09-02 21:00:00,8,0,4,2897,4486,7395,47575
2022-09-02 21:00:00,2022-09-02 22:00:00,8,0,4,3292,4631,7935,45487
2022-09-02 22:00:00,2022-09-02 23:00:00,8,0,4,3249,4594,7855,43043
2022-09-02 23:00:00,2022-09-03 00:00:00,8,0,4,3390,4363,7765,40928
2022-09-03 00:00:00,2022-09-03 01:00:00,8,0,4,3419,4493,7924,39874
2022-09-03 01:00:00,2022-09-03 02:00:00,10,0,4,3233,4175,7422,39215
2022-09-03 02:00:00,2022-09-03 03:00:00,12,0,4,2960,3835,6811,38864
2022-09-03 03:00:00,2022-09-03 04:00:00,12,0,4,2969,3404,6389,39203
2022-09-03 04:00:00,2022-09-03 05:00:00,12,0,9,2965,3310,6296,40171
2022-09-03 05:00:00,2022-09-03 06:00:00,12,0,109,2690,3301,6112,39693
2022-09-03 06:00:00,2022-09-03 07:00:00,12,0,404,2678,2662,5756,38314
2022-09-03 07:00:00,2022-09-03 08:00:00,12,0,784,2301,1964,5061,35711
2022-09-03 08:00:00,2022-09-03 09:00:00,12,0,1065,2170,1639,4886,32394
2022-09-03 09:00:00,2022-09-03 10:00:00,12,0,1253,2160,1489,4914,29611
2022-09-03 10:00:00,2022-09-03 11:00:00,12,0,1202,2171,2006,5391,27537
2022-09-03 11:00:00,2022-09-03 12:00:00,11,0,1151,562,2391,4115,26556
2022-09-03 12:00:00,2022-09-03 13:00:00,39,0,1258,744,1906,3947,27358
2022-09-03 13:00:00,2022-09-03 14:00:00,75,0,1209,1733,1243,4260,30245
2022-09-03 14:00:00,2022-09-03 15:00:00,76,0,942,1957,868,3843,34606
2022-09-03 15:00:00,2022-09-03 16:00:00,76,0,619,1769,765,3229,40342
2022-09-03 16:00:00,2022-09-03 17:00:00,72,0,261,1525,782,2640,44795
2022-09-03 17:00:00,2022-09-03 18:00:00,59,0,53,1705,1156,2973,47952
2022-09-03 18:00:00,2022-09-03 19:00:00,62,0,8,2132,1776,3978,49322
2022-09-03 19:00:00,2022-09-03 20:00:00,60,0,8,2504,2162,4734,48256
2022-09-03 20:00:00,2022-09-03 21:00:00,60,0,8,2545,2263,4876,46638
2022-09-03 21:00:00,2022-09-03 22:00:00,60,0,8,2559,2475,5102,44865
2022-09-03 22:00:00,2022-09-03 23:00:00,61,0,8,2535,2641,5245,42960
2022-09-03 23:00:00,2022-09-04 00:00:00,60,0,8,2384,2674,5126,41472
2022-09-04 00:00:00,2022-09-04 01:00:00,62,0,8,2318,2143,4531,40362
2022-09-04 01:00:00,2022-09-04 02:00:00,63,0,8,2259,1863,4193,39649
2022-09-04 02:00:00,2022-09-04 03:00:00,62,0,8,2059,1723,3852,39176
2022-09-04 03:00:00,2022-09-04 04:00:00,60,0,8,1662,1653,3383,39106
2022-09-04 04:00:00,2022-09-04 05:00:00,60,0,11,1458,1412,2941,39163
2022-09-04 05:00:00,2022-09-04 06:00:00,60,0,111,1318,1263,2752,38167
2022-09-04 06:00:00,2022-09-04 07:00:00,60,0,364,1280,913,2617,36041
2022-09-04 07:00:00,2022-09-04 08:00:00,60,0,720,1413,743,2936,33545
2022-09-04 08:00:00,2022-09-04 09:00:00,61,0,1004,1134,741,2940,30896
2022-09-04 09:00:00,2022-09-04 10:00:00,61,0,1173,927,844,3005,29146
2022-09-04 10:00:00,2022-09-04 11:00:00,60,0,1212,827,707,2806,29833
2022-09-04 11:00:00,2022-09-04 12:00:00,61,0,1177,822,576,2636,31394
2022-09-04 12:00:00,2022-09-04 13:00:00,60,0,1129,654,597,2440,32218
2022-09-04 13:00:00,2022-09-04 14:00:00,60,0,998,741,556,2355,33942
2022-09-04 14:00:00,2022-09-04 15:00:00,61,0,766,813,677,2317,36848
2022-09-04 15:00:00,2022-09-04 16:00:00,60,0,551,778,576,1965,41860
2022-09-04 16:00:00,2022-09-04 17:00:00,60,0,183,823,591,1657,45360
2022-09-04 17:00:00,2022-09-04 18:00:00,60,0,36,850,574,1520,48455
2022-09-04 18:00:00,2022-09-04 19:00:00,61,0,8,1056,645,1770,50362
2022-09-04 19:00:00,2022-09-04 20:00:00,61,0,8,1338,913,2320,49221
2022-09-04 20:00:00,2022-09-04 21:00:00,60,0,8,1609,1136,2813,47106
2022-09-04 21:00:00,2022-09-04 22:00:00,60,0,8,2234,1258,3560,44807
2022-09-04 22:00:00,2022-09-04 23:00:00,61,0,8,2939,1436,4444,43000
2022-09-04 23:00:00,2022-09-05 00:00:00,61,0,8,3840,1701,5610,41474
2022-09-05 00:00:00,2022-09-05 01:00:00,60,0,8,4481,2041,6590,40644
2022-09-05 01:00:00,2022-09-05 02:00:00,62,0,8,4350,1991,6411,40106
2022-09-05 02:00:00,2022-09-05 03:00:00,62,0,8,4425,2051,6546,40256
2022-09-05 03:00:00,2022-09-05 04:00:00,62,0,8,3758,2065,5893,41814
2022-09-05 04:00:00,2022-09-05 05:00:00,60,0,9,3473,2003,5545,45277
2022-09-05 05:00:00,2022-09-05 06:00:00,60,0,98,2958,1886,5002,47881
2022-09-05 06:00:00,2022-09-05 07:00:00,60,0,389,2764,1630,4843,47078
2022-09-05 07:00:00,2022-09-05 08:00:00,60,0,738,2449,1347,4594,44422
2022-09-05 08:00:00,2022-09-05 09:00:00,60,0,985,1729,1008,3782,40691
2022-09-05 09:00:00,2022-09-05 10:00:00,61,0,1170,1144,880,3255,38118
2022-09-05 10:00:00,2022-09-05 11:00:00,61,0,1240,821,887,3009,36684
2022-09-05 11:00:00,2022-09-05 12:00:00,61,0,1248,628,802,2739,37759
2022-09-05 12:00:00,2022-09-05 13:00:00,62,0,1155,441,763,2421,39403
2022-09-05 13:00:00,2022-09-05 14:00:00,60,0,947,438,540,1985,43869
2022-09-05 14:00:00,2022-09-05 15:00:00,58,0,800,572,426,1856,48503
2022-09-05 15:00:00,2022-09-05 16:00:00,62,0,493,772,426,1753,53712
2022-09-05 16:00:00,2022-09-05 17:00:00,64,0,157,1690,465,2376,55352
2022-09-05 17:00:00,2022-09-05 18:00:00,64,0,32,2378,819,3293,56176
2022-09-05 18:00:00,2022-09-05 19:00:00,64,0,4,2973,1647,4688,56039
2022-09-05 19:00:00,2022-09-05 20:00:00,64,0,4,4977,2811,7856,53541
2022-09-05 20:00:00,2022-09-05 21:00:00,63,0,4,6830,4392,11289,50666
2022-09-05 21:00:00,2022-09-05 22:00:00,59,0,4,4648,4575,9286,47673
2022-09-05 22:00:00,2022-09-05 23:00:00,60,0,4,3166,2774,6004,45284
2022-09-05 23:00:00,2022-09-06 00:00:00,64,0,4,2980,1754,4802,43763
2022-09-06 00:00:00,2022-09-06 01:00:00,64,0,4,4105,1622,5795,43201
2022-09-06 01:00:00,2022-09-06 02:00:00,64,0,4,3323,1681,5072,42741
2022-09-06 02:00:00,2022-09-06 03:00:00,64,0,4,1689,1308,3065,42496
2022-09-06 03:00:00,2022-09-06 04:00:00,64,0,4,1992,743,2803,43798
2022-09-06 04:00:00,2022-09-06 05:00:00,64,0,4,2812,628,3508,47977
2022-09-06 05:00:00,2022-09-06 06:00:00,64,0,44,3695,705,4508,51473
2022-09-06 06:00:00,2022-09-06 07:00:00,63,0,213,2353,1010,3639,49623
2022-09-06 07:00:00,2022-09-06 08:00:00,61,0,499,2770,1186,4516,44980
2022-09-06 08:00:00,2022-09-06 09:00:00,61,0,928,3354,1125,5468,41011
2022-09-06 09:00:00,2022-09-06 10:00:00,63,0,1105,4284,1292,6744,38394
2022-09-06 10:00:00,2022-09-06 11:00:00,63,0,1280,3472,1376,6191,36562
2022-09-06 11:00:00,2022-09-06 12:00:00,63,0,1273,2393,1385,5114,35616
2022-09-06 12:00:00,2022-09-06 13:00:00,63,0,1255,1756,1281,4355,36800
2022-09-06 13:00:00,2022-09-06 14:00:00,63,0,1066,1273,813,3215,40236
2022-09-06 14:00:00,2022-09-06 15:00:00,61,0,691,930,502,2184,44662
2022-09-06 15:00:00,2022-09-06 16:00:00,64,0,402,1037,561,2064,51431
2022-09-06 16:00:00,2022-09-06 17:00:00,64,0,176,915,604,1759,54762
2022-09-06 17:00:00,2022-09-06 18:00:00,63,0,30,762,620,1475,56111
2022-09-06 18:00:00,2022-09-06 19:00:00,61,0,4,912,752,1729,56731
2022-09-06 19:00:00,2022-09-06 20:00:00,64,0,4,2402,934,3404,54039
2022-09-06 20:00:00,2022-09-06 21:00:00,60,0,4,1355,1462,2881,51047
2022-09-06 21:00:00,2022-09-06 22:00:00,63,0,4,971,2026,3064,48204
2022-09-06 22:00:00,2022-09-06 23:00:00,63,0,4,694,2533,3294,45580
2022-09-06 23:00:00,2022-09-07 00:00:00,64,0,4,931,3331,4330,44213
2022-09-07 00:00:00,2022-09-07 01:00:00,65,0,4,1213,2107,3389,43624
2022-09-07 01:00:00,2022-09-07 02:00:00,65,0,4,1299,1358,2726,43112
2022-09-07 02:00:00,2022-09-07 03:00:00,64,0,4,1406,1031,2505,43288
2022-09-07 03:00:00,2022-09-07 04:00:00,65,0,4,2027,702,2798,44486
2022-09-07 04:00:00,2022-09-07 05:00:00,63,0,4,2311,692,3070,48215
2022-09-07 05:00:00,2022-09-07 06:00:00,60,0,38,3006,782,3886,51764
2022-09-07 06:00:00,2022-09-07 07:00:00,62,0,240,2577,947,3826,51275
2022-09-07 07:00:00,2022-09-07 08:00:00,64,0,185,2636,1041,3926,47902
2022-09-07 08:00:00,2022-09-07 09:00:00,63,0,433,2652,1127,4275,42824
2022-09-07 09:00:00,2022-09-07 10:00:00,60,0,598,2199,1165,4022,39412
2022-09-07 10:00:00,2022-09-07 11:00:00,62,0,779,1723,1225,3789,37642
2022-09-07 11:00:00,2022-09-07 12:00:00,63,0,1023,1401,1421,3908,38235
2022-09-07 12:00:00,2022-09-07 13:00:00,64,0,1046,1188,1304,3602,39140
2022-09-07 13:00:00,2022-09-07 14:00:00,64,0,989,882,1241,3176,42047
2022-09-07 14:00:00,2022-09-07 15:00:00,64,0,655,383,1020,2122,46000
2022-09-07 15:00:00,2022-09-07 16:00:00,62,0,342,144,820,1368,50816
2022-09-07 16:00:00,2022-09-07 17:00:00,64,0,129,127,606,926,53026
2022-09-07 17:00:00,2022-09-07 18:00:00,61,0,31,136,503,731,54856
2022-09-07 18:00:00,2022-09-07 19:00:00,63,0,4,126,454,647,55323
2022-09-07 19:00:00,2022-09-07 20:00:00,64,0,4,173,633,874,52721
2022-09-07 20:00:00,2022-09-07 21:00:00,63,0,4,703,833,1603,50055
2022-09-07 21:00:00,2022-09-07 22:00:00,60,0,4,1203,861,2128,47606
2022-09-07 22:00:00,2022-09-07 23:00:00,62,0,4,1265,1006,2337,45042
2022-09-07 23:00:00,2022-09-08 00:00:00,63,0,4,1998,970,3035,43345
2022-09-08 00:00:00,2022-09-08 01:00:00,63,0,4,1550,1216,2833,42150
2022-09-08 01:00:00,2022-09-08 02:00:00,64,0,4,1564,1560,3192,41617
2022-09-08 02:00:00,2022-09-08 03:00:00,62,0,4,1393,1649,3108,41803
2022-09-08 03:00:00,2022-09-08 04:00:00,62,0,4,1876,1301,3243,43379
2022-09-08 04:00:00,2022-09-08 05:00:00,60,0,3,2761,1093,3917,47850
2022-09-08 05:00:00,2022-09-08 06:00:00,60,0,35,2591,1443,4129,53010
2022-09-08 06:00:00,2022-09-08 07:00:00,61,0,33,1955,1457,3506,55478
2022-09-08 07:00:00,2022-09-08 08:00:00,63,0,81,2539,1656,4339,54021
2022-09-08 08:00:00,2022-09-08 09:00:00,64,0,205,4560,1789,6618,50305
2022-09-08 09:00:00,2022-09-08 10:00:00,64,0,271,4393,1762,6490,46241
2022-09-08 10:00:00,2022-09-08 11:00:00,64,0,361,3592,2146,6163,42321
2022-09-08 11:00:00,2022-09-08 12:00:00,62,0,359,2138,2229,4788,40262
2022-09-08 12:00:00,2022-09-08 13:00:00,64,0,457,1934,2044,4499,39929
2022-09-08 13:00:00,2022-09-08 14:00:00,63,0,562,2529,2147,5301,42424
2022-09-08 14:00:00,2022-09-08 15:00:00,61,0,520,1564,1719,3864,46771
2022-09-08 15:00:00,2022-09-08 16:00:00,64,0,252,2021,1386,3723,50715
2022-09-08 16:00:00,2022-09-08 17:00:00,63,0,113,1707,1288,3171,52371
2022-09-08 17:00:00,2022-09-08 18:00:00,63,0,42,2111,975,3191,53697
2022-09-08 18:00:00,2022-09-08 19:00:00,63,0,4,2123,1035,3225,54592
2022-09-08 19:00:00,2022-09-08 20:00:00,62,0,4,1675,1113,2854,51555
2022-09-08 20:00:00,2022-09-08 21:00:00,64,0,4,2591,1451,4110,48909
2022-09-08 21:00:00,2022-09-08 22:00:00,61,0,4,3817,1911,5793,46749
2022-09-08 22:00:00,2022-09-08 23:00:00,62,0,4,3782,1999,5847,44146
2022-09-08 23:00:00,2022-09-09 00:00:00,61,0,4,3447,2236,5748,41965
2022-09-09 00:00:00,2022-09-09 01:00:00,64,0,4,3656,2563,6287,41089
2022-09-09 01:00:00,2022-09-09 02:00:00,62,0,4,4622,2485,7173,40752
2022-09-09 02:00:00,2022-09-09 03:00:00,61,0,4,5787,2674,8526,40990
2022-09-09 03:00:00,2022-09-09 04:00:00,64,0,4,6287,2670,9025,42223
2022-09-09 04:00:00,2022-09-09 05:00:00,60,0,4,6375,3252,9691,45211
2022-09-09 05:00:00,2022-09-09 06:00:00,60,0,71,6410,3836,10377,48226
2022-09-09 06:00:00,2022-09-09 07:00:00,59,0,255,5743,3870,9927,48329
2022-09-09 07:00:00,2022-09-09 08:00:00,61,0,593,5001,4463,10118,47522
2022-09-09 08:00:00,2022-09-09 09:00:00,60,0,782,4084,4465,9391,48156
2022-09-09 09:00:00,2022-09-09 10:00:00,64,0,703,3267,4475,8509,48531
2022-09-09 10:00:00,2022-09-09 11:00:00,61,0,863,3241,4568,8733,46533
2022-09-09 11:00:00,2022-09-09 12:00:00,61,0,815,3310,4716,8902,46383
2022-09-09 12:00:00,2022-09-09 13:00:00,61,0,823,3099,4511,8494,45217
2022-09-09 13:00:00,2022-09-09 14:00:00,60,0,486,3332,4295,8173,45408
2022-09-09 14:00:00,2022-09-09 15:00:00,60,0,441,3313,3677,7491,46485
2022-09-09 15:00:00,2022-09-09 16:00:00,64,0,516,3392,3533,7505,50045
2022-09-09 16:00:00,2022-09-09 17:00:00,62,0,129,3369,2575,6135,51190
2022-09-09 17:00:00,2022-09-09 18:00:00,63,0,18,3824,2317,6222,51770
2022-09-09 18:00:00,2022-09-09 19:00:00,64,0,4,2129,2074,4271,51541
2022-09-09 19:00:00,2022-09-09 20:00:00,64,0,4,2249,2239,4556,48936
2022-09-09 20:00:00,2022-09-09 21:00:00,63,0,4,2198,2474,4739,46582
2022-09-09 21:00:00,2022-09-09 22:00:00,62,0,4,3132,2857,6055,44559
2022-09-09 22:00:00,2022-09-09 23:00:00,64,0,4,3309,2610,5987,42405
2022-09-09 23:00:00,2022-09-10 00:00:00,64,0,4,3297,2250,5615,41099
2022-09-10 00:00:00,2022-09-10 01:00:00,64,0,4,3411,2206,5685,40173
2022-09-10 01:00:00,2022-09-10 02:00:00,64,0,4,3502,1857,5427,39580
2022-09-10 02:00:00,2022-09-10 03:00:00,64,0,4,3360,1925,5353,39359
2022-09-10 03:00:00,2022-09-10 04:00:00,64,0,4,4219,1890,6177,39482
2022-09-10 04:00:00,2022-09-10 05:00:00,63,0,4,4669,1736,6472,40932
2022-09-10 05:00:00,2022-09-10 06:00:00,60,0,25,4580,1566,6231,42329
2022-09-10 06:00:00,2022-09-10 07:00:00,63,0,74,4478,1362,5977,43320
2022-09-10 07:00:00,2022-09-10 08:00:00,63,0,177,4330,1147,5717,43134
2022-09-10 08:00:00,2022-09-10 09:00:00,61,0,306,4463,1170,6000,41816
2022-09-10 09:00:00,2022-09-10 10:00:00,64,0,555,4093,1192,5904,39738
2022-09-10 10:00:00,2022-09-10 11:00:00,63,0,787,3262,1186,5298,37776
2022-09-10 11:00:00,2022-09-10 12:00:00,62,0,986,2306,1044,4398,35649
2022-09-10 12:00:00,2022-09-10 13:00:00,62,0,918,1464,1086,3530,33780
2022-09-10 13:00:00,2022-09-10 14:00:00,59,0,823,1199,1316,3397,34653
2022-09-10 14:00:00,2022-09-10 15:00:00,61,0,702,1190,1491,3444,37189
2022-09-10 15:00:00,2022-09-10 16:00:00,62,0,338,1500,1754,3654,41693
2022-09-10 16:00:00,2022-09-10 17:00:00,63,0,129,1789,1484,3465,45010
2022-09-10 17:00:00,2022-09-10 18:00:00,62,0,32,1795,1319,3208,47050
2022-09-10 18:00:00,2022-09-10 19:00:00,63,0,8,1842,1468,3381,47707
2022-09-10 19:00:00,2022-09-10 20:00:00,63,0,8,1931,1310,3312,46116
2022-09-10 20:00:00,2022-09-10 21:00:00,63,0,8,1900,872,2843,44350
2022-09-10 21:00:00,2022-09-10 22:00:00,63,0,8,1537,487,2095,42541
2022-09-10 22:00:00,2022-09-10 23:00:00,62,0,8,1045,370,1485,41210
2022-09-10 23:00:00,2022-09-11 00:00:00,62,0,8,595,300,965,40005
2022-09-11 00:00:00,2022-09-11 01:00:00,63,0,8,492,235,798,39157
2022-09-11 01:00:00,2022-09-11 02:00:00,63,0,8,341,188,600,38660
2022-09-11 02:00:00,2022-09-11 03:00:00,63,0,8,213,182,466,38349
2022-09-11 03:00:00,2022-09-11 04:00:00,62,0,8,103,165,338,38471
2022-09-11 04:00:00,2022-09-11 05:00:00,58,0,9,107,161,335,38904
2022-09-11 05:00:00,2022-09-11 06:00:00,60,0,84,115,177,436,38553
2022-09-11 06:00:00,2022-09-11 07:00:00,64,0,334,121,204,723,36772
2022-09-11 07:00:00,2022-09-11 08:00:00,64,0,684,118,246,1112,34569
2022-09-11 08:00:00,2022-09-11 09:00:00,63,0,924,108,315,1410,32983
2022-09-11 09:00:00,2022-09-11 10:00:00,62,0,1059,113,376,1610,31563
2022-09-11 10:00:00,2022-09-11 11:00:00,63,0,996,122,419,1600,30356
2022-09-11 11:00:00,2022-09-11 12:00:00,62,0,865,122,303,1352,29402
2022-09-11 12:00:00,2022-09-11 13:00:00,61,0,659,125,343,1188,28918
2022-09-11 13:00:00,2022-09-11 14:00:00,60,0,597,126,379,1162,30358
2022-09-11 14:00:00,2022-09-11 15:00:00,62,0,750,127,337,1276,34226
2022-09-11 15:00:00,2022-09-11 16:00:00,62,0,476,127,267,932,40333
2022-09-11 16:00:00,2022-09-11 17:00:00,62,0,148,103,205,518,44677
2022-09-11 17:00:00,2022-09-11 18:00:00,62,0,19,71,187,339,47541
2022-09-11 18:00:00,2022-09-11 19:00:00,61,0,8,136,199,404,48590
2022-09-11 19:00:00,2022-09-11 20:00:00,62,0,8,459,260,789,46762
2022-09-11 20:00:00,2022-09-11 21:00:00,64,0,8,899,364,1335,45199
2022-09-11 21:00:00,2022-09-11 22:00:00,62,0,8,801,493,1364,42958
2022-09-11 22:00:00,2022-09-11 23:00:00,62,0,5,802,636,1505,41165
2022-09-11 23:00:00,2022-09-12 00:00:00,63,0,4,602,878,1547,39593
2022-09-12 00:00:00,2022-09-12 01:00:00,60,0,4,825,989,1878,38641
2022-09-12 01:00:00,2022-09-12 02:00:00,63,0,4,1079,1124,2270,38342
2022-09-12 02:00:00,2022-09-12 03:00:00,64,0,4,1195,1069,2332,38795
2022-09-12 03:00:00,2022-09-12 04:00:00,61,0,4,1494,1022,2581,40585
2022-09-12 04:00:00,2022-09-12 05:00:00,61,0,7,1665,1119,2852,44594
2022-09-12 05:00:00,2022-09-12 06:00:00,61,0,112,1755,1315,3243,48424
2022-09-12 06:00:00,2022-09-12 07:00:00,60,0,204,1687,1295,3246,48791
2022-09-12 07:00:00,2022-09-12 08:00:00,62,0,393,1870,1071,3396,44363
2022-09-12 08:00:00,2022-09-12 09:00:00,64,0,581,2068,927,3640,39174
2022-09-12 09:00:00,2022-09-12 10:00:00,64,0,888,2030,870,3852,35144
2022-09-12 10:00:00,2022-09-12 11:00:00,64,0,1266,1931,1021,4282,32941
2022-09-12 11:00:00,2022-09-12 12:00:00,64,0,1256,1957,1037,4314,33331
2022-09-12 12:00:00,2022-09-12 13:00:00,64,0,1187,1399,1232,3882,34544
2022-09-12 13:00:00,2022-09-12 14:00:00,61,0,985,1489,1358,3893,37513
2022-09-12 14:00:00,2022-09-12 15:00:00,62,0,653,1433,1159,3307,42266
2022-09-12 15:00:00,2022-09-12 16:00:00,63,0,451,1327,951,2792,47766
2022-09-12 16:00:00,2022-09-12 17:00:00,63,0,175,1459,803,2500,51238
2022-09-12 17:00:00,2022-09-12 18:00:00,64,0,18,1758,800,2640,53402
2022-09-12 18:00:00,2022-09-12 19:00:00,64,0,8,1745,658,2475,53962
2022-09-12 19:00:00,2022-09-12 20:00:00,64,0,8,2372,594,3038,51294
2022-09-12 20:00:00,2022-09-12 21:00:00,64,0,8,2117,509,2698,48831
2022-09-12 21:00:00,2022-09-12 22:00:00,62,0,8,2253,729,3052,46355
2022-09-12 22:00:00,2022-09-12 23:00:00,61,0,8,2314,1255,3638,44093
2022-09-12 23:00:00,2022-09-13 00:00:00,64,0,8,2125,1185,3382,42626
2022-09-13 00:00:00,2022-09-13 01:00:00,64,0,8,1116,1135,2323,41717
2022-09-13 01:00:00,2022-09-13 02:00:00,63,0,8,1419,990,2480,41269
2022-09-13 02:00:00,2022-09-13 03:00:00,62,0,8,1827,712,2609,41478
2022-09-13 03:00:00,2022-09-13 04:00:00,62,0,5,1678,494,2239,43263
2022-09-13 04:00:00,2022-09-13 05:00:00,60,0,4,1569,476,2109,47415
2022-09-13 05:00:00,2022-09-13 06:00:00,60,0,19,1468,621,2168,51737
2022-09-13 06:00:00,2022-09-13 07:00:00,63,0,128,1707,631,2529,52161
2022-09-13 07:00:00,2022-09-13 08:00:00,62,0,432,2046,705,3245,48529
2022-09-13 08:00:00,2022-09-13 09:00:00,61,0,764,2454,839,4118,44270
2022-09-13 09:00:00,2022-09-13 10:00:00,60,0,1042,2650,1026,4778,42001
2022-09-13 10:00:00,2022-09-13 11:00:00,60,0,1078,2136,982,4256,39544
2022-09-13 11:00:00,2022-09-13 12:00:00,64,0,1140,1894,817,3915,37926
2022-09-13 12:00:00,2022-09-13 13:00:00,60,0,1052,1444,866,3422,37900
2022-09-13 13:00:00,2022-09-13 14:00:00,60,0,1019,1325,888,3292,41479
2022-09-13 14:00:00,2022-09-13 15:00:00,60,0,683,1740,761,3244,46561
2022-09-13 15:00:00,2022-09-13 16:00:00,63,0,381,2257,917,3618,51409
2022-09-13 16:00:00,2022-09-13 17:00:00,63,0,135,2046,1017,3261,52876
2022-09-13 17:00:00,2022-09-13 18:00:00,63,0,15,1924,907,2909,53829
2022-09-13 18:00:00,2022-09-13 19:00:00,64,0,4,2101,907,3076,53535
2022-09-13 19:00:00,2022-09-13 20:00:00,63,0,4,2112,930,3109,50987
2022-09-13 20:00:00,2022-09-13 21:00:00,64,0,4,1801,791,2660,48542
2022-09-13 21:00:00,2022-09-13 22:00:00,62,0,4,1529,647,2242,46285
2022-09-13 22:00:00,2022-09-13 23:00:00,60,0,4,1245,575,1884,43968
2022-09-13 23:00:00,2022-09-14 00:00:00,61,0,4,1093,514,1672,42261
2022-09-14 00:00:00,2022-09-14 01:00:00,61,0,4,1297,436,1798,41248
2022-09-14 01:00:00,2022-09-14 02:00:00,61,0,4,1306,431,1802,40899
2022-09-14 02:00:00,2022-09-14 03:00:00,62,0,4,1278,425,1769,41087
2022-09-14 03:00:00,2022-09-14 04:00:00,62,0,4,1224,317,1607,42656
2022-09-14 04:00:00,2022-09-14 05:00:00,60,0,4,1258,252,1574,46674
2022-09-14 05:00:00,2022-09-14 06:00:00,60,0,40,1336,285,1721,51390
2022-09-14 06:00:00,2022-09-14 07:00:00,60,0,165,1248,341,1814,53323
2022-09-14 07:00:00,2022-09-14 08:00:00,62,0,291,1036,336,1725,52672
2022-09-14 08:00:00,2022-09-14 09:00:00,64,0,524,685,262,1535,51232
2022-09-14 09:00:00,2022-09-14 10:00:00,63,0,683,570,232,1548,49809
2022-09-14 10:00:00,2022-09-14 11:00:00,63,0,863,507,286,1719,48130
2022-09-14 11:00:00,2022-09-14 12:00:00,64,0,912,414,360,1750,46414
2022-09-14 12:00:00,2022-09-14 13:00:00,62,0,744,396,323,1525,45311
2022-09-14 13:00:00,2022-09-14 14:00:00,59,0,693,486,353,1591,45188
2022-09-14 14:00:00,2022-09-14 15:00:00,61,0,461,727,515,1764,46593
2022-09-14 15:00:00,2022-09-14 16:00:00,62,0,355,905,663,1985,50202
2022-09-14 16:00:00,2022-09-14 17:00:00,61,0,133,1329,586,2109,51738
2022-09-14 17:00:00,2022-09-14 18:00:00,63,0,18,1884,685,2650,53426
2022-09-14 18:00:00,2022-09-14 19:00:00,62,0,4,1996,510,2572,53656
2022-09-14 19:00:00,2022-09-14 20:00:00,64,0,4,1539,687,2294,50713
2022-09-14 20:00:00,2022-09-14 21:00:00,62,0,4,2398,1087,3551,48221
2022-09-14 21:00:00,2022-09-14 22:00:00,60,0,4,3954,1382,5400,45888
2022-09-14 22:00:00,2022-09-14 23:00:00,63,0,4,4059,2033,6159,43168
2022-09-14 23:00:00,2022-09-15 00:00:00,64,0,4,3409,2393,5870,41496
2022-09-15 00:00:00,2022-09-15 01:00:00,64,0,4,4352,2763,7183,40621
2022-09-15 01:00:00,2022-09-15 02:00:00,64,0,4,4862,2909,7839,40158
2022-09-15 02:00:00,2022-09-15 03:00:00,64,0,4,4237,2909,7214,40320
2022-09-15 03:00:00,2022-09-15 04:00:00,64,0,4,3716,2739,6523,41778
2022-09-15 04:00:00,2022-09-15 05:00:00,62,0,4,3464,2649,6179,45532
2022-09-15 05:00:00,2022-09-15 06:00:00,60,0,53,3164,2735,6012,49827
2022-09-15 06:00:00,2022-09-15 07:00:00,64,0,208,3857,2964,7093,51067
2022-09-15 07:00:00,2022-09-15 08:00:00,64,0,453,5332,2679,8528,49859
2022-09-15 08:00:00,2022-09-15 09:00:00,64,0,628,4356,3145,8193,47353
2022-09-15 09:00:00,2022-09-15 10:00:00,64,0,595,3533,2981,7173,44717
2022-09-15 10:00:00,2022-09-15 11:00:00,64,0,796,3831,3043,7734,42293
2022-09-15 11:00:00,2022-09-15 12:00:00,64,0,845,5108,3692,9709,41483
2022-09-15 12:00:00,2022-09-15 13:00:00,67,0,841,4369,4052,9329,42104
2022-09-15 13:00:00,2022-09-15 14:00:00,75,0,557,3497,4765,8894,44732
2022-09-15 14:00:00,2022-09-15 15:00:00,78,0,417,4321,4993,9809,47680
2022-09-15 15:00:00,2022-09-15 16:00:00,77,0,239,5784,4761,10861,50987
2022-09-15 16:00:00,2022-09-15 17:00:00,64,0,110,6300,4879,11353,51736
2022-09-15 17:00:00,2022-09-15 18:00:00,61,0,15,6625,4355,11056,53074
2022-09-15 18:00:00,2022-09-15 19:00:00,64,0,4,7317,3914,11299,52900
2022-09-15 19:00:00,2022-09-15 20:00:00,63,0,4,7326,4240,11633,50409
2022-09-15 20:00:00,2022-09-15 21:00:00,61,0,4,8167,4221,12453,48269
2022-09-15 21:00:00,2022-09-15 22:00:00,60,0,4,7617,3996,11677,45696
2022-09-15 22:00:00,2022-09-15 23:00:00,62,0,4,7825,4250,12141,43405
2022-09-15 23:00:00,2022-09-16 00:00:00,64,0,4,8725,4112,12905,41797
2022-09-16 00:00:00,2022-09-16 01:00:00,64,0,4,8576,3775,12419,41033
2022-09-16 01:00:00,2022-09-16 02:00:00,64,0,4,7728,3876,11672,40303
2022-09-16 02:00:00,2022-09-16 03:00:00,64,0,4,8372,3875,12315,40501
2022-09-16 03:00:00,2022-09-16 04:00:00,64,0,4,8567,3984,12619,42018
2022-09-16 04:00:00,2022-09-16 05:00:00,63,0,3,8864,4455,13385,45706
2022-09-16 05:00:00,2022-09-16 06:00:00,62,0,62,8638,4520,13282,49367
2022-09-16 06:00:00,2022-09-16 07:00:00,64,0,328,8278,4435,13105,48283
2022-09-16 07:00:00,2022-09-16 08:00:00,64,0,607,8766,4726,14163,45532
2022-09-16 08:00:00,2022-09-16 09:00:00,63,0,838,8074,4785,13760,43496
2022-09-16 09:00:00,2022-09-16 10:00:00,63,0,919,8628,5658,15268,42815
2022-09-16 10:00:00,2022-09-16 11:00:00,63,0,883,8455,5079,14480,40484
2022-09-16 11:00:00,2022-09-16 12:00:00,62,0,880,7543,4936,13421,39393
2022-09-16 12:00:00,2022-09-16 13:00:00,64,0,823,7664,5040,13591,40002
2022-09-16 13:00:00,2022-09-16 14:00:00,62,0,613,8609,6512,15796,41915
2022-09-16 14:00:00,2022-09-16 15:00:00,61,0,516,6919,7421,14917,43767
2022-09-16 15:00:00,2022-09-16 16:00:00,64,0,260,7009,7526,14859,48399
2022-09-16 16:00:00,2022-09-16 17:00:00,64,0,65,8878,6820,15827,50722
2022-09-16 17:00:00,2022-09-16 18:00:00,63,0,11,9056,6895,16025,51878
2022-09-16 18:00:00,2022-09-16 19:00:00,63,0,8,9121,5999,15191,51177
2022-09-16 19:00:00,2022-09-16 20:00:00,62,0,8,8971,5971,15012,48962
2022-09-16 20:00:00,2022-09-16 21:00:00,63,0,8,9057,5228,14356,46671
2022-09-16 21:00:00,2022-09-16 22:00:00,63,0,8,9026,5983,15080,44481
2022-09-16 22:00:00,2022-09-16 23:00:00,62,0,8,9170,6526,15766,42113
2022-09-16 23:00:00,2022-09-17 00:00:00,63,0,8,9009,6410,15490,40536
2022-09-17 00:00:00,2022-09-17 01:00:00,64,0,8,8967,6698,15737,39368
2022-09-17 01:00:00,2022-09-17 02:00:00,64,0,8,9113,6492,15677,38590
2022-09-17 02:00:00,2022-09-17 03:00:00,64,0,8,9112,6208,15392,38082
2022-09-17 03:00:00,2022-09-17 04:00:00,64,0,8,8845,6754,15671,38849
2022-09-17 04:00:00,2022-09-17 05:00:00,64,0,8,8961,6671,15704,40697
2022-09-17 05:00:00,2022-09-17 06:00:00,63,0,101,8979,6204,15347,41137
2022-09-17 06:00:00,2022-09-17 07:00:00,64,0,240,8849,5809,14962,40121
2022-09-17 07:00:00,2022-09-17 08:00:00,64,0,522,8564,6044,15194,38242
2022-09-17 08:00:00,2022-09-17 09:00:00,64,0,664,8994,6161,15883,36263
2022-09-17 09:00:00,2022-09-17 10:00:00,64,0,721,9132,5937,15854,34947
2022-09-17 10:00:00,2022-09-17 11:00:00,63,0,727,8226,6374,15390,32311
2022-09-17 11:00:00,2022-09-17 12:00:00,64,0,780,7062,6568,14474,31142
2022-09-17 12:00:00,2022-09-17 13:00:00,63,0,462,7544,6887,14956,31271
2022-09-17 13:00:00,2022-09-17 14:00:00,60,0,423,6818,6284,13585,31946
2022-09-17 14:00:00,2022-09-17 15:00:00,60,0,375,7405,6195,14035,36193
2022-09-17 15:00:00,2022-09-17 16:00:00,62,0,238,8652,7375,16327,42852
2022-09-17 16:00:00,2022-09-17 17:00:00,64,0,125,8956,6773,15918,46772
2022-09-17 17:00:00,2022-09-17 18:00:00,64,0,6,9036,7093,16199,48418
2022-09-17 18:00:00,2022-09-17 19:00:00,64,0,4,9063,6007,15138,48195
2022-09-17 19:00:00,2022-09-17 20:00:00,64,0,4,9074,5520,14662,46154
2022-09-17 20:00:00,2022-09-17 21:00:00,63,0,4,9015,5666,14748,44518
2022-09-17 21:00:00,2022-09-17 22:00:00,60,0,4,8891,5657,14612,42754
2022-09-17 22:00:00,2022-09-17 23:00:00,64,0,4,8806,5146,14020,40708
2022-09-17 23:00:00,2022-09-18 00:00:00,63,0,4,8663,5037,13767,39062
2022-09-18 00:00:00,2022-09-18 01:00:00,64,0,4,8287,4891,13246,38138
2022-09-18 01:00:00,2022-09-18 02:00:00,63,0,4,7558,5134,12759,37586
2022-09-18 02:00:00,2022-09-18 03:00:00,64,0,4,7091,5045,12204,37360
2022-09-18 03:00:00,2022-09-18 04:00:00,62,0,4,6985,5252,12303,37553
2022-09-18 04:00:00,2022-09-18 05:00:00,62,0,3,6379,4871,11315,37777
2022-09-18 05:00:00,2022-09-18 06:00:00,63,0,16,6804,4924,11807,39121
2022-09-18 06:00:00,2022-09-18 07:00:00,64,0,86,6368,4687,11205,39747
2022-09-18 07:00:00,2022-09-18 08:00:00,64,0,139,6643,3804,10650,40450
2022-09-18 08:00:00,2022-09-18 09:00:00,64,0,180,7158,4547,11949,41475
2022-09-18 09:00:00,2022-09-18 10:00:00,64,0,188,7573,5178,13003,41869
2022-09-18 10:00:00,2022-09-18 11:00:00,64,0,371,8110,5006,13551,42185
2022-09-18 11:00:00,2022-09-18 12:00:00,64,0,466,8400,5136,14066,42718
2022-09-18 12:00:00,2022-09-18 13:00:00,60,0,486,8346,5993,14885,43034
2022-09-18 13:00:00,2022-09-18 14:00:00,61,0,349,8626,5626,14662,43932
2022-09-18 14:00:00,2022-09-18 15:00:00,61,0,310,8647,5710,14728,45702
2022-09-18 15:00:00,2022-09-18 16:00:00,63,0,301,8693,6381,15438,48416
2022-09-18 16:00:00,2022-09-18 17:00:00,64,0,120,8510,6359,15053,48909
2022-09-18 17:00:00,2022-09-18 18:00:00,64,0,6,8491,6443,15004,49463
2022-09-18 18:00:00,2022-09-18 19:00:00,64,0,4,8529,6561,15158,48473
2022-09-18 19:00:00,2022-09-18 20:00:00,64,0,4,8209,6692,14969,46733
2022-09-18 20:00:00,2022-09-18 21:00:00,63,0,4,8204,6645,14916,44594
2022-09-18 21:00:00,2022-09-18 22:00:00,63,0,4,7906,6112,14085,42264
2022-09-18 22:00:00,2022-09-18 23:00:00,63,0,4,7218,5855,13140,40215
2022-09-18 23:00:00,2022-09-19 00:00:00,63,0,4,6662,5291,12020,38718
2022-09-19 00:00:00,2022-09-19 01:00:00,64,0,4,5752,5138,10958,38086
2022-09-19 01:00:00,2022-09-19 02:00:00,64,0,4,5961,4730,10759,37927
2022-09-19 02:00:00,2022-09-19 03:00:00,64,0,4,5231,4542,9841,38415
2022-09-19 03:00:00,2022-09-19 04:00:00,64,0,4,5423,4235,9726,40170
2022-09-19 04:00:00,2022-09-19 05:00:00,62,0,4,6232,3618,9916,44319
2022-09-19 05:00:00,2022-09-19 06:00:00,63,0,22,6518,3370,9973,49051
2022-09-19 06:00:00,2022-09-19 07:00:00,60,0,144,6695,3649,10548,48836
2022-09-19 07:00:00,2022-09-19 08:00:00,61,0,440,6655,3699,10855,45517
2022-09-19 08:00:00,2022-09-19 09:00:00,62,0,850,6332,3326,10570,42093
2022-09-19 09:00:00,2022-09-19 10:00:00,64,0,913,5064,3462,9503,40188
2022-09-19 10:00:00,2022-09-19 11:00:00,63,0,778,4042,3685,8568,38631
2022-09-19 11:00:00,2022-09-19 12:00:00,63,0,1149,4099,3876,9187,38108
2022-09-19 12:00:00,2022-09-19 13:00:00,62,0,985,3771,3868,8686,38617
2022-09-19 13:00:00,2022-09-19 14:00:00,63,0,745,3913,4628,9349,41291
2022-09-19 14:00:00,2022-09-19 15:00:00,61,0,641,4727,4492,9921,44603
2022-09-19 15:00:00,2022-09-19 16:00:00,64,0,407,4820,4687,9978,49377
2022-09-19 16:00:00,2022-09-19 17:00:00,64,0,150,4787,3434,8435,51233
2022-09-19 17:00:00,2022-09-19 18:00:00,63,0,13,5366,3399,8841,52974
2022-09-19 18:00:00,2022-09-19 19:00:00,62,0,8,4858,3163,8091,52402
2022-09-19 19:00:00,2022-09-19 20:00:00,63,0,8,4422,2702,7195,49509
2022-09-19 20:00:00,2022-09-19 21:00:00,66,0,8,3375,2331,5780,46765
2022-09-19 21:00:00,2022-09-19 22:00:00,61,0,8,3175,2155,5399,44141
2022-09-19 22:00:00,2022-09-19 23:00:00,64,0,8,3329,1628,5029,41827
2022-09-19 23:00:00,2022-09-20 00:00:00,65,0,8,2739,1631,4443,40404
2022-09-20 00:00:00,2022-09-20 01:00:00,66,0,8,2351,1225,3650,39546
2022-09-20 01:00:00,2022-09-20 02:00:00,73,0,8,1946,1448,3475,39343
2022-09-20 02:00:00,2022-09-20 03:00:00,74,0,8,2029,1038,3149,39465
2022-09-20 03:00:00,2022-09-20 04:00:00,72,0,8,2380,982,3442,41280
2022-09-20 04:00:00,2022-09-20 05:00:00,70,0,8,2211,909,3198,45682
2022-09-20 05:00:00,2022-09-20 06:00:00,65,0,67,2356,757,3245,50452
2022-09-20 06:00:00,2022-09-20 07:00:00,65,0,228,2085,566,2944,50562
2022-09-20 07:00:00,2022-09-20 08:00:00,67,0,454,1930,776,3227,47289
2022-09-20 08:00:00,2022-09-20 09:00:00,68,0,730,1682,866,3346,43238
2022-09-20 09:00:00,2022-09-20 10:00:00,68,0,904,1966,908,3846,42185
2022-09-20 10:00:00,2022-09-20 11:00:00,68,0,851,1690,926,3535,41989
2022-09-20 11:00:00,2022-09-20 12:00:00,67,0,966,1270,1048,3351,41508
2022-09-20 12:00:00,2022-09-20 13:00:00,67,0,918,1340,981,3306,41342
2022-09-20 13:00:00,2022-09-20 14:00:00,64,0,897,1003,794,2758,40908
2022-09-20 14:00:00,2022-09-20 15:00:00,64,0,689,721,877,2351,42904
2022-09-20 15:00:00,2022-09-20 16:00:00,67,0,468,831,840,2206,47849
2022-09-20 16:00:00,2022-09-20 17:00:00,65,0,128,861,818,1872,50758
2022-09-20 17:00:00,2022-09-20 18:00:00,65,0,6,789,740,1600,53352
2022-09-20 18:00:00,2022-09-20 19:00:00,65,0,4,746,506,1321,52873
2022-09-20 19:00:00,2022-09-20 20:00:00,64,0,4,828,296,1192,50269
2022-09-20 20:00:00,2022-09-20 21:00:00,65,0,4,1292,138,1499,47400
2022-09-20 21:00:00,2022-09-20 22:00:00,62,0,4,940,117,1123,44742
2022-09-20 22:00:00,2022-09-20 23:00:00,63,0,4,551,109,727,42571
2022-09-20 23:00:00,2022-09-21 00:00:00,64,0,4,203,104,375,41008
2022-09-21 00:00:00,2022-09-21 01:00:00,65,0,4,94,105,268,40256
2022-09-21 01:00:00,2022-09-21 02:00:00,64,0,4,109,98,275,39862
2022-09-21 02:00:00,2022-09-21 03:00:00,64,0,4,119,94,281,40006
2022-09-21 03:00:00,2022-09-21 04:00:00,64,0,4,103,97,268,41692
2022-09-21 04:00:00,2022-09-21 05:00:00,63,0,4,97,98,262,46217
2022-09-21 05:00:00,2022-09-21 06:00:00,63,0,51,105,103,322,50305
2022-09-21 06:00:00,2022-09-21 07:00:00,60,0,305,112,156,633,48713
2022-09-21 07:00:00,2022-09-21 08:00:00,64,0,706,133,220,1123,43423
2022-09-21 08:00:00,2022-09-21 09:00:00,62,0,1025,123,264,1474,37943
2022-09-21 09:00:00,2022-09-21 10:00:00,63,0,1102,112,301,1578,34576
2022-09-21 10:00:00,2022-09-21 11:00:00,60,0,1090,107,321,1578,34772
2022-09-21 11:00:00,2022-09-21 12:00:00,61,0,1092,102,329,1584,35540
2022-09-21 12:00:00,2022-09-21 13:00:00,61,0,997,79,327,1464,36268
2022-09-21 13:00:00,2022-09-21 14:00:00,60,0,1022,87,294,1463,38948
2022-09-21 14:00:00,2022-09-21 15:00:00,59,0,707,95,242,1103,42679
2022-09-21 15:00:00,2022-09-21 16:00:00,64,0,362,101,190,717,47904
2022-09-21 16:00:00,2022-09-21 17:00:00,62,0,120,107,132,421,51096
2022-09-21 17:00:00,2022-09-21 18:00:00,63,0,5,106,101,275,53594
2022-09-21 18:00:00,2022-09-21 19:00:00,63,0,4,91,119,277,53118
2022-09-21 19:00:00,2022-09-21 20:00:00,64,0,4,80,124,272,50155
2022-09-21 20:00:00,2022-09-21 21:00:00,64,0,4,80,124,272,47049
2022-09-21 21:00:00,2022-09-21 22:00:00,62,0,4,104,120,290,44709
2022-09-21 22:00:00,2022-09-21 23:00:00,63,0,4,118,109,294,42302
2022-09-21 23:00:00,2022-09-22 00:00:00,64,0,4,139,112,319,40643
2022-09-22 00:00:00,2022-09-22 01:00:00,65,0,4,163,133,365,39842
2022-09-22 01:00:00,2022-09-22 02:00:00,64,0,4,185,193,446,39269
2022-09-22 02:00:00,2022-09-22 03:00:00,64,0,4,217,261,546,39260
2022-09-22 03:00:00,2022-09-22 04:00:00,64,0,4,210,265,543,40901
2022-09-22 04:00:00,2022-09-22 05:00:00,64,0,4,225,236,529,45758
2022-09-22 05:00:00,2022-09-22 06:00:00,64,0,47,337,222,670,50248
2022-09-22 06:00:00,2022-09-22 07:00:00,62,0,284,456,265,1067,48540
2022-09-22 07:00:00,2022-09-22 08:00:00,63,0,653,434,304,1454,43095
2022-09-22 08:00:00,2022-09-22 09:00:00,64,0,991,508,337,1900,37584
2022-09-22 09:00:00,2022-09-22 10:00:00,64,0,1195,543,324,2126,34066
2022-09-22 10:00:00,2022-09-22 11:00:00,64,0,1246,483,356,2149,31843
2022-09-22 11:00:00,2022-09-22 12:00:00,64,0,1060,480,445,2049,32197
2022-09-22 12:00:00,2022-09-22 13:00:00,65,0,991,573,598,2227,33107
2022-09-22 13:00:00,2022-09-22 14:00:00,61,0,916,562,644,2183,35633
2022-09-22 14:00:00,2022-09-22 15:00:00,64,0,660,474,538,1736,40560
2022-09-22 15:00:00,2022-09-22 16:00:00,64,0,353,477,396,1290,47555
2022-09-22 16:00:00,2022-09-22 17:00:00,64,0,112,379,344,899,51886
2022-09-22 17:00:00,2022-09-22 18:00:00,63,0,5,359,402,829,54066
2022-09-22 18:00:00,2022-09-22 19:00:00,62,0,4,490,312,868,53104
2022-09-22 19:00:00,2022-09-22 20:00:00,64,0,4,527,386,981,50087
2022-09-22 20:00:00,2022-09-22 21:00:00,64,0,4,779,643,1490,46514
2022-09-22 21:00:00,2022-09-22 22:00:00,64,0,4,1239,891,2198,43891
2022-09-22 22:00:00,2022-09-22 23:00:00,64,0,4,1332,1211,2611,41759
2022-09-22 23:00:00,2022-09-23 00:00:00,64,0,4,1478,1251,2797,40082
2022-09-23 00:00:00,2022-09-23 01:00:00,64,0,4,1617,1168,2853,39169
2022-09-23 01:00:00,2022-09-23 02:00:00,64,0,4,1808,1076,2952,38704
2022-09-23 02:00:00,2022-09-23 03:00:00,64,0,4,1517,1195,2780,38850
2022-09-23 03:00:00,2022-09-23 04:00:00,63,0,4,1526,1305,2898,40517
2022-09-23 04:00:00,2022-09-23 05:00:00,63,0,4,1495,1475,3037,44665
2022-09-23 05:00:00,2022-09-23 06:00:00,60,0,43,1459,1353,2915,49700
2022-09-23 06:00:00,2022-09-23 07:00:00,62,0,243,1380,1040,2725,50785
2022-09-23 07:00:00,2022-09-23 08:00:00,64,0,355,1021,761,2201,48635
2022-09-23 08:00:00,2022-09-23 09:00:00,64,0,493,998,645,2200,46279
2022-09-23 09:00:00,2022-09-23 10:00:00,64,0,540,950,525,2079,45149
2022-09-23 10:00:00,2022-09-23 11:00:00,64,0,469,1185,392,2110,44855
2022-09-23 11:00:00,2022-09-23 12:00:00,64,0,397,1272,427,2160,45319
2022-09-23 12:00:00,2022-09-23 13:00:00,64,0,397,1405,517,2383,45815
2022-09-23 13:00:00,2022-09-23 14:00:00,63,0,339,1150,645,2197,47602
2022-09-23 14:00:00,2022-09-23 15:00:00,64,0,176,1165,759,2164,50444
2022-09-23 15:00:00,2022-09-23 16:00:00,64,0,78,1294,731,2167,53836
2022-09-23 16:00:00,2022-09-23 17:00:00,64,0,27,928,1057,2076,53521
2022-09-23 17:00:00,2022-09-23 18:00:00,64,0,4,1146,1595,2809,53245
2022-09-23 18:00:00,2022-09-23 19:00:00,62,0,4,913,1307,2286,51337
2022-09-23 19:00:00,2022-09-23 20:00:00,63,0,4,727,1392,2186,48571
2022-09-23 20:00:00,2022-09-23 21:00:00,63,0,4,1588,1463,3118,45737
2022-09-23 21:00:00,2022-09-23 22:00:00,60,0,4,2789,1184,4037,43785
2022-09-23 22:00:00,2022-09-23 23:00:00,63,0,4,3660,1237,4964,42000
2022-09-23 23:00:00,2022-09-24 00:00:00,64,0,4,4113,1090,5271,40399
2022-09-24 00:00:00,2022-09-24 01:00:00,64,0,4,5000,1051,6119,39472
2022-09-24 01:00:00,2022-09-24 02:00:00,64,0,4,5720,1245,7033,38645
2022-09-24 02:00:00,2022-09-24 03:00:00,64,0,4,5775,1263,7106,38298
2022-09-24 03:00:00,2022-09-24 04:00:00,64,0,4,6797,1986,8851,38700
2022-09-24 04:00:00,2022-09-24 05:00:00,64,0,4,6901,2296,9265,40217
2022-09-24 05:00:00,2022-09-24 06:00:00,62,0,8,7203,2605,9878,42584
2022-09-24 06:00:00,2022-09-24 07:00:00,61,0,43,6668,2655,9427,44735
2022-09-24 07:00:00,2022-09-24 08:00:00,64,0,111,8236,2968,11379,45972
2022-09-24 08:00:00,2022-09-24 09:00:00,64,0,196,8466,3306,12032,45485
2022-09-24 09:00:00,2022-09-24 10:00:00,64,0,246,8043,3753,12106,45044
2022-09-24 10:00:00,2022-09-24 11:00:00,64,0,176,7560,3650,11450,43609
2022-09-24 11:00:00,2022-09-24 12:00:00,64,0,253,6896,3865,11078,42578
2022-09-24 12:00:00,2022-09-24 13:00:00,64,0,222,6520,3881,10687,41376
2022-09-24 13:00:00,2022-09-24 14:00:00,64,0,207,6370,3928,10569,41373
2022-09-24 14:00:00,2022-09-24 15:00:00,61,0,203,7006,4046,11316,42934
2022-09-24 15:00:00,2022-09-24 16:00:00,62,0,202,6895,4059,11218,45912
2022-09-24 16:00:00,2022-09-24 17:00:00,64,0,54,7086,3508,10712,47592
2022-09-24 17:00:00,2022-09-24 18:00:00,64,0,6,7388,3107,10565,48813
2022-09-24 18:00:00,2022-09-24 19:00:00,64,0,4,7390,3193,10651,47890
2022-09-24 19:00:00,2022-09-24 20:00:00,64,0,4,7117,2614,9799,45753
2022-09-24 20:00:00,2022-09-24 21:00:00,64,0,4,6164,2150,8382,43636
2022-09-24 21:00:00,2022-09-24 22:00:00,62,0,4,5558,1646,7270,41943
2022-09-24 22:00:00,2022-09-24 23:00:00,61,0,4,4997,1636,6698,40500
2022-09-24 23:00:00,2022-09-25 00:00:00,64,0,4,4426,1572,6066,39272
2022-09-25 00:00:00,2022-09-25 01:00:00,64,0,4,4362,1399,5829,38441
2022-09-25 01:00:00,2022-09-25 02:00:00,64,0,4,3913,1363,5344,37918
2022-09-25 02:00:00,2022-09-25 03:00:00,64,0,4,3125,859,4052,37826
2022-09-25 03:00:00,2022-09-25 04:00:00,64,0,4,2460,799,3327,37482
2022-09-25 04:00:00,2022-09-25 05:00:00,63,0,4,1035,636,1738,38055
2022-09-25 05:00:00,2022-09-25 06:00:00,61,0,37,1878,710,2686,38990
2022-09-25 06:00:00,2022-09-25 07:00:00,62,0,247,1736,524,2569,37388
2022-09-25 07:00:00,2022-09-25 08:00:00,64,0,581,1581,337,2563,34438
2022-09-25 08:00:00,2022-09-25 09:00:00,64,0,876,1671,364,2975,31385
2022-09-25 09:00:00,2022-09-25 10:00:00,64,0,857,1456,474,2851,30114
2022-09-25 10:00:00,2022-09-25 11:00:00,64,0,595,2355,743,3757,30034
2022-09-25 11:00:00,2022-09-25 12:00:00,64,0,805,975,634,2478,29574
2022-09-25 12:00:00,2022-09-25 13:00:00,64,0,698,1371,439,2572,30319
2022-09-25 13:00:00,2022-09-25 14:00:00,64,0,721,1010,533,2328,33198
2022-09-25 14:00:00,2022-09-25 15:00:00,64,0,534,558,548,1704,37184
2022-09-25 15:00:00,2022-09-25 16:00:00,64,0,348,507,544,1463,43816
2022-09-25 16:00:00,2022-09-25 17:00:00,64,0,31,569,588,1252,47935
2022-09-25 17:00:00,2022-09-25 18:00:00,64,0,8,790,473,1335,49676
2022-09-25 18:00:00,2022-09-25 19:00:00,63,0,8,1054,653,1778,48873
2022-09-25 19:00:00,2022-09-25 20:00:00,64,0,8,2548,1173,3793,46560
2022-09-25 20:00:00,2022-09-25 21:00:00,64,0,8,4607,1961,6640,44317
2022-09-25 21:00:00,2022-09-25 22:00:00,63,0,8,5554,2701,8326,42133
2022-09-25 22:00:00,2022-09-25 23:00:00,63,0,8,6121,3348,9540,39953
2022-09-25 23:00:00,2022-09-26 00:00:00,64,0,8,7501,4261,11834,38507
2022-09-26 00:00:00,2022-09-26 01:00:00,64,0,8,8668,5143,13883,37944
2022-09-26 01:00:00,2022-09-26 02:00:00,64,0,8,9209,5555,14836,37678
2022-09-26 02:00:00,2022-09-26 03:00:00,64,0,8,9302,5977,15351,37856
2022-09-26 03:00:00,2022-09-26 04:00:00,64,0,8,9272,7136,16480,39973
2022-09-26 04:00:00,2022-09-26 05:00:00,64,0,8,9266,7658,16996,44825
2022-09-26 05:00:00,2022-09-26 06:00:00,59,0,12,9179,7986,17236,50283
2022-09-26 06:00:00,2022-09-26 07:00:00,59,0,67,9229,8124,17479,53187
2022-09-26 07:00:00,2022-09-26 08:00:00,64,0,145,9021,7990,17220,53760
2022-09-26 08:00:00,2022-09-26 09:00:00,64,0,226,7411,8093,15794,53654
2022-09-26 09:00:00,2022-09-26 10:00:00,64,0,240,5355,7897,13556,53197
2022-09-26 10:00:00,2022-09-26 11:00:00,64,0,214,3746,6763,10787,52635
2022-09-26 11:00:00,2022-09-26 12:00:00,64,0,197,4683,5685,10629,53119
2022-09-26 12:00:00,2022-09-26 13:00:00,64,0,179,5504,4264,10011,52612
2022-09-26 13:00:00,2022-09-26 14:00:00,60,0,201,6492,3656,10409,52231
2022-09-26 14:00:00,2022-09-26 15:00:00,61,0,174,6037,2956,9228,53006
2022-09-26 15:00:00,2022-09-26 16:00:00,63,0,106,7630,2944,10743,55749
2022-09-26 16:00:00,2022-09-26 17:00:00,65,0,31,8076,1926,10098,55681
2022-09-26 17:00:00,2022-09-26 18:00:00,64,0,4,8356,2654,11078,56020
2022-09-26 18:00:00,2022-09-26 19:00:00,64,0,4,8178,3209,11455,54200
2022-09-26 19:00:00,2022-09-26 20:00:00,65,0,4,7941,4546,12556,51238
2022-09-26 20:00:00,2022-09-26 21:00:00,65,0,4,8773,4412,13254,48690
2022-09-26 21:00:00,2022-09-26 22:00:00,64,0,4,8622,4571,13261,45426
2022-09-26 22:00:00,2022-09-26 23:00:00,63,0,4,8559,4865,13491,42790
2022-09-26 23:00:00,2022-09-27 00:00:00,65,0,4,8331,4211,12611,41038
2022-09-27 00:00:00,2022-09-27 01:00:00,64,0,4,7757,4508,12333,40029
2022-09-27 01:00:00,2022-09-27 02:00:00,64,0,4,8494,4186,12748,39912
2022-09-27 02:00:00,2022-09-27 03:00:00,64,0,4,8385,3860,12313,40075
2022-09-27 03:00:00,2022-09-27 04:00:00,64,0,4,8112,3834,12014,41752
2022-09-27 04:00:00,2022-09-27 05:00:00,62,0,4,8312,3233,11611,46196
2022-09-27 05:00:00,2022-09-27 06:00:00,60,0,12,7718,3169,10959,51792
2022-09-27 06:00:00,2022-09-27 07:00:00,62,0,153,7719,3059,10993,53120
2022-09-27 07:00:00,2022-09-27 08:00:00,63,0,358,7490,2716,10627,53100
2022-09-27 08:00:00,2022-09-27 09:00:00,63,0,560,7089,2899,10611,52528
2022-09-27 09:00:00,2022-09-27 10:00:00,62,0,681,5766,2866,9375,52277
2022-09-27 10:00:00,2022-09-27 11:00:00,63,0,542,5078,2430,8113,49734
2022-09-27 11:00:00,2022-09-27 12:00:00,63,0,588,5056,2997,8704,47914
2022-09-27 12:00:00,2022-09-27 13:00:00,64,0,662,6245,3028,9999,47444
2022-09-27 13:00:00,2022-09-27 14:00:00,60,0,339,6274,2314,8987,48744
2022-09-27 14:00:00,2022-09-27 15:00:00,62,0,204,5524,2596,8386,51703
2022-09-27 15:00:00,2022-09-27 16:00:00,62,0,187,5026,1945,7220,55882
2022-09-27 16:00:00,2022-09-27 17:00:00,64,0,41,3723,1613,5441,56294
2022-09-27 17:00:00,2022-09-27 18:00:00,64,0,5,3053,834,3956,56529
2022-09-27 18:00:00,2022-09-27 19:00:00,63,0,4,2932,786,3785,54623
2022-09-27 19:00:00,2022-09-27 20:00:00,61,0,4,3287,861,4213,51648
2022-09-27 20:00:00,2022-09-27 21:00:00,64,0,4,2659,789,3516,48153
2022-09-27 21:00:00,2022-09-27 22:00:00,65,0,4,2125,794,2988,45347
2022-09-27 22:00:00,2022-09-27 23:00:00,62,0,4,2249,770,3085,43087
2022-09-27 23:00:00,2022-09-28 00:00:00,64,0,4,1905,782,2755,41495
2022-09-28 00:00:00,2022-09-28 01:00:00,67,0,4,3150,914,4135,40591
2022-09-28 01:00:00,2022-09-28 02:00:00,64,0,4,2099,833,3000,40229
2022-09-28 02:00:00,2022-09-28 03:00:00,65,0,4,1661,744,2474,39865
2022-09-28 03:00:00,2022-09-28 04:00:00,65,0,4,2413,602,3084,41685
2022-09-28 04:00:00,2022-09-28 05:00:00,64,0,4,1526,810,2404,46672
2022-09-28 05:00:00,2022-09-28 06:00:00,65,0,15,2364,746,3190,52164
2022-09-28 06:00:00,2022-09-28 07:00:00,65,0,103,2373,610,3151,51681
2022-09-28 07:00:00,2022-09-28 08:00:00,67,0,336,2238,553,3194,46499
2022-09-28 08:00:00,2022-09-28 09:00:00,64,0,578,2684,738,4064,41845
2022-09-28 09:00:00,2022-09-28 10:00:00,64,0,767,2638,749,4218,39604
2022-09-28 10:00:00,2022-09-28 11:00:00,64,0,1042,2028,826,3960,40114
2022-09-28 11:00:00,2022-09-28 12:00:00,64,0,982,1550,873,3469,41319
2022-09-28 12:00:00,2022-09-28 13:00:00,66,0,604,1106,1018,2794,43232
2022-09-28 13:00:00,2022-09-28 14:00:00,62,0,522,998,851,2433,45222
2022-09-28 14:00:00,2022-09-28 15:00:00,62,0,261,937,783,2043,47882
2022-09-28 15:00:00,2022-09-28 16:00:00,65,0,172,748,915,1900,52727
2022-09-28 16:00:00,2022-09-28 17:00:00,64,0,38,1007,830,1939,54146
2022-09-28 17:00:00,2022-09-28 18:00:00,66,0,4,205,846,1121,55835
2022-09-28 18:00:00,2022-09-28 19:00:00,73,0,4,131,740,948,54293
2022-09-28 19:00:00,2022-09-28 20:00:00,76,0,4,182,504,766,51229
2022-09-28 20:00:00,2022-09-28 21:00:00,73,0,4,115,452,644,48139
2022-09-28 21:00:00,2022-09-28 22:00:00,68,0,4,178,595,845,45275
2022-09-28 22:00:00,2022-09-28 23:00:00,73,0,4,177,567,821,42998
2022-09-28 23:00:00,2022-09-29 00:00:00,75,0,4,105,596,780,41558
2022-09-29 00:00:00,2022-09-29 01:00:00,70,0,4,111,524,709,40845
2022-09-29 01:00:00,2022-09-29 02:00:00,71,0,4,120,437,632,40495
2022-09-29 02:00:00,2022-09-29 03:00:00,74,0,4,115,375,568,40591
2022-09-29 03:00:00,2022-09-29 04:00:00,75,0,4,162,335,576,41992
2022-09-29 04:00:00,2022-09-29 05:00:00,65,0,4,135,305,509,47048
2022-09-29 05:00:00,2022-09-29 06:00:00,70,0,29,106,302,507,52511
2022-09-29 06:00:00,2022-09-29 07:00:00,68,0,212,174,359,813,51939
2022-09-29 07:00:00,2022-09-29 08:00:00,71,0,499,322,421,1313,47086
2022-09-29 08:00:00,2022-09-29 09:00:00,72,0,856,184,480,1592,41212
2022-09-29 09:00:00,2022-09-29 10:00:00,71,0,795,125,491,1482,37806
2022-09-29 10:00:00,2022-09-29 11:00:00,72,0,1001,178,515,1766,34722
2022-09-29 11:00:00,2022-09-29 12:00:00,72,0,1122,189,542,1925,35524
2022-09-29 12:00:00,2022-09-29 13:00:00,72,0,885,990,451,2398,37450
2022-09-29 13:00:00,2022-09-29 14:00:00,71,0,640,798,503,2012,40361
2022-09-29 14:00:00,2022-09-29 15:00:00,72,0,416,798,504,1790,44181
2022-09-29 15:00:00,2022-09-29 16:00:00,77,0,150,863,437,1527,50252
2022-09-29 16:00:00,2022-09-29 17:00:00,76,0,30,711,366,1183,53424
2022-09-29 17:00:00,2022-09-29 18:00:00,76,0,4,662,315,1057,55618
2022-09-29 18:00:00,2022-09-29 19:00:00,76,0,4,500,313,893,54147
2022-09-29 19:00:00,2022-09-29 20:00:00,76,0,4,328,292,700,51305
2022-09-29 20:00:00,2022-09-29 21:00:00,75,0,4,288,288,655,48047
2022-09-29 21:00:00,2022-09-29 22:00:00,69,0,4,381,287,741,45335
2022-09-29 22:00:00,2022-09-29 23:00:00,73,0,4,367,283,727,42896
2022-09-29 23:00:00,2022-09-30 00:00:00,74,0,4,152,280,510,41254
2022-09-30 00:00:00,2022-09-30 01:00:00,74,0,4,109,286,473,40326
2022-09-30 01:00:00,2022-09-30 02:00:00,74,0,4,120,303,501,39809
2022-09-30 02:00:00,2022-09-30 03:00:00,73,0,4,109,336,522,40036
2022-09-30 03:00:00,2022-09-30 04:00:00,73,0,4,105,400,582,41590
2022-09-30 04:00:00,2022-09-30 05:00:00,73,0,4,218,541,836,46096
2022-09-30 05:00:00,2022-09-30 06:00:00,68,0,22,468,704,1262,51542
2022-09-30 06:00:00,2022-09-30 07:00:00,70,0,207,234,952,1463,50387
2022-09-30 07:00:00,2022-09-30 08:00:00,72,0,561,218,1181,2032,45422
2022-09-30 08:00:00,2022-09-30 09:00:00,72,0,886,938,1195,3091,40228
2022-09-30 09:00:00,2022-09-30 10:00:00,72,0,865,3082,1351,5370,36676
2022-09-30 10:00:00,2022-09-30 11:00:00,72,0,874,4059,2202,7207,34890
2022-09-30 11:00:00,2022-09-30 12:00:00,71,0,1034,5704,3456,10265,35525
2022-09-30 12:00:00,2022-09-30 13:00:00,72,0,897,6911,4378,12258,37582
2022-09-30 13:00:00,2022-09-30 14:00:00,71,0,666,8225,4781,13743,40036
2022-09-30 14:00:00,2022-09-30 15:00:00,71,0,489,9164,5414,15138,43729
2022-09-30 15:00:00,2022-09-30 16:00:00,72,0,230,9234,5952,15488,50143
2022-09-30 16:00:00,2022-09-30 17:00:00,72,0,28,9205,5850,15155,52923
2022-09-30 17:00:00,2022-09-30 18:00:00,75,0,8,9126,6685,15894,53525
2022-09-30 18:00:00,2022-09-30 19:00:00,76,0,8,9095,7719,16898,51400
2022-09-30 19:00:00,2022-09-30 20:00:00,76,0,8,9122,8528,17734,48535
2022-09-30 20:00:00,2022-09-30 21:00:00,75,0,8,9122,8784,17989,45686
2022-09-30 21:00:00,2022-09-30 22:00:00,69,0,8,8770,8766,17613,43380
2022-09-30 22:00:00,2022-09-30 23:00:00,65,0,8,7903,8442,16418,41430
2022-09-30 23:00:00,2022-10-01 00:00:00,66,0,8,7733,8349,16156,39628
2022-10-01 00:00:00,2022-10-01 01:00:00,64,0,8,7257,9046,16375,38778
2022-10-01 01:00:00,2022-10-01 02:00:00,65,0,8,6972,8942,15987,38124
2022-10-01 02:00:00,2022-10-01 03:00:00,65,0,8,6089,8519,14681,38001
2022-10-01 03:00:00,2022-10-01 04:00:00,64,0,8,5792,7285,13149,38514
2022-10-01 04:00:00,2022-10-01 05:00:00,64,0,8,5769,6030,11871,40558
2022-10-01 05:00:00,2022-10-01 06:00:00,62,0,9,7049,5187,12307,43337
2022-10-01 06:00:00,2022-10-01 07:00:00,63,0,134,7416,4684,12297,43847
2022-10-01 07:00:00,2022-10-01 08:00:00,66,0,351,6862,4646,11925,42458
2022-10-01 08:00:00,2022-10-01 09:00:00,64,0,824,6317,4446,11651,39670
2022-10-01 09:00:00,2022-10-01 10:00:00,64,0,764,5143,6276,12247,37156
2022-10-01 10:00:00,2022-10-01 11:00:00,63,0,388,6113,6929,13493,35068
2022-10-01 11:00:00,2022-10-01 12:00:00,64,0,724,5633,6698,13119,32903
2022-10-01 12:00:00,2022-10-01 13:00:00,63,0,705,5356,6880,13004,32685
2022-10-01 13:00:00,2022-10-01 14:00:00,63,0,555,5427,6883,12928,34367
2022-10-01 14:00:00,2022-10-01 15:00:00,64,0,362,5619,6646,12691,37913
2022-10-01 15:00:00,2022-10-01 16:00:00,63,0,237,6240,5884,12424,44087
2022-10-01 16:00:00,2022-10-01 17:00:00,64,0,51,5465,5313,10893,47739
2022-10-01 17:00:00,2022-10-01 18:00:00,63,0,8,5658,4499,10228,48958
2022-10-01 18:00:00,2022-10-01 19:00:00,64,0,8,5444,4585,10101,47576
2022-10-01 19:00:00,2022-10-01 20:00:00,64,0,8,5160,5279,10511,45524
2022-10-01 20:00:00,2022-10-01 21:00:00,64,0,8,5797,5738,11607,43854
2022-10-01 21:00:00,2022-10-01 22:00:00,60,0,8,7239,5422,12729,42202
2022-10-01 22:00:00,2022-10-01 23:00:00,62,0,8,8452,5813,14335,40235
2022-10-01 23:00:00,2022-10-02 00:00:00,61,0,8,8027,5689,13785,38824
2022-10-02 00:00:00,2022-10-02 01:00:00,65,0,8,7716,5103,12892,37733
2022-10-02 01:00:00,2022-10-02 02:00:00,64,0,8,7683,4900,12655,37222
2022-10-02 02:00:00,2022-10-02 03:00:00,65,0,8,7579,4596,12248,37044
2022-10-02 03:00:00,2022-10-02 04:00:00,64,0,8,7376,4157,11605,37188
2022-10-02 04:00:00,2022-10-02 05:00:00,64,0,5,6411,3457,9937,37445
2022-10-02 05:00:00,2022-10-02 06:00:00,61,0,18,5043,3685,8807,38659
2022-10-02 06:00:00,2022-10-02 07:00:00,63,0,180,4625,3816,8684,39054
2022-10-02 07:00:00,2022-10-02 08:00:00,64,0,333,4100,3437,7934,38447
2022-10-02 08:00:00,2022-10-02 09:00:00,64,0,552,3563,2717,6896,35973
2022-10-02 09:00:00,2022-10-02 10:00:00,64,0,728,3546,2820,7158,34039
2022-10-02 10:00:00,2022-10-02 11:00:00,64,0,901,3539,3082,7586,34581
2022-10-02 11:00:00,2022-10-02 12:00:00,65,0,905,3447,2941,7358,32891
2022-10-02 12:00:00,2022-10-02 13:00:00,64,0,682,3130,2616,6492,31875
2022-10-02 13:00:00,2022-10-02 14:00:00,64,0,591,2818,2470,5943,32084
2022-10-02 14:00:00,2022-10-02 15:00:00,66,0,461,2832,2541,5900,36009
2022-10-02 15:00:00,2022-10-02 16:00:00,66,0,233,3275,2960,6534,43043
2022-10-02 16:00:00,2022-10-02 17:00:00,65,0,42,3327,3004,6438,47198
2022-10-02 17:00:00,2022-10-02 18:00:00,64,0,4,3238,3088,6394,49063
2022-10-02 18:00:00,2022-10-02 19:00:00,64,0,4,2979,2919,5966,47726
2022-10-02 19:00:00,2022-10-02 20:00:00,61,0,4,2420,2677,5162,45664
2022-10-02 20:00:00,2022-10-02 21:00:00,64,0,4,1988,2346,4402,43503
2022-10-02 21:00:00,2022-10-02 22:00:00,64,0,4,2151,2217,4436,41459
2022-10-02 22:00:00,2022-10-02 23:00:00,64,0,4,2035,1593,3696,39841
2022-10-02 23:00:00,2022-10-03 00:00:00,66,0,4,1675,1414,3159,38669
2022-10-03 00:00:00,2022-10-03 01:00:00,65,0,4,1488,1369,2926,38013
2022-10-03 01:00:00,2022-10-03 02:00:00,65,0,4,992,1319,2380,37535
2022-10-03 02:00:00,2022-10-03 03:00:00,64,0,4,753,929,1750,38240
2022-10-03 03:00:00,2022-10-03 04:00:00,64,0,4,615,771,1454,40548
2022-10-03 04:00:00,2022-10-03 05:00:00,64,0,4,449,701,1218,45565
2022-10-03 05:00:00,2022-10-03 06:00:00,64,0,16,326,608,1014,51221
2022-10-03 06:00:00,2022-10-03 07:00:00,62,0,179,594,523,1358,51293
2022-10-03 07:00:00,2022-10-03 08:00:00,68,0,512,544,497,1621,46939
2022-10-03 08:00:00,2022-10-03 09:00:00,72,0,803,596,566,2037,42661
2022-10-03 09:00:00,2022-10-03 10:00:00,72,0,1025,644,592,2333,40771
2022-10-03 10:00:00,2022-10-03 11:00:00,76,0,996,605,596,2273,40429
2022-10-03 11:00:00,2022-10-03 12:00:00,76,0,891,507,524,1998,40987
2022-10-03 12:00:00,2022-10-03 13:00:00,75,0,799,567,526,1967,43124
2022-10-03 13:00:00,2022-10-03 14:00:00,74,0,601,376,533,1584,45863
2022-10-03 14:00:00,2022-10-03 15:00:00,69,0,362,200,521,1152,49168
2022-10-03 15:00:00,2022-10-03 16:00:00,76,0,198,218,444,936,53164
2022-10-03 16:00:00,2022-10-03 17:00:00,76,0,31,363,488,958,54830
2022-10-03 17:00:00,2022-10-03 18:00:00,75,0,4,558,491,1128,55860
2022-10-03 18:00:00,2022-10-03 19:00:00,75,0,4,997,580,1656,53202
2022-10-03 19:00:00,2022-10-03 20:00:00,76,0,4,1395,681,2156,49883
2022-10-03 20:00:00,2022-10-03 21:00:00,76,0,4,2342,855,3277,46755
2022-10-03 21:00:00,2022-10-03 22:00:00,78,0,4,2270,957,3309,44291
2022-10-03 22:00:00,2022-10-03 23:00:00,82,0,4,2257,1279,3622,42142
2022-10-03 23:00:00,2022-10-04 00:00:00,84,0,4,2545,1434,4067,40581
2022-10-04 00:00:00,2022-10-04 01:00:00,84,0,4,2460,1588,4136,39688
2022-10-04 01:00:00,2022-10-04 02:00:00,84,0,4,2336,1861,4285,38940
2022-10-04 02:00:00,2022-10-04 03:00:00,84,0,4,2742,2214,5044,39017
2022-10-04 03:00:00,2022-10-04 04:00:00,83,0,4,3020,2166,5273,40348
2022-10-04 04:00:00,2022-10-04 05:00:00,80,0,4,3292,2132,5508,44809
2022-10-04 05:00:00,2022-10-04 06:00:00,78,0,12,3774,2674,6538,50860
2022-10-04 06:00:00,2022-10-04 07:00:00,80,0,162,4120,3438,7800,51158
2022-10-04 07:00:00,2022-10-04 08:00:00,83,0,504,4109,2936,7632,45871
2022-10-04 08:00:00,2022-10-04 09:00:00,82,0,722,4719,2311,7834,40270
2022-10-04 09:00:00,2022-10-04 10:00:00,82,0,1055,4317,2426,7880,36225
2022-10-04 10:00:00,2022-10-04 11:00:00,83,0,684,5071,2604,8442,34076
2022-10-04 11:00:00,2022-10-04 12:00:00,83,0,923,5827,2649,9482,34623
2022-10-04 12:00:00,2022-10-04 13:00:00,80,0,899,6502,2937,10418,34938
2022-10-04 13:00:00,2022-10-04 14:00:00,79,0,650,7142,3785,11656,39026
2022-10-04 14:00:00,2022-10-04 15:00:00,81,0,461,7738,3534,11814,45913
2022-10-04 15:00:00,2022-10-04 16:00:00,84,0,174,7996,3265,11519,52432
2022-10-04 16:00:00,2022-10-04 17:00:00,84,0,29,8521,3585,12219,54253
2022-10-04 17:00:00,2022-10-04 18:00:00,85,0,4,8276,4581,12946,55177
2022-10-04 18:00:00,2022-10-04 19:00:00,84,0,4,7944,5154,13186,53177
2022-10-04 19:00:00,2022-10-04 20:00:00,85,0,4,8221,5261,13571,50416
2022-10-04 20:00:00,2022-10-04 21:00:00,84,0,4,7850,5305,13243,47299
2022-10-04 21:00:00,2022-10-04 22:00:00,84,0,4,8267,5526,13881,44559
2022-10-04 22:00:00,2022-10-04 23:00:00,85,0,4,8036,5772,13897,42251
2022-10-04 23:00:00,2022-10-05 00:00:00,85,0,4,7903,5736,13728,40567
2022-10-05 00:00:00,2022-10-05 01:00:00,85,0,4,7847,5821,13757,39667
2022-10-05 01:00:00,2022-10-05 02:00:00,81,0,4,8091,6169,14345,39215
2022-10-05 02:00:00,2022-10-05 03:00:00,83,0,4,8095,6306,14488,39350
2022-10-05 03:00:00,2022-10-05 04:00:00,81,0,4,8173,6555,14813,41090
2022-10-05 04:00:00,2022-10-05 05:00:00,80,0,4,8331,6818,15233,45487
2022-10-05 05:00:00,2022-10-05 06:00:00,81,0,4,8622,6891,15598,50914
2022-10-05 06:00:00,2022-10-05 07:00:00,81,0,42,8923,7016,16062,53362
2022-10-05 07:00:00,2022-10-05 08:00:00,85,0,141,8859,7260,16345,52424
2022-10-05 08:00:00,2022-10-05 09:00:00,86,0,348,8861,7779,17074,49905
2022-10-05 09:00:00,2022-10-05 10:00:00,84,0,420,8851,8254,17609,47776
2022-10-05 10:00:00,2022-10-05 11:00:00,85,0,377,8768,8591,17821,46779
2022-10-05 11:00:00,2022-10-05 12:00:00,84,0,408,7983,8177,16652,45802
2022-10-05 12:00:00,2022-10-05 13:00:00,84,0,264,7543,8274,16165,44781
2022-10-05 13:00:00,2022-10-05 14:00:00,81,0,255,8096,8388,16820,46367
2022-10-05 14:00:00,2022-10-05 15:00:00,82,0,218,8579,8855,17734,50160
2022-10-05 15:00:00,2022-10-05 16:00:00,84,0,91,8620,8891,17686,54793
2022-10-05 16:00:00,2022-10-05 17:00:00,84,0,11,8367,8758,17220,55209
2022-10-05 17:00:00,2022-10-05 18:00:00,84,0,4,8266,8999,17353,55356
2022-10-05 18:00:00,2022-10-05 19:00:00,87,0,4,8143,8837,17071,52959
2022-10-05 19:00:00,2022-10-05 20:00:00,99,0,4,8454,7715,16272,49798
2022-10-05 20:00:00,2022-10-05 21:00:00,104,0,4,8705,7492,16305,46975
2022-10-05 21:00:00,2022-10-05 22:00:00,105,0,4,8588,7366,16063,44842
2022-10-05 22:00:00,2022-10-05 23:00:00,114,0,4,8702,7362,16182,42191
2022-10-05 23:00:00,2022-10-06 00:00:00,122,0,4,8577,6537,15240,40482
2022-10-06 00:00:00,2022-10-06 01:00:00,123,0,4,8689,7568,16384,39791
2022-10-06 01:00:00,2022-10-06 02:00:00,120,0,4,8561,7034,15719,39547
2022-10-06 02:00:00,2022-10-06 03:00:00,120,0,4,8490,6376,14990,39842
2022-10-06 03:00:00,2022-10-06 04:00:00,120,0,4,8141,6056,14321,41804
2022-10-06 04:00:00,2022-10-06 05:00:00,119,0,4,6524,5761,12408,46208
2022-10-06 05:00:00,2022-10-06 06:00:00,112,0,15,5957,5178,11262,51176
2022-10-06 06:00:00,2022-10-06 07:00:00,115,0,165,5885,4828,10993,50619
2022-10-06 07:00:00,2022-10-06 08:00:00,120,0,490,6043,4304,10957,45932
2022-10-06 08:00:00,2022-10-06 09:00:00,120,0,831,5222,4326,10499,40546
2022-10-06 09:00:00,2022-10-06 10:00:00,117,0,1006,5247,5093,11463,37388
2022-10-06 10:00:00,2022-10-06 11:00:00,116,0,982,5216,4532,10846,35069
2022-10-06 11:00:00,2022-10-06 12:00:00,89,0,1145,4533,4761,10528,34295
2022-10-06 12:00:00,2022-10-06 13:00:00,91,0,1106,5096,4903,11196,35023
2022-10-06 13:00:00,2022-10-06 14:00:00,121,0,870,6419,5790,13200,38105
2022-10-06 14:00:00,2022-10-06 15:00:00,116,0,585,6910,5673,13284,43187
2022-10-06 15:00:00,2022-10-06 16:00:00,122,0,238,6758,4637,11755,49822
2022-10-06 16:00:00,2022-10-06 17:00:00,126,0,32,6981,3972,11111,53316
2022-10-06 17:00:00,2022-10-06 18:00:00,128,0,4,6785,3694,10611,55414
2022-10-06 18:00:00,2022-10-06 19:00:00,127,0,4,6616,4012,10759,53610
2022-10-06 19:00:00,2022-10-06 20:00:00,128,0,4,6424,4578,11134,50348
2022-10-06 20:00:00,2022-10-06 21:00:00,126,0,4,6479,5007,11616,47027
2022-10-06 21:00:00,2022-10-06 22:00:00,115,0,4,6226,5525,11870,44214
2022-10-06 22:00:00,2022-10-06 23:00:00,116,0,4,6206,5988,12314,41552
2022-10-06 23:00:00,2022-10-07 00:00:00,117,0,4,6054,6169,12344,40077
2022-10-07 00:00:00,2022-10-07 01:00:00,118,0,4,6225,5811,12158,39296
2022-10-07 01:00:00,2022-10-07 02:00:00,116,0,4,6704,5577,12401,38831
2022-10-07 02:00:00,2022-10-07 03:00:00,101,0,4,6341,5466,11912,39101
2022-10-07 03:00:00,2022-10-07 04:00:00,89,0,4,6230,5519,11842,40893
2022-10-07 04:00:00,2022-10-07 05:00:00,84,0,4,5830,5773,11691,45073
2022-10-07 05:00:00,2022-10-07 06:00:00,71,0,12,5994,6225,12302,50740
2022-10-07 06:00:00,2022-10-07 07:00:00,71,0,133,5974,5979,12157,51017
2022-10-07 07:00:00,2022-10-07 08:00:00,76,0,445,7076,5408,13005,47549
2022-10-07 08:00:00,2022-10-07 09:00:00,76,0,606,7139,5057,12878,44034
2022-10-07 09:00:00,2022-10-07 10:00:00,75,0,907,7416,5234,13632,41674
2022-10-07 10:00:00,2022-10-07 11:00:00,76,0,945,7602,5597,14220,39788
2022-10-07 11:00:00,2022-10-07 12:00:00,75,0,975,7506,6029,14585,39266
2022-10-07 12:00:00,2022-10-07 13:00:00,74,0,584,8313,6361,15332,40089
2022-10-07 13:00:00,2022-10-07 14:00:00,67,0,438,8536,6382,15423,42565
2022-10-07 14:00:00,2022-10-07 15:00:00,70,0,243,8816,5881,15010,46745
2022-10-07 15:00:00,2022-10-07 16:00:00,72,0,69,8927,5192,14260,51799
2022-10-07 16:00:00,2022-10-07 17:00:00,72,0,15,8948,5295,14330,52831
2022-10-07 17:00:00,2022-10-07 18:00:00,72,0,4,8884,5945,14905,53623
2022-10-07 18:00:00,2022-10-07 19:00:00,72,0,4,8853,6372,15301,51450
2022-10-07 19:00:00,2022-10-07 20:00:00,72,0,4,8923,6832,15831,48463
2022-10-07 20:00:00,2022-10-07 21:00:00,72,0,4,8656,7170,15902,45574
2022-10-07 21:00:00,2022-10-07 22:00:00,71,0,4,6779,7197,14051,43382
2022-10-07 22:00:00,2022-10-07 23:00:00,70,0,4,5872,5964,11910,40878
2022-10-07 23:00:00,2022-10-08 00:00:00,71,0,4,6482,3886,10443,39345
2022-10-08 00:00:00,2022-10-08 01:00:00,72,0,4,6027,3442,9545,38927
2022-10-08 01:00:00,2022-10-08 02:00:00,72,0,4,6059,3674,9809,38615
2022-10-08 02:00:00,2022-10-08 03:00:00,72,0,4,5861,3599,9536,38310
2022-10-08 03:00:00,2022-10-08 04:00:00,72,0,4,6582,3630,10288,38449
2022-10-08 04:00:00,2022-10-08 05:00:00,72,0,4,6544,4209,10829,40129
2022-10-08 05:00:00,2022-10-08 06:00:00,72,0,9,6600,5103,11784,42581
2022-10-08 06:00:00,2022-10-08 07:00:00,72,0,131,6532,4890,11625,42521
2022-10-08 07:00:00,2022-10-08 08:00:00,72,0,367,6196,4377,11012,39088
2022-10-08 08:00:00,2022-10-08 09:00:00,72,0,726,5882,4419,11099,35664
2022-10-08 09:00:00,2022-10-08 10:00:00,72,0,731,5400,4659,10862,34077
2022-10-08 10:00:00,2022-10-08 11:00:00,72,0,935,4601,4786,10394,32106
2022-10-08 11:00:00,2022-10-08 12:00:00,72,0,1005,3676,4093,8846,30871
2022-10-08 12:00:00,2022-10-08 13:00:00,72,0,877,3150,3779,7878,30984
2022-10-08 13:00:00,2022-10-08 14:00:00,69,0,700,2440,4014,7223,32818
2022-10-08 14:00:00,2022-10-08 15:00:00,70,0,370,2739,3579,6758,37294
2022-10-08 15:00:00,2022-10-08 16:00:00,72,0,187,2625,3136,6020,44399
2022-10-08 16:00:00,2022-10-08 17:00:00,73,0,25,2220,2524,4842,48569
2022-10-08 17:00:00,2022-10-08 18:00:00,72,0,4,1660,1658,3394,49572
2022-10-08 18:00:00,2022-10-08 19:00:00,73,0,4,1516,1270,2863,47832
2022-10-08 19:00:00,2022-10-08 20:00:00,72,0,4,1092,1132,2300,45790
2022-10-08 20:00:00,2022-10-08 21:00:00,74,0,4,912,893,1883,43895
2022-10-08 21:00:00,2022-10-08 22:00:00,68,0,4,686,722,1480,42113
2022-10-08 22:00:00,2022-10-08 23:00:00,71,0,4,728,720,1523,40453
2022-10-08 23:00:00,2022-10-09 00:00:00,73,0,4,1061,716,1854,38948
2022-10-09 00:00:00,2022-10-09 01:00:00,75,0,4,1031,770,1880,38299
2022-10-09 01:00:00,2022-10-09 02:00:00,74,0,4,677,755,1510,37852
2022-10-09 02:00:00,2022-10-09 03:00:00,73,0,4,763,657,1497,37674
2022-10-09 03:00:00,2022-10-09 04:00:00,74,0,4,973,743,1794,37527
2022-10-09 04:00:00,2022-10-09 05:00:00,73,0,4,1275,1090,2442,38290
2022-10-09 05:00:00,2022-10-09 06:00:00,73,0,10,1960,1313,3356,39980
2022-10-09 06:00:00,2022-10-09 07:00:00,74,0,143,2361,1722,4300,39104
2022-10-09 07:00:00,2022-10-09 08:00:00,73,0,448,2099,2156,4776,35202
2022-10-09 08:00:00,2022-10-09 09:00:00,72,0,777,2255,1773,4877,31268
2022-10-09 09:00:00,2022-10-09 10:00:00,73,0,1002,2561,1645,5281,28299
2022-10-09 10:00:00,2022-10-09 11:00:00,74,0,1117,2700,1612,5503,26233
2022-10-09 11:00:00,2022-10-09 12:00:00,72,0,1096,2166,1689,5023,25352
2022-10-09 12:00:00,2022-10-09 13:00:00,71,0,950,1828,1573,4422,26161
2022-10-09 13:00:00,2022-10-09 14:00:00,70,0,797,1528,1598,3993,29025
2022-10-09 14:00:00,2022-10-09 15:00:00,71,0,548,1583,1813,4015,34575
2022-10-09 15:00:00,2022-10-09 16:00:00,73,0,213,1973,1882,4141,42957
2022-10-09 16:00:00,2022-10-09 17:00:00,74,0,24,2087,1981,4166,48094
2022-10-09 17:00:00,2022-10-09 18:00:00,72,0,8,2588,2249,4917,49324
2022-10-09 18:00:00,2022-10-09 19:00:00,73,0,8,3721,2935,6737,47643
2022-10-09 19:00:00,2022-10-09 20:00:00,74,0,8,4134,3805,8021,45611
2022-10-09 20:00:00,2022-10-09 21:00:00,74,0,8,4181,4760,9023,43470
2022-10-09 21:00:00,2022-10-09 22:00:00,70,0,8,4049,5205,9332,41063
2022-10-09 22:00:00,2022-10-09 23:00:00,91,0,8,4739,5095,9933,39542
2022-10-09 23:00:00,2022-10-10 00:00:00,127,0,8,4752,4622,9509,38172
2022-10-10 00:00:00,2022-10-10 01:00:00,172,0,8,4906,4918,10004,37534
2022-10-10 01:00:00,2022-10-10 02:00:00,180,0,8,4631,4870,9689,37569
2022-10-10 02:00:00,2022-10-10 03:00:00,180,0,8,4188,4955,9331,38132
2022-10-10 03:00:00,2022-10-10 04:00:00,180,0,8,3747,4223,8158,40367
2022-10-10 04:00:00,2022-10-10 05:00:00,180,0,8,3179,4180,7547,45222
2022-10-10 05:00:00,2022-10-10 06:00:00,180,0,12,3019,3813,7024,51165
2022-10-10 06:00:00,2022-10-10 07:00:00,176,0,134,2843,3316,6469,51311
2022-10-10 07:00:00,2022-10-10 08:00:00,177,0,368,2900,2565,6010,47394
2022-10-10 08:00:00,2022-10-10 09:00:00,180,0,514,4068,2141,6903,45072
2022-10-10 09:00:00,2022-10-10 10:00:00,180,0,688,4374,2016,7258,44237
2022-10-10 10:00:00,2022-10-10 11:00:00,180,0,639,4521,2345,7685,45266
2022-10-10 11:00:00,2022-10-10 12:00:00,180,0,242,5752,3353,9527,47667
2022-10-10 12:00:00,2022-10-10 13:00:00,180,0,142,5597,4444,10363,50023
2022-10-10 13:00:00,2022-10-10 14:00:00,180,0,104,6156,5256,11696,51645
2022-10-10 14:00:00,2022-10-10 15:00:00,180,0,155,5628,4582,10545,50795
2022-10-10 15:00:00,2022-10-10 16:00:00,180,0,177,5538,4391,10286,53263
2022-10-10 16:00:00,2022-10-10 17:00:00,180,0,19,5307,3957,9463,54894
2022-10-10 17:00:00,2022-10-10 18:00:00,180,0,8,4965,3644,8797,55648
2022-10-10 18:00:00,2022-10-10 19:00:00,16,0,8,5003,3159,8186,53136
2022-10-10 19:00:00,2022-10-10 20:00:00,7,0,8,4437,3074,7526,50211
2022-10-10 20:00:00,2022-10-10 21:00:00,7,0,8,3817,2563,6395,47113
2022-10-10 21:00:00,2022-10-10 22:00:00,8,0,8,3305,2129,5450,44465
2022-10-10 22:00:00,2022-10-10 23:00:00,9,0,8,2858,1660,4535,42284
2022-10-10 23:00:00,2022-10-11 00:00:00,12,0,8,2448,1324,3792,40810
2022-10-11 00:00:00,2022-10-11 01:00:00,12,0,8,1924,1145,3089,40045
2022-10-11 01:00:00,2022-10-11 02:00:00,12,0,8,1522,882,2424,39787
2022-10-11 02:00:00,2022-10-11 03:00:00,12,0,8,1547,680,2247,40184
2022-10-11 03:00:00,2022-10-11 04:00:00,12,0,8,1211,529,1760,41892
2022-10-11 04:00:00,2022-10-11 05:00:00,12,0,8,1377,562,1959,46635
2022-10-11 05:00:00,2022-10-11 06:00:00,12,0,11,1295,687,2005,52982
2022-10-11 06:00:00,2022-10-11 07:00:00,12,0,117,895,708,1732,53090
2022-10-11 07:00:00,2022-10-11 08:00:00,12,0,338,833,891,2074,48391
2022-10-11 08:00:00,2022-10-11 09:00:00,12,0,691,619,882,2204,42230
2022-10-11 09:00:00,2022-10-11 10:00:00,26,0,945,712,798,2481,37868
2022-10-11 10:00:00,2022-10-11 11:00:00,81,0,1038,718,756,2593,35440
2022-10-11 11:00:00,2022-10-11 12:00:00,91,0,970,529,696,2286,36209
2022-10-11 12:00:00,2022-10-11 13:00:00,113,0,873,526,669,2181,37606
2022-10-11 13:00:00,2022-10-11 14:00:00,140,0,631,540,606,1917,40306
2022-10-11 14:00:00,2022-10-11 15:00:00,150,0,423,390,454,1417,45074
2022-10-11 15:00:00,2022-10-11 16:00:00,145,0,155,339,416,1055,51735
2022-10-11 16:00:00,2022-10-11 17:00:00,145,0,15,292,345,797,54950
2022-10-11 17:00:00,2022-10-11 18:00:00,145,0,4,176,350,675,55637
2022-10-11 18:00:00,2022-10-11 19:00:00,148,0,4,92,359,603,53010
2022-10-11 19:00:00,2022-10-11 20:00:00,149,0,4,79,364,596,50030
2022-10-11 20:00:00,2022-10-11 21:00:00,150,0,4,95,360,609,46983
2022-10-11 21:00:00,2022-10-11 22:00:00,146,0,4,270,357,777,44124
2022-10-11 22:00:00,2022-10-11 23:00:00,141,0,4,368,394,907,41901
2022-10-11 23:00:00,2022-10-12 00:00:00,143,0,4,478,393,1018,40267
2022-10-12 00:00:00,2022-10-12 01:00:00,145,0,4,476,381,1006,39523
2022-10-12 01:00:00,2022-10-12 02:00:00,150,0,4,566,425,1145,39229
2022-10-12 02:00:00,2022-10-12 03:00:00,154,0,4,757,412,1327,39531
2022-10-12 03:00:00,2022-10-12 04:00:00,147,0,4,780,396,1327,41416
2022-10-12 04:00:00,2022-10-12 05:00:00,144,0,4,809,438,1395,46450
2022-10-12 05:00:00,2022-10-12 06:00:00,146,0,5,978,491,1620,52574
2022-10-12 06:00:00,2022-10-12 07:00:00,148,0,107,1222,567,2044,53702
2022-10-12 07:00:00,2022-10-12 08:00:00,147,0,334,1179,697,2357,49653
2022-10-12 08:00:00,2022-10-12 09:00:00,151,0,613,1274,748,2786,42889
2022-10-12 09:00:00,2022-10-12 10:00:00,145,0,802,1366,696,3009,37731
2022-10-12 10:00:00,2022-10-12 11:00:00,142,0,1050,1523,718,3433,35365
2022-10-12 11:00:00,2022-10-12 12:00:00,140,0,1038,1494,864,3536,37101
2022-10-12 12:00:00,2022-10-12 13:00:00,147,0,886,1704,949,3686,40545
2022-10-12 13:00:00,2022-10-12 14:00:00,150,0,722,1615,1010,3497,42743
2022-10-12 14:00:00,2022-10-12 15:00:00,143,0,400,1660,965,3168,47308
2022-10-12 15:00:00,2022-10-12 16:00:00,143,0,133,1548,768,2592,53239
2022-10-12 16:00:00,2022-10-12 17:00:00,146,0,14,1753,901,2814,55314
2022-10-12 17:00:00,2022-10-12 18:00:00,148,0,4,1555,969,2676,55712
2022-10-12 18:00:00,2022-10-12 19:00:00,149,0,4,1492,1084,2729,52684
2022-10-12 19:00:00,2022-10-12 20:00:00,150,0,4,1698,1454,3306,49663
2022-10-12 20:00:00,2022-10-12 21:00:00,149,0,4,2087,1717,3957,46149
2022-10-12 21:00:00,2022-10-12 22:00:00,149,0,4,3578,2285,6016,43476
2022-10-12 22:00:00,2022-10-12 23:00:00,147,0,4,3197,2798,6146,41105
2022-10-12 23:00:00,2022-10-13 00:00:00,153,0,4,3943,2885,6985,39228
2022-10-13 00:00:00,2022-10-13 01:00:00,154,0,4,3123,2695,5976,38371
2022-10-13 01:00:00,2022-10-13 02:00:00,151,0,4,2359,2912,5426,38090
2022-10-13 02:00:00,2022-10-13 03:00:00,145,0,4,1943,2666,4758,38358
2022-10-13 03:00:00,2022-10-13 04:00:00,146,0,4,1922,2522,4594,40300
2022-10-13 04:00:00,2022-10-13 05:00:00,152,0,4,2023,2503,4682,45424
2022-10-13 05:00:00,2022-10-13 06:00:00,153,0,4,1638,2482,4277,51886
2022-10-13 06:00:00,2022-10-13 07:00:00,148,0,36,2239,2531,4954,54643
2022-10-13 07:00:00,2022-10-13 08:00:00,150,0,93,2609,2195,5047,54471
2022-10-13 08:00:00,2022-10-13 09:00:00,154,0,243,2460,1903,4760,53315
2022-10-13 09:00:00,2022-10-13 10:00:00,148,0,253,1918,1647,3966,52813
2022-10-13 10:00:00,2022-10-13 11:00:00,150,0,214,1414,1300,3078,52123
2022-10-13 11:00:00,2022-10-13 12:00:00,153,0,225,1104,1245,2727,52343
2022-10-13 12:00:00,2022-10-13 13:00:00,156,0,149,487,1037,1829,52591
2022-10-13 13:00:00,2022-10-13 14:00:00,143,0,171,376,784,1474,53383
2022-10-13 14:00:00,2022-10-13 15:00:00,148,0,91,240,553,1032,54513
2022-10-13 15:00:00,2022-10-13 16:00:00,158,0,67,234,402,861,56623
2022-10-13 16:00:00,2022-10-13 17:00:00,146,0,8,198,372,724,56948
2022-10-13 17:00:00,2022-10-13 18:00:00,159,0,4,266,377,806,56721
2022-10-13 18:00:00,2022-10-13 19:00:00,153,0,4,268,480,905,53920
2022-10-13 19:00:00,2022-10-13 20:00:00,151,0,4,351,422,928,51063
2022-10-13 20:00:00,2022-10-13 21:00:00,149,0,4,303,561,1017,47657
2022-10-13 21:00:00,2022-10-13 22:00:00,142,0,4,425,625,1196,44942
2022-10-13 22:00:00,2022-10-13 23:00:00,148,0,4,577,591,1320,43106
2022-10-13 23:00:00,2022-10-14 00:00:00,154,0,4,749,611,1518,41499
2022-10-14 00:00:00,2022-10-14 01:00:00,155,0,4,949,580,1688,40588
2022-10-14 01:00:00,2022-10-14 02:00:00,155,0,4,1124,596,1879,40304
2022-10-14 02:00:00,2022-10-14 03:00:00,151,0,4,1499,644,2298,40615
2022-10-14 03:00:00,2022-10-14 04:00:00,150,0,4,1169,725,2048,41879
2022-10-14 04:00:00,2022-10-14 05:00:00,155,0,4,945,1034,2138,46344
2022-10-14 05:00:00,2022-10-14 06:00:00,148,0,5,652,1253,2058,52362
2022-10-14 06:00:00,2022-10-14 07:00:00,147,0,60,930,1404,2541,55452
2022-10-14 07:00:00,2022-10-14 08:00:00,151,0,160,1227,1449,2987,56217
2022-10-14 08:00:00,2022-10-14 09:00:00,153,0,202,1356,1608,3319,55385
2022-10-14 09:00:00,2022-10-14 10:00:00,150,0,212,1187,1668,3217,55053
2022-10-14 10:00:00,2022-10-14 11:00:00,137,0,156,1259,1457,3009,54141
2022-10-14 11:00:00,2022-10-14 12:00:00,144,0,198,1140,1353,2835,53361
2022-10-14 12:00:00,2022-10-14 13:00:00,144,0,193,1361,1604,3302,52306
2022-10-14 13:00:00,2022-10-14 14:00:00,156,0,156,1483,1702,3497,51188
2022-10-14 14:00:00,2022-10-14 15:00:00,169,0,110,1308,1661,3248,52165
2022-10-14 15:00:00,2022-10-14 16:00:00,173,0,42,1206,2558,3979,55498
2022-10-14 16:00:00,2022-10-14 17:00:00,178,0,4,1413,1987,3582,55618
2022-10-14 17:00:00,2022-10-14 18:00:00,177,0,4,1650,1752,3583,54816
2022-10-14 18:00:00,2022-10-14 19:00:00,180,0,4,1778,1771,3733,52070
2022-10-14 19:00:00,2022-10-14 20:00:00,180,0,4,2022,1996,4202,49373
2022-10-14 20:00:00,2022-10-14 21:00:00,180,0,4,2103,2391,4678,46585
2022-10-14 21:00:00,2022-10-14 22:00:00,174,0,4,2735,2695,5608,44370
2022-10-14 22:00:00,2022-10-14 23:00:00,175,0,4,2692,2609,5480,41811
2022-10-14 23:00:00,2022-10-15 00:00:00,180,0,4,2204,2851,5239,39839
2022-10-15 00:00:00,2022-10-15 01:00:00,180,0,4,1136,2720,4040,38626
2022-10-15 01:00:00,2022-10-15 02:00:00,180,0,4,768,2734,3686,38216
2022-10-15 02:00:00,2022-10-15 03:00:00,180,0,4,1004,2645,3833,38385
2022-10-15 03:00:00,2022-10-15 04:00:00,180,0,4,1400,2453,4037,38811
2022-10-15 04:00:00,2022-10-15 05:00:00,179,0,4,1388,2351,3922,40473
2022-10-15 05:00:00,2022-10-15 06:00:00,176,0,4,2070,2609,4859,43106
2022-10-15 06:00:00,2022-10-15 07:00:00,177,0,58,3147,2770,6152,45110
2022-10-15 07:00:00,2022-10-15 08:00:00,180,0,200,3831,2910,7121,45022
2022-10-15 08:00:00,2022-10-15 09:00:00,180,0,369,3381,3301,7231,44174
2022-10-15 09:00:00,2022-10-15 10:00:00,180,0,275,3757,3774,7986,44522
2022-10-15 10:00:00,2022-10-15 11:00:00,180,0,328,4506,3708,8722,44731
2022-10-15 11:00:00,2022-10-15 12:00:00,179,0,352,5587,4060,10178,44296
2022-10-15 12:00:00,2022-10-15 13:00:00,179,0,290,6241,4075,10785,42598
2022-10-15 13:00:00,2022-10-15 14:00:00,174,0,171,6985,4049,11379,40992
2022-10-15 14:00:00,2022-10-15 15:00:00,176,0,143,9103,4187,13609,42917
2022-10-15 15:00:00,2022-10-15 16:00:00,178,0,81,9200,5322,14781,47587
2022-10-15 16:00:00,2022-10-15 17:00:00,180,0,8,8893,5285,14366,50508
2022-10-15 17:00:00,2022-10-15 18:00:00,180,0,4,8770,5979,14933,50094
2022-10-15 18:00:00,2022-10-15 19:00:00,180,0,4,8952,6790,15926,47948
2022-10-15 19:00:00,2022-10-15 20:00:00,180,0,4,9072,7293,16549,45820
2022-10-15 20:00:00,2022-10-15 21:00:00,179,0,4,8698,7243,16124,43849
2022-10-15 21:00:00,2022-10-15 22:00:00,176,0,4,8814,7110,16104,41807
2022-10-15 22:00:00,2022-10-15 23:00:00,176,0,4,8780,7070,16030,39964
2022-10-15 23:00:00,2022-10-16 00:00:00,178,0,4,8682,6996,15860,38385
2022-10-16 00:00:00,2022-10-16 01:00:00,180,0,4,8528,7071,15783,37403
2022-10-16 01:00:00,2022-10-16 02:00:00,180,0,4,8591,6909,15684,36833
2022-10-16 02:00:00,2022-10-16 03:00:00,180,0,4,8015,6677,14876,36671
2022-10-16 03:00:00,2022-10-16 04:00:00,180,0,4,7385,6444,14013,36737
2022-10-16 04:00:00,2022-10-16 05:00:00,179,0,4,8340,6457,14980,37682
2022-10-16 05:00:00,2022-10-16 06:00:00,176,0,4,8241,6428,14849,39755
2022-10-16 06:00:00,2022-10-16 07:00:00,177,0,49,8417,6970,15613,40735
2022-10-16 07:00:00,2022-10-16 08:00:00,180,0,221,8144,6573,15118,38255
2022-10-16 08:00:00,2022-10-16 09:00:00,180,0,431,6325,5764,12700,34258
2022-10-16 09:00:00,2022-10-16 10:00:00,180,0,632,4848,5710,11370,31465
2022-10-16 10:00:00,2022-10-16 11:00:00,180,0,810,3968,5123,10081,30380
2022-10-16 11:00:00,2022-10-16 12:00:00,180,0,873,3168,4064,8285,29679
2022-10-16 12:00:00,2022-10-16 13:00:00,179,0,815,2696,2988,6678,31070
2022-10-16 13:00:00,2022-10-16 14:00:00,176,0,598,2744,2013,5531,35170
2022-10-16 14:00:00,2022-10-16 15:00:00,177,0,267,2243,1308,3995,41146
2022-10-16 15:00:00,2022-10-16 16:00:00,180,0,86,1846,752,2864,47451
2022-10-16 16:00:00,2022-10-16 17:00:00,180,0,5,1712,686,2583,49958
2022-10-16 17:00:00,2022-10-16 18:00:00,180,0,4,2107,706,2997,49698
2022-10-16 18:00:00,2022-10-16 19:00:00,180,0,4,1720,848,2752,47725
2022-10-16 19:00:00,2022-10-16 20:00:00,180,0,4,2495,1728,4407,45304
2022-10-16 20:00:00,2022-10-16 21:00:00,178,0,4,3056,2760,5998,42991
2022-10-16 21:00:00,2022-10-16 22:00:00,176,0,4,3076,3109,6365,40747
2022-10-16 22:00:00,2022-10-16 23:00:00,180,0,4,3300,3457,6941,39124
2022-10-16 23:00:00,2022-10-17 00:00:00,180,0,4,3950,3622,7756,37870
2022-10-17 00:00:00,2022-10-17 01:00:00,180,0,4,4359,3488,8031,36611
2022-10-17 01:00:00,2022-10-17 02:00:00,180,0,4,4345,3907,8436,36672
2022-10-17 02:00:00,2022-10-17 03:00:00,180,0,4,5482,5026,10692,37606
2022-10-17 03:00:00,2022-10-17 04:00:00,180,0,4,6761,5086,12031,40246
2022-10-17 04:00:00,2022-10-17 05:00:00,180,0,4,6775,5751,12710,45059
2022-10-17 05:00:00,2022-10-17 06:00:00,180,0,3,5313,6075,11571,50447
2022-10-17 06:00:00,2022-10-17 07:00:00,180,0,43,7464,5565,13252,53423
2022-10-17 07:00:00,2022-10-17 08:00:00,180,0,174,5852,5134,11340,54199
2022-10-17 08:00:00,2022-10-17 09:00:00,180,0,173,5773,5479,11605,56026
2022-10-17 09:00:00,2022-10-17 10:00:00,180,0,132,5193,3439,8944,56197
2022-10-17 10:00:00,2022-10-17 11:00:00,180,0,76,4985,3140,8381,55476
2022-10-17 11:00:00,2022-10-17 12:00:00,180,0,125,4978,3496,8779,54160
2022-10-17 12:00:00,2022-10-17 13:00:00,180,0,165,5015,3281,8641,53568
2022-10-17 13:00:00,2022-10-17 14:00:00,177,0,96,5053,3426,8752,52815
2022-10-17 14:00:00,2022-10-17 15:00:00,176,0,80,4589,3114,7959,53639
2022-10-17 15:00:00,2022-10-17 16:00:00,180,0,50,3865,3424,7519,56285
2022-10-17 16:00:00,2022-10-17 17:00:00,180,0,5,3567,3337,7089,56264
2022-10-17 17:00:00,2022-10-17 18:00:00,180,0,4,3830,3393,7407,55387
2022-10-17 18:00:00,2022-10-17 19:00:00,180,0,4,3861,3442,7487,52851
2022-10-17 19:00:00,2022-10-17 20:00:00,180,0,4,3405,3158,6747,49885
2022-10-17 20:00:00,2022-10-17 21:00:00,180,0,4,2830,2666,5680,47079
2022-10-17 21:00:00,2022-10-17 22:00:00,179,0,4,2120,2176,4479,44523
2022-10-17 22:00:00,2022-10-17 23:00:00,176,0,4,1973,1916,4069,42161
2022-10-17 23:00:00,2022-10-18 00:00:00,178,0,4,1788,1801,3771,40665
2022-10-18 00:00:00,2022-10-18 01:00:00,180,0,4,1384,1470,3038,39881
2022-10-18 01:00:00,2022-10-18 02:00:00,180,0,4,1034,1133,2351,39348
2022-10-18 02:00:00,2022-10-18 03:00:00,180,0,4,831,920,1935,39484
2022-10-18 03:00:00,2022-10-18 04:00:00,180,0,4,717,842,1743,41421
2022-10-18 04:00:00,2022-10-18 05:00:00,180,0,4,910,767,1861,45771
2022-10-18 05:00:00,2022-10-18 06:00:00,176,0,4,1116,702,1998,51980
2022-10-18 06:00:00,2022-10-18 07:00:00,178,0,36,1137,679,2030,53721
2022-10-18 07:00:00,2022-10-18 08:00:00,180,0,277,889,763,2109,49677
2022-10-18 08:00:00,2022-10-18 09:00:00,180,0,592,806,690,2268,43379
2022-10-18 09:00:00,2022-10-18 10:00:00,180,0,893,895,794,2762,38421
2022-10-18 10:00:00,2022-10-18 11:00:00,180,0,954,1141,1104,3379,35676
2022-10-18 11:00:00,2022-10-18 12:00:00,180,0,998,1177,1174,3529,34879
2022-10-18 12:00:00,2022-10-18 13:00:00,180,0,825,1309,1132,3446,35487
2022-10-18 13:00:00,2022-10-18 14:00:00,176,0,634,1168,1119,3097,38989
2022-10-18 14:00:00,2022-10-18 15:00:00,176,0,358,1056,969,2559,45060
2022-10-18 15:00:00,2022-10-18 16:00:00,180,0,104,1155,823,2262,52533
2022-10-18 16:00:00,2022-10-18 17:00:00,180,0,8,1429,840,2457,55289
2022-10-18 17:00:00,2022-10-18 18:00:00,180,0,4,1228,813,2225,54926
2022-10-18 18:00:00,2022-10-18 19:00:00,180,0,4,1425,794,2403,52459
2022-10-18 19:00:00,2022-10-18 20:00:00,180,0,4,1870,983,3037,49616
2022-10-18 20:00:00,2022-10-18 21:00:00,180,0,4,1719,1192,3095,46658
2022-10-18 21:00:00,2022-10-18 22:00:00,177,0,4,1712,1153,3046,43974
2022-10-18 22:00:00,2022-10-18 23:00:00,180,0,4,2264,1122,3570,41808
2022-10-18 23:00:00,2022-10-19 00:00:00,180,0,4,2945,1259,4388,40114
2022-10-19 00:00:00,2022-10-19 01:00:00,180,0,4,3666,1246,5096,39244
2022-10-19 01:00:00,2022-10-19 02:00:00,180,0,4,3739,1258,5181,38944
2022-10-19 02:00:00,2022-10-19 03:00:00,180,0,4,4387,1258,5829,39470
2022-10-19 03:00:00,2022-10-19 04:00:00,180,0,4,4752,1646,6582,41137
2022-10-19 04:00:00,2022-10-19 05:00:00,180,0,4,5257,1840,7281,45683
2022-10-19 05:00:00,2022-10-19 06:00:00,180,0,4,5633,2191,8008,51606
2022-10-19 06:00:00,2022-10-19 07:00:00,180,0,53,6057,2498,8788,53470
2022-10-19 07:00:00,2022-10-19 08:00:00,180,0,184,6052,3066,9482,49567
2022-10-19 08:00:00,2022-10-19 09:00:00,180,0,361,6031,2999,9571,43917
2022-10-19 09:00:00,2022-10-19 10:00:00,180,0,462,6422,3764,10828,39771
2022-10-19 10:00:00,2022-10-19 11:00:00,180,0,542,6576,3721,11019,37253
2022-10-19 11:00:00,2022-10-19 12:00:00,180,0,609,5992,3157,9938,35569
2022-10-19 12:00:00,2022-10-19 13:00:00,179,0,624,5565,3519,9887,36386
2022-10-19 13:00:00,2022-10-19 14:00:00,176,0,625,5896,3685,10382,40251
2022-10-19 14:00:00,2022-10-19 15:00:00,180,0,359,6362,3172,10073,46289
2022-10-19 15:00:00,2022-10-19 16:00:00,180,0,91,6803,3367,10441,53501
2022-10-19 16:00:00,2022-10-19 17:00:00,176,0,4,7389,4426,11995,55341
2022-10-19 17:00:00,2022-10-19 18:00:00,179,0,4,7833,5816,13832,54912
2022-10-19 18:00:00,2022-10-19 19:00:00,180,0,4,8475,6016,14675,52306
2022-10-19 19:00:00,2022-10-19 20:00:00,180,0,4,9062,6306,15552,49391
2022-10-19 20:00:00,2022-10-19 21:00:00,180,0,4,8913,6618,15715,46331
2022-10-19 21:00:00,2022-10-19 22:00:00,178,0,4,8119,6692,14993,43690
2022-10-19 22:00:00,2022-10-19 23:00:00,176,0,4,7222,5878,13280,41572
2022-10-19 23:00:00,2022-10-20 00:00:00,180,0,4,6481,5634,12299,39629
2022-10-20 00:00:00,2022-10-20 01:00:00,180,0,4,6669,5389,12242,38634
2022-10-20 01:00:00,2022-10-20 02:00:00,180,0,4,6776,5040,12000,38467
2022-10-20 02:00:00,2022-10-20 03:00:00,180,0,4,6401,5368,11953,38608
2022-10-20 03:00:00,2022-10-20 04:00:00,180,0,4,5771,5298,11253,40633
2022-10-20 04:00:00,2022-10-20 05:00:00,180,0,4,5560,5384,11128,45154
2022-10-20 05:00:00,2022-10-20 06:00:00,180,0,3,5133,4749,10065,50881
2022-10-20 06:00:00,2022-10-20 07:00:00,180,0,65,5170,4230,9645,53610
2022-10-20 07:00:00,2022-10-20 08:00:00,180,0,183,5117,4194,9674,52598
2022-10-20 08:00:00,2022-10-20 09:00:00,180,0,385,3916,3449,7930,50120
2022-10-20 09:00:00,2022-10-20 10:00:00,180,0,476,3874,2912,7442,50296
2022-10-20 10:00:00,2022-10-20 11:00:00,180,0,530,4681,2822,8213,51637
2022-10-20 11:00:00,2022-10-20 12:00:00,180,0,456,4590,3270,8496,52101
2022-10-20 12:00:00,2022-10-20 13:00:00,179,0,168,4242,3837,8426,50411
2022-10-20 13:00:00,2022-10-20 14:00:00,176,0,119,4569,3762,8626,48904
2022-10-20 14:00:00,2022-10-20 15:00:00,178,0,109,4494,3424,8205,50633
2022-10-20 15:00:00,2022-10-20 16:00:00,180,0,62,4622,3358,8222,54802
2022-10-20 16:00:00,2022-10-20 17:00:00,180,0,4,3744,3978,7906,56042
2022-10-20 17:00:00,2022-10-20 18:00:00,180,0,4,4007,4026,8217,55461
2022-10-20 18:00:00,2022-10-20 19:00:00,180,0,4,3408,4372,7964,52576
2022-10-20 19:00:00,2022-10-20 20:00:00,180,0,4,2307,4518,7009,49528
2022-10-20 20:00:00,2022-10-20 21:00:00,180,0,4,2073,4432,6689,46351
2022-10-20 21:00:00,2022-10-20 22:00:00,177,0,4,1985,4598,6764,43741
2022-10-20 22:00:00,2022-10-20 23:00:00,178,0,4,2206,4248,6636,41499
2022-10-20 23:00:00,2022-10-21 00:00:00,180,0,4,1991,3914,6089,40002
2022-10-21 00:00:00,2022-10-21 01:00:00,180,0,4,1665,3648,5497,38957
2022-10-21 01:00:00,2022-10-21 02:00:00,180,0,4,1433,3711,5328,38492
2022-10-21 02:00:00,2022-10-21 03:00:00,180,0,4,1380,2667,4231,38965
2022-10-21 03:00:00,2022-10-21 04:00:00,180,0,4,1201,2168,3553,40393
2022-10-21 04:00:00,2022-10-21 05:00:00,178,0,4,1070,2359,3611,44407
2022-10-21 05:00:00,2022-10-21 06:00:00,176,0,4,994,2736,3910,50243
2022-10-21 06:00:00,2022-10-21 07:00:00,179,0,47,926,2652,3804,53048
2022-10-21 07:00:00,2022-10-21 08:00:00,180,0,227,1849,2208,4464,52348
2022-10-21 08:00:00,2022-10-21 09:00:00,180,0,429,2653,2410,5672,51281
2022-10-21 09:00:00,2022-10-21 10:00:00,180,0,562,2470,2198,5410,49627
2022-10-21 10:00:00,2022-10-21 11:00:00,180,0,463,2164,2119,4926,45523
2022-10-21 11:00:00,2022-10-21 12:00:00,180,0,450,1944,1983,4557,42789
2022-10-21 12:00:00,2022-10-21 13:00:00,180,0,396,2362,1844,4782,42585
2022-10-21 13:00:00,2022-10-21 14:00:00,180,0,316,2160,1807,4463,42855
2022-10-21 14:00:00,2022-10-21 15:00:00,178,0,210,2452,1591,4431,46463
2022-10-21 15:00:00,2022-10-21 16:00:00,176,0,71,3335,1484,5066,52680
2022-10-21 16:00:00,2022-10-21 17:00:00,176,0,7,4367,1825,6375,54422
2022-10-21 17:00:00,2022-10-21 18:00:00,178,0,8,5340,2744,8270,53331
2022-10-21 18:00:00,2022-10-21 19:00:00,180,0,6,5359,3724,9269,50685
2022-10-21 19:00:00,2022-10-21 20:00:00,180,0,4,5948,4663,10795,47724
2022-10-21 20:00:00,2022-10-21 21:00:00,180,0,4,6425,4683,11292,45087
2022-10-21 21:00:00,2022-10-21 22:00:00,179,0,4,6618,4211,11012,42870
2022-10-21 22:00:00,2022-10-21 23:00:00,179,0,4,5571,4034,9788,40805
2022-10-21 23:00:00,2022-10-22 00:00:00,180,0,4,5617,4156,9957,39044
2022-10-22 00:00:00,2022-10-22 01:00:00,180,0,4,6504,4374,11062,37735
2022-10-22 01:00:00,2022-10-22 02:00:00,180,0,4,6840,4869,11893,37222
2022-10-22 02:00:00,2022-10-22 03:00:00,180,0,4,6677,5016,11877,36931
2022-10-22 03:00:00,2022-10-22 04:00:00,180,0,4,7166,5018,12368,37466
2022-10-22 04:00:00,2022-10-22 05:00:00,178,0,4,7315,4907,12404,39148
2022-10-22 05:00:00,2022-10-22 06:00:00,176,0,4,7137,4974,12291,41885
2022-10-22 06:00:00,2022-10-22 07:00:00,161,0,58,6131,5384,11734,43601
2022-10-22 07:00:00,2022-10-22 08:00:00,141,0,227,6476,5107,11951,43048
2022-10-22 08:00:00,2022-10-22 09:00:00,136,0,416,5702,4960,11214,41440
2022-10-22 09:00:00,2022-10-22 10:00:00,138,0,500,4791,4859,10288,40473
2022-10-22 10:00:00,2022-10-22 11:00:00,138,0,333,4271,4349,9091,38535
2022-10-22 11:00:00,2022-10-22 12:00:00,138,0,333,3689,4428,8588,36652
2022-10-22 12:00:00,2022-10-22 13:00:00,138,0,420,3352,4223,8133,35799
2022-10-22 13:00:00,2022-10-22 14:00:00,133,0,328,3290,4120,7871,36594
2022-10-22 14:00:00,2022-10-22 15:00:00,134,0,304,2865,3422,6725,40998
2022-10-22 15:00:00,2022-10-22 16:00:00,135,0,63,2043,2830,5071,47090
2022-10-22 16:00:00,2022-10-22 17:00:00,139,0,7,1827,2047,4020,49662
2022-10-22 17:00:00,2022-10-22 18:00:00,140,0,8,1708,1692,3548,49021
2022-10-22 18:00:00,2022-10-22 19:00:00,140,0,8,1015,1550,2713,46919
2022-10-22 19:00:00,2022-10-22 20:00:00,140,0,8,940,1434,2522,44893
2022-10-22 20:00:00,2022-10-22 21:00:00,138,0,8,1021,1372,2539,43035
2022-10-22 21:00:00,2022-10-22 22:00:00,136,0,8,1258,1534,2936,41176
2022-10-22 22:00:00,2022-10-22 23:00:00,139,0,8,1291,1501,2939,39720
2022-10-22 23:00:00,2022-10-23 00:00:00,140,0,8,1005,1390,2543,38166
2022-10-23 00:00:00,2022-10-23 01:00:00,140,0,8,840,1288,2276,37093
2022-10-23 01:00:00,2022-10-23 02:00:00,140,0,8,820,1435,2403,36454
2022-10-23 02:00:00,2022-10-23 03:00:00,139,0,8,881,1373,2401,36132
2022-10-23 03:00:00,2022-10-23 04:00:00,140,0,8,1390,1673,3211,36227
2022-10-23 04:00:00,2022-10-23 05:00:00,138,0,8,1509,1718,3373,36795
2022-10-23 05:00:00,2022-10-23 06:00:00,132,0,8,1679,2149,3968,38416
2022-10-23 06:00:00,2022-10-23 07:00:00,135,0,28,2845,3064,6072,40330
2022-10-23 07:00:00,2022-10-23 08:00:00,137,0,109,4494,3495,8235,40840
2022-10-23 08:00:00,2022-10-23 09:00:00,135,0,244,4727,3665,8771,40879
2022-10-23 09:00:00,2022-10-23 10:00:00,135,0,407,4476,3670,8688,41113
2022-10-23 10:00:00,2022-10-23 11:00:00,135,0,437,4657,4011,9240,41149
2022-10-23 11:00:00,2022-10-23 12:00:00,136,0,283,2412,4040,6871,38644
2022-10-23 12:00:00,2022-10-23 13:00:00,136,0,299,2482,4467,7384,38528
2022-10-23 13:00:00,2022-10-23 14:00:00,133,0,228,2682,5377,8420,38853
2022-10-23 14:00:00,2022-10-23 15:00:00,132,0,145,4136,5657,10070,43021
2022-10-23 15:00:00,2022-10-23 16:00:00,132,0,54,6530,5919,12635,48492
2022-10-23 16:00:00,2022-10-23 17:00:00,131,0,4,7280,6102,13517,50079
2022-10-23 17:00:00,2022-10-23 18:00:00,132,0,4,8315,6539,14990,48936
2022-10-23 18:00:00,2022-10-23 19:00:00,132,0,4,7967,6877,14980,46947
2022-10-23 19:00:00,2022-10-23 20:00:00,135,0,4,5746,6576,12461,44744
2022-10-23 20:00:00,2022-10-23 21:00:00,133,0,4,6703,5525,12365,42096
2022-10-23 21:00:00,2022-10-23 22:00:00,132,0,4,8200,6357,14693,40993
2022-10-23 22:00:00,2022-10-23 23:00:00,132,0,4,7922,6861,14919,38553
2022-10-23 23:00:00,2022-10-24 00:00:00,135,0,4,8727,7138,16004,37408
2022-10-24 00:00:00,2022-10-24 01:00:00,132,0,4,8866,7483,16485,36845
2022-10-24 01:00:00,2022-10-24 02:00:00,132,0,4,9120,7847,17103,36513
2022-10-24 02:00:00,2022-10-24 03:00:00,133,0,4,9111,8589,17837,37010
2022-10-24 03:00:00,2022-10-24 04:00:00,133,0,4,9026,8873,18036,39209
2022-10-24 04:00:00,2022-10-24 05:00:00,132,0,4,9174,8928,18238,44246
2022-10-24 05:00:00,2022-10-24 06:00:00,133,0,4,9155,9125,18417,50015
2022-10-24 06:00:00,2022-10-24 07:00:00,132,0,35,9170,9130,18467,52198
2022-10-24 07:00:00,2022-10-24 08:00:00,132,0,200,9260,9136,18728,50550
2022-10-24 08:00:00,2022-10-24 09:00:00,133,0,315,9250,9149,18847,48885
2022-10-24 09:00:00,2022-10-24 10:00:00,134,0,372,9042,9124,18672,46009
2022-10-24 10:00:00,2022-10-24 11:00:00,134,0,673,8977,9182,18966,45613
2022-10-24 11:00:00,2022-10-24 12:00:00,135,0,545,8371,9108,18159,46024
2022-10-24 12:00:00,2022-10-24 13:00:00,133,0,478,8630,8717,17958,46399
2022-10-24 13:00:00,2022-10-24 14:00:00,132,0,279,8781,8170,17362,47283
2022-10-24 14:00:00,2022-10-24 15:00:00,134,0,172,8475,6854,15635,50048
2022-10-24 15:00:00,2022-10-24 16:00:00,128,0,49,7679,6086,13942,54548
2022-10-24 16:00:00,2022-10-24 17:00:00,127,0,4,6854,5361,12346,55365
2022-10-24 17:00:00,2022-10-24 18:00:00,130,0,4,7287,5119,12540,54246
2022-10-24 18:00:00,2022-10-24 19:00:00,132,0,4,7310,5750,13196,51940
2022-10-24 19:00:00,2022-10-24 20:00:00,132,0,4,7324,5861,13321,49104
2022-10-24 20:00:00,2022-10-24 21:00:00,131,0,4,7710,5662,13507,45896
2022-10-24 21:00:00,2022-10-24 22:00:00,131,0,4,7660,5471,13266,43249
2022-10-24 22:00:00,2022-10-24 23:00:00,132,0,4,7949,5653,13738,40989
2022-10-24 23:00:00,2022-10-25 00:00:00,132,0,4,7631,5413,13180,39201
2022-10-25 00:00:00,2022-10-25 01:00:00,132,0,4,7000,5662,12798,38352
2022-10-25 01:00:00,2022-10-25 02:00:00,132,0,4,6512,5713,12361,38171
2022-10-25 02:00:00,2022-10-25 03:00:00,132,0,4,5240,5490,10866,38379
2022-10-25 03:00:00,2022-10-25 04:00:00,128,0,4,4910,5177,10219,40250
2022-10-25 04:00:00,2022-10-25 05:00:00,88,0,4,5012,5016,10120,44614
2022-10-25 05:00:00,2022-10-25 06:00:00,81,0,4,4544,5052,9681,50484
2022-10-25 06:00:00,2022-10-25 07:00:00,80,0,38,4536,4827,9481,53060
2022-10-25 07:00:00,2022-10-25 08:00:00,90,0,177,4126,4439,8832,50244
2022-10-25 08:00:00,2022-10-25 09:00:00,133,0,369,4376,4531,9409,47338
2022-10-25 09:00:00,2022-10-25 10:00:00,133,0,381,4638,4235,9387,46125
2022-10-25 10:00:00,2022-10-25 11:00:00,132,0,637,4746,4098,9613,43252
2022-10-25 11:00:00,2022-10-25 12:00:00,132,0,663,4384,3775,8954,42143
2022-10-25 12:00:00,2022-10-25 13:00:00,133,0,536,3909,3229,7807,42301
2022-10-25 13:00:00,2022-10-25 14:00:00,130,0,422,3585,2783,6920,44405
2022-10-25 14:00:00,2022-10-25 15:00:00,128,0,207,3232,2174,5741,48373
2022-10-25 15:00:00,2022-10-25 16:00:00,130,0,56,2503,1837,4526,53772
2022-10-25 16:00:00,2022-10-25 17:00:00,132,0,3,2423,1914,4472,55494
2022-10-25 17:00:00,2022-10-25 18:00:00,132,0,4,2201,2136,4473,54377
2022-10-25 18:00:00,2022-10-25 19:00:00,132,0,4,2058,2225,4419,51718
2022-10-25 19:00:00,2022-10-25 20:00:00,132,0,4,2140,2643,4919,48759
2022-10-25 20:00:00,2022-10-25 21:00:00,133,0,4,3120,2371,5628,45671
2022-10-25 21:00:00,2022-10-25 22:00:00,132,0,4,2702,2480,5318,42877
2022-10-25 22:00:00,2022-10-25 23:00:00,132,0,4,2419,2562,5117,40469
2022-10-25 23:00:00,2022-10-26 00:00:00,132,0,4,2529,2650,5315,38765
2022-10-26 00:00:00,2022-10-26 01:00:00,132,0,4,3378,2724,6238,37975
2022-10-26 01:00:00,2022-10-26 02:00:00,132,0,4,3098,2722,5956,37660
2022-10-26 02:00:00,2022-10-26 03:00:00,132,0,4,2881,2963,5980,37926
2022-10-26 03:00:00,2022-10-26 04:00:00,132,0,4,3365,3242,6743,39732
2022-10-26 04:00:00,2022-10-26 05:00:00,132,0,4,4378,3699,8213,44466
2022-10-26 05:00:00,2022-10-26 06:00:00,132,0,4,5071,4323,9530,50558
2022-10-26 06:00:00,2022-10-26 07:00:00,131,0,27,6077,4566,10801,53024
2022-10-26 07:00:00,2022-10-26 08:00:00,128,0,226,5541,4523,10418,49471
2022-10-26 08:00:00,2022-10-26 09:00:00,128,0,439,5497,4161,10225,44149
2022-10-26 09:00:00,2022-10-26 10:00:00,132,0,668,5688,3641,10129,41326
2022-10-26 10:00:00,2022-10-26 11:00:00,132,0,653,6194,3868,10847,40291
2022-10-26 11:00:00,2022-10-26 12:00:00,132,0,709,5313,3995,10149,39081
2022-10-26 12:00:00,2022-10-26 13:00:00,132,0,639,7075,3459,11305,39418
2022-10-26 13:00:00,2022-10-26 14:00:00,132,0,413,7865,4132,12542,43362
2022-10-26 14:00:00,2022-10-26 15:00:00,132,0,202,7953,4220,12507,49663
2022-10-26 15:00:00,2022-10-26 16:00:00,132,0,45,8282,4534,12993,54255
2022-10-26 16:00:00,2022-10-26 17:00:00,128,0,4,8592,4896,13620,55227
2022-10-26 17:00:00,2022-10-26 18:00:00,131,0,4,7283,5249,12667,53850
2022-10-26 18:00:00,2022-10-26 19:00:00,132,0,4,5597,5077,10810,51055
2022-10-26 19:00:00,2022-10-26 20:00:00,132,0,4,5151,5198,10485,48483
2022-10-26 20:00:00,2022-10-26 21:00:00,131,0,4,4140,4814,9089,45696
2022-10-26 21:00:00,2022-10-26 22:00:00,128,0,4,2598,4354,7084,43073
2022-10-26 22:00:00,2022-10-26 23:00:00,130,0,4,3616,4088,7838,41045
2022-10-26 23:00:00,2022-10-27 00:00:00,132,0,4,3320,3600,7056,39345
2022-10-27 00:00:00,2022-10-27 01:00:00,132,0,4,2470,3012,5618,38159
2022-10-27 01:00:00,2022-10-27 02:00:00,132,0,4,3348,2983,6467,37796
2022-10-27 02:00:00,2022-10-27 03:00:00,132,0,4,3586,3323,7045,37940
2022-10-27 03:00:00,2022-10-27 04:00:00,132,0,4,4099,3192,7427,39582
2022-10-27 04:00:00,2022-10-27 05:00:00,132,0,4,4805,3409,8350,44179
2022-10-27 05:00:00,2022-10-27 06:00:00,128,0,4,5023,4224,9379,50433
2022-10-27 06:00:00,2022-10-27 07:00:00,128,0,48,5753,4903,10832,52866
2022-10-27 07:00:00,2022-10-27 08:00:00,132,0,198,6390,5727,12447,50117
2022-10-27 08:00:00,2022-10-27 09:00:00,132,0,388,6715,5984,13219,45941
2022-10-27 09:00:00,2022-10-27 10:00:00,131,0,546,7262,5755,13694,43955
2022-10-27 10:00:00,2022-10-27 11:00:00,132,0,521,7350,5405,13408,44226
2022-10-27 11:00:00,2022-10-27 12:00:00,132,0,454,7180,5302,13068,46683
2022-10-27 12:00:00,2022-10-27 13:00:00,132,0,439,7029,5342,12942,47527
2022-10-27 13:00:00,2022-10-27 14:00:00,130,0,353,6756,4960,12199,48474
2022-10-27 14:00:00,2022-10-27 15:00:00,128,0,99,6556,4980,11763,50533
2022-10-27 15:00:00,2022-10-27 16:00:00,128,0,53,5509,5107,10797,54459
2022-10-27 16:00:00,2022-10-27 17:00:00,131,0,4,5800,5313,11248,56227
2022-10-27 17:00:00,2022-10-27 18:00:00,132,0,4,5816,5625,11577,55093
2022-10-27 18:00:00,2022-10-27 19:00:00,132,0,4,6106,5451,11693,52585
2022-10-27 19:00:00,2022-10-27 20:00:00,132,0,4,5524,4898,10558,49323
2022-10-27 20:00:00,2022-10-27 21:00:00,131,0,4,4326,4159,8620,46596
2022-10-27 21:00:00,2022-10-27 22:00:00,128,0,4,3053,3327,6512,44424
2022-10-27 22:00:00,2022-10-27 23:00:00,130,0,4,3206,2518,5858,42270
2022-10-27 23:00:00,2022-10-28 00:00:00,132,0,4,2901,2300,5337,40500
2022-10-28 00:00:00,2022-10-28 01:00:00,132,0,4,2025,2681,4842,39449
2022-10-28 01:00:00,2022-10-28 02:00:00,132,0,4,2151,3208,5495,38729
2022-10-28 02:00:00,2022-10-28 03:00:00,132,0,4,2096,3543,5775,38760
2022-10-28 03:00:00,2022-10-28 04:00:00,132,0,4,2309,3905,6350,40473
2022-10-28 04:00:00,2022-10-28 05:00:00,131,0,4,2669,4362,7166,44283
2022-10-28 05:00:00,2022-10-28 06:00:00,128,0,4,2262,4744,7138,50082
2022-10-28 06:00:00,2022-10-28 07:00:00,130,0,37,2559,4790,7516,52761
2022-10-28 07:00:00,2022-10-28 08:00:00,131,0,222,3673,4420,8446,50247
2022-10-28 08:00:00,2022-10-28 09:00:00,132,0,427,5252,4301,10112,47066
2022-10-28 09:00:00,2022-10-28 10:00:00,130,0,447,5480,4172,10229,44408
2022-10-28 10:00:00,2022-10-28 11:00:00,132,0,442,5807,3830,10211,43021
2022-10-28 11:00:00,2022-10-28 12:00:00,132,0,540,6759,4349,11780,44659
2022-10-28 12:00:00,2022-10-28 13:00:00,132,0,374,7700,5167,13373,46411
2022-10-28 13:00:00,2022-10-28 14:00:00,130,0,278,8354,5511,14273,48140
2022-10-28 14:00:00,2022-10-28 15:00:00,129,0,90,8832,5170,14221,51381
2022-10-28 15:00:00,2022-10-28 16:00:00,128,0,28,8878,5408,14442,54859
2022-10-28 16:00:00,2022-10-28 17:00:00,128,0,5,8011,5739,13883,55234
2022-10-28 17:00:00,2022-10-28 18:00:00,128,0,4,6616,5461,12209,53593
2022-10-28 18:00:00,2022-10-28 19:00:00,128,0,4,4291,4607,9030,50977
2022-10-28 19:00:00,2022-10-28 20:00:00,128,0,4,3121,3393,6646,47955
2022-10-28 20:00:00,2022-10-28 21:00:00,129,0,4,1857,2212,4202,45858
2022-10-28 21:00:00,2022-10-28 22:00:00,128,0,4,954,1682,2768,43880
2022-10-28 22:00:00,2022-10-28 23:00:00,129,0,4,506,1524,2163,41788
2022-10-28 23:00:00,2022-10-29 00:00:00,130,0,4,151,1161,1446,40208
2022-10-29 00:00:00,2022-10-29 01:00:00,131,0,4,112,671,918,39495
2022-10-29 01:00:00,2022-10-29 02:00:00,131,0,4,123,426,684,38873
2022-10-29 02:00:00,2022-10-29 03:00:00,130,0,4,419,471,1024,38285
2022-10-29 03:00:00,2022-10-29 04:00:00,129,0,4,359,583,1075,38739
2022-10-29 04:00:00,2022-10-29 05:00:00,128,0,4,733,770,1635,40000
2022-10-29 05:00:00,2022-10-29 06:00:00,129,0,4,1470,1012,2615,42282
2022-10-29 06:00:00,2022-10-29 07:00:00,130,0,20,2673,1594,4417,44988
2022-10-29 07:00:00,2022-10-29 08:00:00,132,0,86,2095,1731,4044,44948
2022-10-29 08:00:00,2022-10-29 09:00:00,132,0,194,2425,1868,4619,43386
2022-10-29 09:00:00,2022-10-29 10:00:00,132,0,266,2392,2309,5099,42055
2022-10-29 10:00:00,2022-10-29 11:00:00,132,0,499,1770,2044,4445,37467
2022-10-29 11:00:00,2022-10-29 12:00:00,132,0,527,1096,1867,3622,36054
2022-10-29 12:00:00,2022-10-29 13:00:00,132,0,382,963,1860,3337,36357
2022-10-29 13:00:00,2022-10-29 14:00:00,130,0,383,1279,2025,3817,40267
2022-10-29 14:00:00,2022-10-29 15:00:00,99,0,185,1567,2075,3926,44498
2022-10-29 15:00:00,2022-10-29 16:00:00,89,0,28,1921,2433,4471,49076
2022-10-29 16:00:00,2022-10-29 17:00:00,86,0,8,4107,3435,7636,50693
2022-10-29 17:00:00,2022-10-29 18:00:00,86,0,8,5213,4147,9454,49134
2022-10-29 18:00:00,2022-10-29 19:00:00,87,0,8,4961,4811,9867,47021
2022-10-29 19:00:00,2022-10-29 20:00:00,85,0,8,4726,4643,9462,44969
2022-10-29 20:00:00,2022-10-29 21:00:00,87,0,8,4192,4627,8914,43147
2022-10-29 21:00:00,2022-10-29 22:00:00,91,0,8,3467,4959,8525,41208
2022-10-29 22:00:00,2022-10-29 23:00:00,88,0,8,2870,4427,7393,39325
2022-10-29 23:00:00,2022-10-30 00:00:00,81,0,8,2585,4149,6823,37921
2022-10-30 00:00:00,2022-10-30 01:00:00,82,0,8,2246,3438,5774,37040
2022-10-30 01:00:00,2022-10-30 02:00:00,83,0,8,2094,3007,5192,36557
2022-10-30 02:00:00,2022-10-30 03:00:00,81,0,8,1938,3392,5419,36377
2022-10-30 03:00:00,2022-10-30 04:00:00,82,0,8,1633,2193,3916,36621
2022-10-30 04:00:00,2022-10-30 05:00:00,80,0,8,1160,1133,2381,36952
2022-10-30 05:00:00,2022-10-30 06:00:00,79,0,8,873,1126,2086,37294
2022-10-30 06:00:00,2022-10-30 07:00:00,78,0,36,730,1230,2074,38403
2022-10-30 07:00:00,2022-10-30 08:00:00,80,0,196,856,1427,2559,37672
2022-10-30 08:00:00,2022-10-30 09:00:00,81,0,416,1202,1092,2791,35991
2022-10-30 09:00:00,2022-10-30 10:00:00,81,0,617,1089,744,2531,33100
2022-10-30 10:00:00,2022-10-30 11:00:00,80,0,727,1194,599,2600,32171
2022-10-30 11:00:00,2022-10-30 12:00:00,80,0,656,1185,529,2450,34731
2022-10-30 12:00:00,2022-10-30 13:00:00,80,0,450,1554,493,2577,37693
2022-10-30 13:00:00,2022-10-30 14:00:00,80,0,344,457,737,1618,38914
2022-10-30 14:00:00,2022-10-30 15:00:00,77,0,171,939,877,2064,41877
2022-10-30 15:00:00,2022-10-30 16:00:00,79,0,32,1628,814,2553,47042
2022-10-30 16:00:00,2022-10-30 17:00:00,80,0,4,2450,1885,4419,52049
2022-10-30 17:00:00,2022-10-30 18:00:00,81,0,4,2575,1528,4188,50954
2022-10-30 18:00:00,2022-10-30 19:00:00,81,0,4,2640,2168,4893,48922
2022-10-30 19:00:00,2022-10-30 20:00:00,80,0,4,2690,2559,5333,46828
2022-10-30 20:00:00,2022-10-30 21:00:00,81,0,4,2643,2322,5050,44644
2022-10-30 21:00:00,2022-10-30 22:00:00,81,0,4,2731,2206,5022,42358
2022-10-30 22:00:00,2022-10-30 23:00:00,79,0,4,3092,2315,5490,40313
2022-10-30 23:00:00,2022-10-31 00:00:00,76,0,4,2470,2569,5119,38484
2022-10-31 00:00:00,2022-10-31 01:00:00,80,0,4,2127,2592,4803,37296
2022-10-31 01:00:00,2022-10-31 02:00:00,81,0,4,1838,2179,4102,36647
2022-10-31 02:00:00,2022-10-31 03:00:00,83,0,4,1438,1468,2993,36690
2022-10-31 03:00:00,2022-10-31 04:00:00,81,0,4,931,1117,2133,36950
2022-10-31 04:00:00,2022-10-31 05:00:00,81,0,4,724,874,1683,39787
2022-10-31 05:00:00,2022-10-31 06:00:00,80,0,4,864,707,1655,45350
2022-10-31 06:00:00,2022-10-31 07:00:00,82,0,20,910,779,1791,51097
2022-10-31 07:00:00,2022-10-31 08:00:00,80,0,132,1049,1134,2395,50643
2022-10-31 08:00:00,2022-10-31 09:00:00,87,0,399,1153,1517,3156,47887
2022-10-31 09:00:00,2022-10-31 10:00:00,87,0,450,1587,1286,3410,46529
2022-10-31 10:00:00,2022-10-31 11:00:00,88,0,485,1424,1204,3201,46900
2022-10-31 11:00:00,2022-10-31 12:00:00,88,0,393,1044,1249,2774,46443
2022-10-31 12:00:00,2022-10-31 13:00:00,88,0,341,1523,1101,3053,47370
2022-10-31 13:00:00,2022-10-31 14:00:00,87,0,279,1455,992,2813,49846
2022-10-31 14:00:00,2022-10-31 15:00:00,84,0,113,1742,1659,3598,52316
2022-10-31 15:00:00,2022-10-31 16:00:00,87,0,30,2559,2774,5450,56202
2022-10-31 16:00:00,2022-10-31 17:00:00,88,0,4,4145,4042,8279,60039
2022-10-31 17:00:00,2022-10-31 18:00:00,88,0,4,5869,4848,10809,57438
2022-10-31 18:00:00,2022-10-31 19:00:00,88,0,4,6728,5496,12316,54741
2022-10-31 19:00:00,2022-10-31 20:00:00,87,0,4,7906,5872,13869,51950
2022-10-31 20:00:00,2022-10-31 21:00:00,88,0,4,8956,6412,15460,49119
2022-10-31 21:00:00,2022-10-31 22:00:00,88,0,4,9075,6564,15731,46267
2022-10-31 22:00:00,2022-10-31 23:00:00,82,0,4,9015,7109,16210,43286
2022-10-31 23:00:00,2022-11-01 00:00:00,77,0,4,8679,7582,16342,40752
2022-11-01 00:00:00,2022-11-01 01:00:00,84,0,4,8672,7760,16520,39175
2022-11-01 01:00:00,2022-11-01 02:00:00,84,0,4,8691,7966,16745,38656
2022-11-01 02:00:00,2022-11-01 03:00:00,84,0,4,8907,8221,17216,38163
2022-11-01 03:00:00,2022-11-01 04:00:00,84,0,4,8886,8670,17644,38382
2022-11-01 04:00:00,2022-11-01 05:00:00,84,0,4,8699,9132,17919,40572
2022-11-01 05:00:00,2022-11-01 06:00:00,83,0,4,8483,9277,17847,46174
2022-11-01 06:00:00,2022-11-01 07:00:00,80,0,9,8432,9502,18023,51543
2022-11-01 07:00:00,2022-11-01 08:00:00,89,0,156,8217,9261,17723,50471
2022-11-01 08:00:00,2022-11-01 09:00:00,89,0,385,8423,8852,17749,46871
2022-11-01 09:00:00,2022-11-01 10:00:00,88,0,431,8537,8767,17823,42915
2022-11-01 10:00:00,2022-11-01 11:00:00,88,0,415,8603,8820,17926,40540
2022-11-01 11:00:00,2022-11-01 12:00:00,88,0,403,8013,8060,16564,38971
2022-11-01 12:00:00,2022-11-01 13:00:00,92,0,631,8727,8363,17813,40678
2022-11-01 13:00:00,2022-11-01 14:00:00,117,0,470,8937,8758,18282,43899
2022-11-01 14:00:00,2022-11-01 15:00:00,131,0,208,9021,8681,18041,48982
2022-11-01 15:00:00,2022-11-01 16:00:00,132,0,31,9040,8624,17827,55018
2022-11-01 16:00:00,2022-11-01 17:00:00,136,0,4,8952,9058,18150,59365
2022-11-01 17:00:00,2022-11-01 18:00:00,136,0,4,9019,9137,18296,56951
2022-11-01 18:00:00,2022-11-01 19:00:00,136,0,4,9026,8941,18107,54862
2022-11-01 19:00:00,2022-11-01 20:00:00,136,0,4,9015,8681,17836,52475
2022-11-01 20:00:00,2022-11-01 21:00:00,122,0,4,9007,8009,17142,48965
2022-11-01 21:00:00,2022-11-01 22:00:00,118,0,4,8935,8216,17273,46163
2022-11-01 22:00:00,2022-11-01 23:00:00,117,0,4,8932,8397,17450,43142
2022-11-01 23:00:00,2022-11-02 00:00:00,112,0,4,8965,7913,16994,41191
2022-11-02 00:00:00,2022-11-02 01:00:00,118,0,4,8403,7997,16522,39603
2022-11-02 01:00:00,2022-11-02 02:00:00,118,0,4,8001,8218,16341,38565
2022-11-02 02:00:00,2022-11-02 03:00:00,114,0,4,7790,8001,15909,38127
2022-11-02 03:00:00,2022-11-02 04:00:00,105,0,4,7995,8259,16363,38466
2022-11-02 04:00:00,2022-11-02 05:00:00,96,0,4,8769,8696,17565,40606
2022-11-02 05:00:00,2022-11-02 06:00:00,92,0,4,9036,8971,18103,45569
2022-11-02 06:00:00,2022-11-02 07:00:00,97,0,14,9041,8663,17815,50808
2022-11-02 07:00:00,2022-11-02 08:00:00,85,0,90,8476,8053,16704,50091
2022-11-02 08:00:00,2022-11-02 09:00:00,78,0,252,8103,7323,15756,45616
2022-11-02 09:00:00,2022-11-02 10:00:00,82,0,389,7303,7267,15041,41708
2022-11-02 10:00:00,2022-11-02 11:00:00,72,0,431,6629,7442,14574,39755
2022-11-02 11:00:00,2022-11-02 12:00:00,74,0,428,7580,7067,15149,39119
2022-11-02 12:00:00,2022-11-02 13:00:00,86,0,441,8815,6896,16238,41491
2022-11-02 13:00:00,2022-11-02 14:00:00,101,0,295,8946,6319,15661,44524
2022-11-02 14:00:00,2022-11-02 15:00:00,117,0,125,8746,5989,14977,49756
2022-11-02 15:00:00,2022-11-02 16:00:00,119,0,18,8406,6536,15079,55881
2022-11-02 16:00:00,2022-11-02 17:00:00,108,0,0,8390,7174,15672,59705
2022-11-02 17:00:00,2022-11-02 18:00:00,91,0,0,7647,7807,15545,57259
2022-11-02 18:00:00,2022-11-02 19:00:00,96,0,0,7640,8572,16308,55022
2022-11-02 19:00:00,2022-11-02 20:00:00,93,0,0,8076,8757,16926,52452
2022-11-02 20:00:00,2022-11-02 21:00:00,92,0,0,9133,8780,18005,49487
2022-11-02 21:00:00,2022-11-02 22:00:00,91,0,0,9168,8799,18058,46427
2022-11-02 22:00:00,2022-11-02 23:00:00,88,0,0,9156,8959,18203,43392
2022-11-02 23:00:00,2022-11-03 00:00:00,86,0,0,9162,9074,18322,40953
2022-11-03 00:00:00,2022-11-03 01:00:00,92,0,0,9123,9046,18261,39267
2022-11-03 01:00:00,2022-11-03 02:00:00,92,0,0,9154,9001,18247,38583
2022-11-03 02:00:00,2022-11-03 03:00:00,92,0,0,9130,8797,18019,38360
2022-11-03 03:00:00,2022-11-03 04:00:00,92,0,0,9083,8430,17605,38689
2022-11-03 04:00:00,2022-11-03 05:00:00,91,0,0,9112,8568,17771,40761
2022-11-03 05:00:00,2022-11-03 06:00:00,89,0,0,9157,8155,17401,45936
2022-11-03 06:00:00,2022-11-03 07:00:00,84,0,8,9198,7858,17148,51884
2022-11-03 07:00:00,2022-11-03 08:00:00,90,0,90,9195,7787,17162,53722
2022-11-03 08:00:00,2022-11-03 09:00:00,92,0,190,9066,7883,17231,52687
2022-11-03 09:00:00,2022-11-03 10:00:00,92,0,342,9047,7619,17100,50729
2022-11-03 10:00:00,2022-11-03 11:00:00,92,0,416,8961,7106,16575,49720
2022-11-03 11:00:00,2022-11-03 12:00:00,92,0,404,8671,7106,16273,47849
2022-11-03 12:00:00,2022-11-03 13:00:00,92,0,265,8177,7203,15737,48259
2022-11-03 13:00:00,2022-11-03 14:00:00,92,0,235,8297,6460,15084,51599
2022-11-03 14:00:00,2022-11-03 15:00:00,86,0,89,7652,5993,13820,54682
2022-11-03 15:00:00,2022-11-03 16:00:00,88,0,10,7442,6322,13862,57877
2022-11-03 16:00:00,2022-11-03 17:00:00,92,0,4,4745,6240,11081,60749
2022-11-03 17:00:00,2022-11-03 18:00:00,81,0,4,4412,6283,10780,58671
2022-11-03 18:00:00,2022-11-03 19:00:00,80,0,4,5545,4869,10498,56442
2022-11-03 19:00:00,2022-11-03 20:00:00,80,0,4,4778,4513,9375,53503
2022-11-03 20:00:00,2022-11-03 21:00:00,82,0,4,3450,4739,8275,50285
2022-11-03 21:00:00,2022-11-03 22:00:00,82,0,4,2643,4358,7087,47088
2022-11-03 22:00:00,2022-11-03 23:00:00,80,0,4,2030,4592,6706,44065
2022-11-03 23:00:00,2022-11-04 00:00:00,81,0,4,1775,4091,5951,41306
2022-11-04 00:00:00,2022-11-04 01:00:00,84,0,4,1770,3938,5796,40044
2022-11-04 01:00:00,2022-11-04 02:00:00,84,0,4,2852,3363,6303,39781
2022-11-04 02:00:00,2022-11-04 03:00:00,83,0,4,2559,3764,6410,39656
2022-11-04 03:00:00,2022-11-04 04:00:00,84,0,4,2499,3392,5979,40251
2022-11-04 04:00:00,2022-11-04 05:00:00,81,0,4,2474,2493,5052,42000
2022-11-04 05:00:00,2022-11-04 06:00:00,80,0,4,2442,1818,4344,46986
2022-11-04 06:00:00,2022-11-04 07:00:00,81,0,13,2099,1181,3374,53129
2022-11-04 07:00:00,2022-11-04 08:00:00,79,0,150,2241,974,3444,53638
2022-11-04 08:00:00,2022-11-04 09:00:00,64,0,379,2525,945,3913,50556
2022-11-04 09:00:00,2022-11-04 10:00:00,64,0,518,2932,833,4347,48631
2022-11-04 10:00:00,2022-11-04 11:00:00,65,0,611,4302,881,5859,47844
2022-11-04 11:00:00,2022-11-04 12:00:00,65,0,614,4828,1338,6845,46931
2022-11-04 12:00:00,2022-11-04 13:00:00,64,0,330,6138,1748,8280,48223
2022-11-04 13:00:00,2022-11-04 14:00:00,65,0,229,6099,1884,8277,50881
2022-11-04 14:00:00,2022-11-04 15:00:00,73,0,136,5097,1959,7265,53543
2022-11-04 15:00:00,2022-11-04 16:00:00,78,0,16,4631,1927,6652,56522
2022-11-04 16:00:00,2022-11-04 17:00:00,80,0,4,4328,2037,6449,60668
2022-11-04 17:00:00,2022-11-04 18:00:00,81,0,4,4308,1535,5928,58409
2022-11-04 18:00:00,2022-11-04 19:00:00,80,0,4,3947,1669,5700,55866
2022-11-04 19:00:00,2022-11-04 20:00:00,80,0,4,4790,1901,6775,52803
2022-11-04 20:00:00,2022-11-04 21:00:00,80,0,4,4704,1584,6372,49848
2022-11-04 21:00:00,2022-11-04 22:00:00,80,0,4,3998,1634,5716,47158
2022-11-04 22:00:00,2022-11-04 23:00:00,75,0,4,3066,2026,5171,44664
2022-11-04 23:00:00,2022-11-05 00:00:00,71,0,4,2511,1099,3685,42700
2022-11-05 00:00:00,2022-11-05 01:00:00,72,0,4,2971,1291,4338,41079
2022-11-05 01:00:00,2022-11-05 02:00:00,71,0,4,2931,1990,4996,40216
2022-11-05 02:00:00,2022-11-05 03:00:00,67,0,4,2612,2314,4997,39245
2022-11-05 03:00:00,2022-11-05 04:00:00,62,0,4,2394,2929,5389,39008
2022-11-05 04:00:00,2022-11-05 05:00:00,62,0,4,3382,3270,6718,39481
2022-11-05 05:00:00,2022-11-05 06:00:00,61,0,4,3611,3846,7522,41545
2022-11-05 06:00:00,2022-11-05 07:00:00,60,0,16,3353,4139,7568,43567
2022-11-05 07:00:00,2022-11-05 08:00:00,61,0,162,3414,4356,7993,43032
2022-11-05 08:00:00,2022-11-05 09:00:00,61,0,426,3936,4048,8471,40759
2022-11-05 09:00:00,2022-11-05 10:00:00,61,0,613,4654,3840,9168,39089
2022-11-05 10:00:00,2022-11-05 11:00:00,61,0,696,4537,3889,9183,39975
2022-11-05 11:00:00,2022-11-05 12:00:00,63,0,571,4362,3684,8680,40873
2022-11-05 12:00:00,2022-11-05 13:00:00,60,0,259,4528,4152,8999,42898
2022-11-05 13:00:00,2022-11-05 14:00:00,60,0,207,6415,4678,11360,45106
2022-11-05 14:00:00,2022-11-05 15:00:00,63,0,85,7703,5024,12875,47665
2022-11-05 15:00:00,2022-11-05 16:00:00,62,0,8,8850,5761,14681,51246
2022-11-05 16:00:00,2022-11-05 17:00:00,73,0,4,8980,6306,15363,55057
2022-11-05 17:00:00,2022-11-05 18:00:00,81,0,4,9126,6869,16080,53318
2022-11-05 18:00:00,2022-11-05 19:00:00,81,0,4,9150,7644,16879,50889
2022-11-05 19:00:00,2022-11-05 20:00:00,76,0,4,9159,8278,17517,48715
2022-11-05 20:00:00,2022-11-05 21:00:00,67,0,4,9147,8535,17753,46293
2022-11-05 21:00:00,2022-11-05 22:00:00,64,0,4,9174,8864,18106,44387
2022-11-05 22:00:00,2022-11-05 23:00:00,62,0,4,9153,8876,18095,42552
2022-11-05 23:00:00,2022-11-06 00:00:00,62,0,4,9171,8867,18104,40774
2022-11-06 00:00:00,2022-11-06 01:00:00,62,0,4,9209,8716,17991,39353
2022-11-06 01:00:00,2022-11-06 02:00:00,63,0,4,9143,8514,17724,38263
2022-11-06 02:00:00,2022-11-06 03:00:00,63,0,4,9096,8287,17450,37908
2022-11-06 03:00:00,2022-11-06 04:00:00,63,0,4,9001,8227,17295,37671
2022-11-06 04:00:00,2022-11-06 05:00:00,62,0,4,8399,7731,16196,37698
2022-11-06 05:00:00,2022-11-06 06:00:00,63,0,4,8125,7547,15739,38586
2022-11-06 06:00:00,2022-11-06 07:00:00,63,0,12,8813,7651,16539,40329
2022-11-06 07:00:00,2022-11-06 08:00:00,64,0,85,8807,7804,16760,41887
2022-11-06 08:00:00,2022-11-06 09:00:00,72,0,160,8907,7573,16712,42749
2022-11-06 09:00:00,2022-11-06 10:00:00,67,0,336,8883,7722,17008,42954
2022-11-06 10:00:00,2022-11-06 11:00:00,64,0,351,8074,7854,16343,43928
2022-11-06 11:00:00,2022-11-06 12:00:00,64,0,282,7796,7399,15541,45222
2022-11-06 12:00:00,2022-11-06 13:00:00,64,0,293,8213,8059,16629,46662
2022-11-06 13:00:00,2022-11-06 14:00:00,62,0,94,8749,8646,17551,48478
2022-11-06 14:00:00,2022-11-06 15:00:00,60,0,35,9170,8991,18256,49561
2022-11-06 15:00:00,2022-11-06 16:00:00,64,0,5,8985,9093,18147,51967
2022-11-06 16:00:00,2022-11-06 17:00:00,64,0,4,9145,9256,18469,55188
2022-11-06 17:00:00,2022-11-06 18:00:00,63,0,4,9143,9307,18517,53648
2022-11-06 18:00:00,2022-11-06 19:00:00,82,0,4,9128,9418,18632,51826
2022-11-06 19:00:00,2022-11-06 20:00:00,106,0,4,9056,9426,18592,49520
2022-11-06 20:00:00,2022-11-06 21:00:00,109,0,4,8981,9363,18457,47161
2022-11-06 21:00:00,2022-11-06 22:00:00,108,0,4,8909,9253,18274,44614
2022-11-06 22:00:00,2022-11-06 23:00:00,100,0,4,8585,9239,17928,42184
2022-11-06 23:00:00,2022-11-07 00:00:00,102,0,4,8273,8888,17267,40299
2022-11-07 00:00:00,2022-11-07 01:00:00,105,0,4,8383,8880,17372,38737
2022-11-07 01:00:00,2022-11-07 02:00:00,107,0,4,8269,8300,16680,38153
2022-11-07 02:00:00,2022-11-07 03:00:00,104,0,4,8316,8229,16653,38118
2022-11-07 03:00:00,2022-11-07 04:00:00,105,0,4,8348,8252,16709,38877
2022-11-07 04:00:00,2022-11-07 05:00:00,104,0,4,8550,8431,17089,41403
2022-11-07 05:00:00,2022-11-07 06:00:00,104,0,4,8550,8333,16991,46502
2022-11-07 06:00:00,2022-11-07 07:00:00,100,0,7,8717,8275,17099,52490
2022-11-07 07:00:00,2022-11-07 08:00:00,99,0,57,8354,8495,17005,54558
2022-11-07 08:00:00,2022-11-07 09:00:00,104,0,144,8502,8394,17144,53941
2022-11-07 09:00:00,2022-11-07 10:00:00,104,0,209,8633,8322,17268,53083
2022-11-07 10:00:00,2022-11-07 11:00:00,104,0,296,8688,8036,17124,52386
2022-11-07 11:00:00,2022-11-07 12:00:00,104,0,259,8681,8081,17125,52385
2022-11-07 12:00:00,2022-11-07 13:00:00,104,0,258,8647,7778,16787,53185
2022-11-07 13:00:00,2022-11-07 14:00:00,104,0,104,8667,7541,16416,54537
2022-11-07 14:00:00,2022-11-07 15:00:00,104,0,36,8680,7408,16228,55868
2022-11-07 15:00:00,2022-11-07 16:00:00,104,0,6,8652,7679,16441,58690
2022-11-07 16:00:00,2022-11-07 17:00:00,107,0,4,8573,8110,16794,61601
2022-11-07 17:00:00,2022-11-07 18:00:00,106,0,4,8655,8485,17250,58653
2022-11-07 18:00:00,2022-11-07 19:00:00,106,0,4,8614,8488,17212,56118
2022-11-07 19:00:00,2022-11-07 20:00:00,105,0,4,8485,8533,17127,53224
2022-11-07 20:00:00,2022-11-07 21:00:00,106,0,4,8617,8430,17157,50560
2022-11-07 21:00:00,2022-11-07 22:00:00,104,0,4,8504,8555,17167,47397
2022-11-07 22:00:00,2022-11-07 23:00:00,100,0,4,7941,8292,16337,44565
2022-11-07 23:00:00,2022-11-08 00:00:00,103,0,4,7252,8048,15407,42056
2022-11-08 00:00:00,2022-11-08 01:00:00,108,0,4,7259,7942,15313,40402
2022-11-08 01:00:00,2022-11-08 02:00:00,108,0,4,6988,8048,15148,39591
2022-11-08 02:00:00,2022-11-08 03:00:00,108,0,4,6869,7869,14850,39487
2022-11-08 03:00:00,2022-11-08 04:00:00,107,0,4,7135,7787,15033,39725
2022-11-08 04:00:00,2022-11-08 05:00:00,106,0,4,7326,7747,15183,41610
2022-11-08 05:00:00,2022-11-08 06:00:00,105,0,4,8149,8206,16464,46577
2022-11-08 06:00:00,2022-11-08 07:00:00,98,0,12,9068,8737,17915,52306
2022-11-08 07:00:00,2022-11-08 08:00:00,102,0,106,9075,8598,17881,53133
2022-11-08 08:00:00,2022-11-08 09:00:00,104,0,302,9060,8391,17857,52270
2022-11-08 09:00:00,2022-11-08 10:00:00,104,0,379,9067,8375,17925,50895
2022-11-08 10:00:00,2022-11-08 11:00:00,104,0,274,9050,8365,17793,50614
2022-11-08 11:00:00,2022-11-08 12:00:00,104,0,338,8740,8088,17270,47835
2022-11-08 12:00:00,2022-11-08 13:00:00,104,0,309,8869,8408,17690,49135
2022-11-08 13:00:00,2022-11-08 14:00:00,104,0,218,8919,8014,17255,50947
2022-11-08 14:00:00,2022-11-08 15:00:00,104,0,87,8827,7585,16603,53229
2022-11-08 15:00:00,2022-11-08 16:00:00,104,0,10,8827,7633,16574,57240
2022-11-08 16:00:00,2022-11-08 17:00:00,102,0,4,8862,8192,17160,61116
2022-11-08 17:00:00,2022-11-08 18:00:00,103,0,4,8614,8679,17400,58386
2022-11-08 18:00:00,2022-11-08 19:00:00,104,0,4,8644,8794,17546,56091
2022-11-08 19:00:00,2022-11-08 20:00:00,104,0,4,8432,8698,17238,53249
2022-11-08 20:00:00,2022-11-08 21:00:00,104,0,4,7980,8203,16291,50034
2022-11-08 21:00:00,2022-11-08 22:00:00,103,0,4,8474,7495,16076,46790
2022-11-08 22:00:00,2022-11-08 23:00:00,99,0,4,8153,7279,15535,44075
2022-11-08 23:00:00,2022-11-09 00:00:00,103,0,4,8678,7300,16085,41577
2022-11-09 00:00:00,2022-11-09 01:00:00,107,0,4,8462,7725,16298,40573
2022-11-09 01:00:00,2022-11-09 02:00:00,107,0,4,7902,8121,16134,39737
2022-11-09 02:00:00,2022-11-09 03:00:00,107,0,4,8323,7941,16375,39557
2022-11-09 03:00:00,2022-11-09 04:00:00,107,0,4,8396,8051,16558,39695
2022-11-09 04:00:00,2022-11-09 05:00:00,103,0,4,8545,8063,16715,41787
2022-11-09 05:00:00,2022-11-09 06:00:00,100,0,4,8186,8321,16611,46512
2022-11-09 06:00:00,2022-11-09 07:00:00,101,0,6,7839,8072,16018,52331
2022-11-09 07:00:00,2022-11-09 08:00:00,101,0,112,7697,7960,15870,52434
2022-11-09 08:00:00,2022-11-09 09:00:00,101,0,320,7768,7967,16156,49694
2022-11-09 09:00:00,2022-11-09 10:00:00,105,0,427,8428,8423,17383,48938
2022-11-09 10:00:00,2022-11-09 11:00:00,104,0,368,8536,8637,17645,49181
2022-11-09 11:00:00,2022-11-09 12:00:00,104,0,387,8515,8710,17716,49090
2022-11-09 12:00:00,2022-11-09 13:00:00,104,0,322,8316,8503,17245,48927
2022-11-09 13:00:00,2022-11-09 14:00:00,104,0,212,7557,8784,16657,50864
2022-11-09 14:00:00,2022-11-09 15:00:00,105,0,60,7664,7805,15634,54185
2022-11-09 15:00:00,2022-11-09 16:00:00,100,0,10,7832,7420,15362,58237
2022-11-09 16:00:00,2022-11-09 17:00:00,97,0,4,8152,6917,15170,61690
2022-11-09 17:00:00,2022-11-09 18:00:00,103,0,4,7910,6470,14487,58812
2022-11-09 18:00:00,2022-11-09 19:00:00,103,0,4,7857,6123,14087,56575
2022-11-09 19:00:00,2022-11-09 20:00:00,104,0,4,7753,5993,13854,53845
2022-11-09 20:00:00,2022-11-09 21:00:00,104,0,4,7291,6039,13438,50695
2022-11-09 21:00:00,2022-11-09 22:00:00,101,0,4,7387,5595,13087,47734
2022-11-09 22:00:00,2022-11-09 23:00:00,101,0,4,6846,5619,12570,45023
2022-11-09 23:00:00,2022-11-10 00:00:00,104,0,4,6905,5651,12664,42794
2022-11-10 00:00:00,2022-11-10 01:00:00,104,0,4,6618,5740,12466,41041
2022-11-10 01:00:00,2022-11-10 02:00:00,103,0,4,7241,5532,12880,40451
2022-11-10 02:00:00,2022-11-10 03:00:00,104,0,4,7716,5651,13475,40199
2022-11-10 03:00:00,2022-11-10 04:00:00,104,0,4,8356,6100,14564,40323
2022-11-10 04:00:00,2022-11-10 05:00:00,101,0,4,8574,6047,14726,42370
2022-11-10 05:00:00,2022-11-10 06:00:00,100,0,4,8459,6533,15096,47335
2022-11-10 06:00:00,2022-11-10 07:00:00,100,0,8,7984,6605,14697,53009
2022-11-10 07:00:00,2022-11-10 08:00:00,100,0,99,7335,6742,14276,52789
2022-11-10 08:00:00,2022-11-10 09:00:00,100,0,294,7104,6640,14138,49203
2022-11-10 09:00:00,2022-11-10 10:00:00,81,0,338,6954,6717,14090,46056
2022-11-10 10:00:00,2022-11-10 11:00:00,84,0,385,7453,6589,14511,45612
2022-11-10 11:00:00,2022-11-10 12:00:00,88,0,346,8212,7020,15666,47120
2022-11-10 12:00:00,2022-11-10 13:00:00,89,0,237,8443,7066,15835,49331
2022-11-10 13:00:00,2022-11-10 14:00:00,98,0,112,8518,7127,15855,52096
2022-11-10 14:00:00,2022-11-10 15:00:00,101,0,29,8589,6746,15465,54973
2022-11-10 15:00:00,2022-11-10 16:00:00,100,0,4,8515,6673,15292,58440
2022-11-10 16:00:00,2022-11-10 17:00:00,104,0,4,8604,7462,16174,61822
2022-11-10 17:00:00,2022-11-10 18:00:00,105,0,4,8515,7988,16612,59251
2022-11-10 18:00:00,2022-11-10 19:00:00,104,0,4,8489,7996,16593,57031
2022-11-10 19:00:00,2022-11-10 20:00:00,104,0,4,8481,8155,16744,54274
2022-11-10 20:00:00,2022-11-10 21:00:00,105,0,4,8565,8312,16986,51219
2022-11-10 21:00:00,2022-11-10 22:00:00,107,0,4,8595,7926,16632,48067
2022-11-10 22:00:00,2022-11-10 23:00:00,108,0,4,8546,8032,16690,45516
2022-11-10 23:00:00,2022-11-11 00:00:00,108,0,4,8575,7942,16629,43162
2022-11-11 00:00:00,2022-11-11 01:00:00,107,0,4,8561,7843,16515,41131
2022-11-11 01:00:00,2022-11-11 02:00:00,107,0,4,8566,7574,16251,40186
2022-11-11 02:00:00,2022-11-11 03:00:00,108,0,4,8267,7454,15833,39837
2022-11-11 03:00:00,2022-11-11 04:00:00,107,0,4,7509,7252,14872,40094
2022-11-11 04:00:00,2022-11-11 05:00:00,104,0,4,7720,7449,15277,42459
2022-11-11 05:00:00,2022-11-11 06:00:00,106,0,4,7800,7150,15060,47295
2022-11-11 06:00:00,2022-11-11 07:00:00,106,0,4,7182,7045,14337,53300
2022-11-11 07:00:00,2022-11-11 08:00:00,104,0,27,7418,6821,14370,55607
2022-11-11 08:00:00,2022-11-11 09:00:00,104,0,105,7416,6340,13965,54149
2022-11-11 09:00:00,2022-11-11 10:00:00,104,0,193,7209,5904,13410,51376
2022-11-11 10:00:00,2022-11-11 11:00:00,103,0,246,6027,5296,11672,48751
2022-11-11 11:00:00,2022-11-11 12:00:00,100,0,325,5162,4923,10510,47086
2022-11-11 12:00:00,2022-11-11 13:00:00,100,0,377,4416,4141,9034,47027
2022-11-11 13:00:00,2022-11-11 14:00:00,100,0,238,3875,3327,7540,49378
2022-11-11 14:00:00,2022-11-11 15:00:00,100,0,101,3401,2564,6166,53228
2022-11-11 15:00:00,2022-11-11 16:00:00,100,0,8,3080,2334,5522,57439
2022-11-11 16:00:00,2022-11-11 17:00:00,101,0,4,3373,2901,6379,60664
2022-11-11 17:00:00,2022-11-11 18:00:00,104,0,4,3594,3639,7341,58023
2022-11-11 18:00:00,2022-11-11 19:00:00,104,0,4,3640,3812,7560,55397
2022-11-11 19:00:00,2022-11-11 20:00:00,104,0,4,3388,3682,7178,52747
2022-11-11 20:00:00,2022-11-11 21:00:00,105,0,4,2859,3743,6711,49433
2022-11-11 21:00:00,2022-11-11 22:00:00,104,0,4,2586,3193,5887,47016
2022-11-11 22:00:00,2022-11-11 23:00:00,101,0,4,2233,2680,5018,45150
2022-11-11 23:00:00,2022-11-12 00:00:00,101,0,4,2061,2018,4184,43216
2022-11-12 00:00:00,2022-11-12 01:00:00,104,0,4,1737,1437,3282,41095
2022-11-12 01:00:00,2022-11-12 02:00:00,104,0,4,1262,920,2290,39789
2022-11-12 02:00:00,2022-11-12 03:00:00,104,0,4,885,818,1811,39651
2022-11-12 03:00:00,2022-11-12 04:00:00,104,0,4,743,736,1587,39424
2022-11-12 04:00:00,2022-11-12 05:00:00,105,0,4,696,849,1654,39858
2022-11-12 05:00:00,2022-11-12 06:00:00,104,0,4,367,664,1139,41666
2022-11-12 06:00:00,2022-11-12 07:00:00,100,0,6,361,595,1062,44661
2022-11-12 07:00:00,2022-11-12 08:00:00,104,0,93,498,611,1306,45192
2022-11-12 08:00:00,2022-11-12 09:00:00,107,0,274,454,680,1515,43077
2022-11-12 09:00:00,2022-11-12 10:00:00,108,0,487,362,771,1728,39636
2022-11-12 10:00:00,2022-11-12 11:00:00,105,0,534,421,742,1802,37617
2022-11-12 11:00:00,2022-11-12 12:00:00,105,0,553,363,689,1710,36470
2022-11-12 12:00:00,2022-11-12 13:00:00,103,0,581,354,492,1530,36711
2022-11-12 13:00:00,2022-11-12 14:00:00,94,0,397,232,442,1165,39464
2022-11-12 14:00:00,2022-11-12 15:00:00,88,0,146,371,507,1112,44193
2022-11-12 15:00:00,2022-11-12 16:00:00,88,0,12,350,816,1266,50170
2022-11-12 16:00:00,2022-11-12 17:00:00,89,0,4,511,1288,1892,55140
2022-11-12 17:00:00,2022-11-12 18:00:00,80,0,4,831,1494,2409,53558
2022-11-12 18:00:00,2022-11-12 19:00:00,80,0,4,629,1521,2234,51435
2022-11-12 19:00:00,2022-11-12 20:00:00,80,0,4,667,1453,2204,48984
2022-11-12 20:00:00,2022-11-12 21:00:00,80,0,4,538,1233,1855,46894
2022-11-12 21:00:00,2022-11-12 22:00:00,80,0,4,878,735,1697,44958
2022-11-12 22:00:00,2022-11-12 23:00:00,78,0,4,699,556,1337,43077
2022-11-12 23:00:00,2022-11-13 00:00:00,79,0,4,564,550,1197,41105
2022-11-13 00:00:00,2022-11-13 01:00:00,83,0,4,488,562,1137,39507
2022-11-13 01:00:00,2022-11-13 02:00:00,84,0,4,143,957,1188,38579
2022-11-13 02:00:00,2022-11-13 03:00:00,84,0,4,87,891,1066,38113
2022-11-13 03:00:00,2022-11-13 04:00:00,83,0,4,141,692,920,37642
2022-11-13 04:00:00,2022-11-13 05:00:00,83,0,4,262,893,1242,37882
2022-11-13 05:00:00,2022-11-13 06:00:00,81,0,4,404,1142,1631,38880
2022-11-13 06:00:00,2022-11-13 07:00:00,76,0,8,575,1282,1941,40662
2022-11-13 07:00:00,2022-11-13 08:00:00,81,0,113,631,1186,2011,40140
2022-11-13 08:00:00,2022-11-13 09:00:00,74,0,358,649,1198,2279,37295
2022-11-13 09:00:00,2022-11-13 10:00:00,72,0,514,665,983,2234,34541
2022-11-13 10:00:00,2022-11-13 11:00:00,72,0,693,555,900,2220,32838
2022-11-13 11:00:00,2022-11-13 12:00:00,72,0,698,554,927,2251,32860
2022-11-13 12:00:00,2022-11-13 13:00:00,72,0,574,608,997,2251,33770
2022-11-13 13:00:00,2022-11-13 14:00:00,72,0,386,756,924,2138,36774
2022-11-13 14:00:00,2022-11-13 15:00:00,71,0,147,803,1266,2287,42182
2022-11-13 15:00:00,2022-11-13 16:00:00,71,0,13,793,2015,2892,49015
2022-11-13 16:00:00,2022-11-13 17:00:00,74,0,8,1069,2970,4121,54394
2022-11-13 17:00:00,2022-11-13 18:00:00,74,0,8,1283,3377,4742,53023
2022-11-13 18:00:00,2022-11-13 19:00:00,75,0,8,1855,4004,5942,50855
2022-11-13 19:00:00,2022-11-13 20:00:00,75,0,8,2044,4261,6388,48596
2022-11-13 20:00:00,2022-11-13 21:00:00,75,0,8,2343,3397,5823,46741
2022-11-13 21:00:00,2022-11-13 22:00:00,74,0,8,2339,3373,5794,44502
2022-11-13 22:00:00,2022-11-13 23:00:00,70,0,8,2558,3502,6138,42202
2022-11-13 23:00:00,2022-11-14 00:00:00,71,0,8,2467,2934,5480,40941
2022-11-14 00:00:00,2022-11-14 01:00:00,78,0,8,2625,2752,5463,39431
2022-11-14 01:00:00,2022-11-14 02:00:00,107,0,8,2700,2605,5420,38712
2022-11-14 02:00:00,2022-11-14 03:00:00,107,0,8,2634,2408,5157,38701
2022-11-14 03:00:00,2022-11-14 04:00:00,83,0,8,2434,2652,5177,39310
2022-11-14 04:00:00,2022-11-14 05:00:00,65,0,8,2452,2795,5320,41802
2022-11-14 05:00:00,2022-11-14 06:00:00,63,0,8,2199,2592,4862,47428
2022-11-14 06:00:00,2022-11-14 07:00:00,68,0,7,2113,2278,4466,54173
2022-11-14 07:00:00,2022-11-14 08:00:00,86,0,57,2094,2279,4516,55484
2022-11-14 08:00:00,2022-11-14 09:00:00,93,0,195,2041,2130,4459,51330
2022-11-14 09:00:00,2022-11-14 10:00:00,88,0,381,1544,1726,3739,46738
2022-11-14 10:00:00,2022-11-14 11:00:00,96,0,550,1454,1809,3909,44365
2022-11-14 11:00:00,2022-11-14 12:00:00,96,0,609,1803,1250,3758,44656
2022-11-14 12:00:00,2022-11-14 13:00:00,96,0,529,1738,1639,4002,47283
2022-11-14 13:00:00,2022-11-14 14:00:00,96,0,321,2125,1999,4541,50474
2022-11-14 14:00:00,2022-11-14 15:00:00,91,0,97,3039,1986,5213,55463
2022-11-14 15:00:00,2022-11-14 16:00:00,90,0,9,3433,2491,6023,60503
2022-11-14 16:00:00,2022-11-14 17:00:00,86,0,8,3487,2692,6273,63786
2022-11-14 17:00:00,2022-11-14 18:00:00,83,0,8,3698,2787,6576,60906
2022-11-14 18:00:00,2022-11-14 19:00:00,83,0,8,3070,2959,6120,58188
2022-11-14 19:00:00,2022-11-14 20:00:00,84,0,8,2941,2740,5773,55114
2022-11-14 20:00:00,2022-11-14 21:00:00,84,0,8,2320,2774,5186,51505
2022-11-14 21:00:00,2022-11-14 22:00:00,84,0,8,2012,2426,4530,48122
2022-11-14 22:00:00,2022-11-14 23:00:00,83,0,8,1797,1941,3829,45121
2022-11-14 23:00:00,2022-11-15 00:00:00,80,0,8,2557,2129,4774,42578
2022-11-15 00:00:00,2022-11-15 01:00:00,82,0,8,4021,2501,6612,40706
2022-11-15 01:00:00,2022-11-15 02:00:00,82,0,8,6047,2981,9118,40365
2022-11-15 02:00:00,2022-11-15 03:00:00,83,0,8,4887,3364,8342,39590
2022-11-15 03:00:00,2022-11-15 04:00:00,84,0,8,4984,3439,8515,39408
2022-11-15 04:00:00,2022-11-15 05:00:00,84,0,8,5707,3968,9767,41739
2022-11-15 05:00:00,2022-11-15 06:00:00,84,0,8,5225,4281,9598,46736
2022-11-15 06:00:00,2022-11-15 07:00:00,79,0,6,6103,4638,10826,53387
2022-11-15 07:00:00,2022-11-15 08:00:00,80,0,23,7353,4461,11917,55745
2022-11-15 08:00:00,2022-11-15 09:00:00,79,0,106,8281,4291,12757,53591
2022-11-15 09:00:00,2022-11-15 10:00:00,87,0,161,8547,4625,13420,49592
2022-11-15 10:00:00,2022-11-15 11:00:00,93,0,191,8033,4776,13093,47218
2022-11-15 11:00:00,2022-11-15 12:00:00,95,0,335,8284,5470,14184,46111
2022-11-15 12:00:00,2022-11-15 13:00:00,96,0,349,7917,5218,13580,47637
2022-11-15 13:00:00,2022-11-15 14:00:00,95,0,264,7980,5187,13526,51884
2022-11-15 14:00:00,2022-11-15 15:00:00,88,0,83,8135,5927,14233,56026
2022-11-15 15:00:00,2022-11-15 16:00:00,94,0,6,8778,6904,15782,59768
2022-11-15 16:00:00,2022-11-15 17:00:00,96,0,4,9139,7136,16375,62330
2022-11-15 17:00:00,2022-11-15 18:00:00,98,0,4,9104,7104,16310,59229
2022-11-15 18:00:00,2022-11-15 19:00:00,96,0,4,9054,6679,15833,56971
2022-11-15 19:00:00,2022-11-15 20:00:00,96,0,4,8429,6532,15061,54240
2022-11-15 20:00:00,2022-11-15 21:00:00,97,0,4,7492,6209,13802,50888
2022-11-15 21:00:00,2022-11-15 22:00:00,96,0,4,6819,5579,12498,47643
2022-11-15 22:00:00,2022-11-15 23:00:00,94,0,4,4756,4934,9788,44091
2022-11-15 23:00:00,2022-11-16 00:00:00,98,0,4,4425,4699,9226,42082
2022-11-16 00:00:00,2022-11-16 01:00:00,98,0,4,4252,4434,8788,41318
2022-11-16 01:00:00,2022-11-16 02:00:00,97,0,4,4848,4160,9109,40596
2022-11-16 02:00:00,2022-11-16 03:00:00,98,0,4,5661,3802,9565,40549
2022-11-16 03:00:00,2022-11-16 04:00:00,97,0,4,5931,3062,9094,40949
2022-11-16 04:00:00,2022-11-16 05:00:00,96,0,4,5590,2654,8344,42176
2022-11-16 05:00:00,2022-11-16 06:00:00,96,0,4,7518,2717,10335,47268
2022-11-16 06:00:00,2022-11-16 07:00:00,102,0,4,6882,3086,10074,53640
2022-11-16 07:00:00,2022-11-16 08:00:00,105,0,22,6767,3059,9953,54911
2022-11-16 08:00:00,2022-11-16 09:00:00,105,0,107,6095,3267,9574,51304
2022-11-16 09:00:00,2022-11-16 10:00:00,105,0,208,6101,3358,9772,47634
2022-11-16 10:00:00,2022-11-16 11:00:00,104,0,274,7035,3778,11191,46263
2022-11-16 11:00:00,2022-11-16 12:00:00,96,0,455,7847,3918,12316,47018
2022-11-16 12:00:00,2022-11-16 13:00:00,82,0,539,7202,3432,11255,47502
2022-11-16 13:00:00,2022-11-16 14:00:00,80,0,342,6930,3368,10720,50592
2022-11-16 14:00:00,2022-11-16 15:00:00,80,0,127,6526,3154,9887,54537
2022-11-16 15:00:00,2022-11-16 16:00:00,81,0,9,6812,3517,10419,58850
2022-11-16 16:00:00,2022-11-16 17:00:00,80,0,4,8074,5286,13444,62516
2022-11-16 17:00:00,2022-11-16 18:00:00,91,0,4,8390,6296,14781,59850
2022-11-16 18:00:00,2022-11-16 19:00:00,97,0,4,8909,6811,15821,57266
2022-11-16 19:00:00,2022-11-16 20:00:00,112,0,4,9033,7581,16730,54553
2022-11-16 20:00:00,2022-11-16 21:00:00,116,0,4,9065,8194,17379,51473
2022-11-16 21:00:00,2022-11-16 22:00:00,114,0,4,9098,8640,17856,48116
2022-11-16 22:00:00,2022-11-16 23:00:00,112,0,4,8967,9005,18088,45269
2022-11-16 23:00:00,2022-11-17 00:00:00,117,0,4,8075,9211,17407,42825
2022-11-17 00:00:00,2022-11-17 01:00:00,119,0,4,8218,9221,17562,41239
2022-11-17 01:00:00,2022-11-17 02:00:00,108,0,4,8024,9185,17321,40498
2022-11-17 02:00:00,2022-11-17 03:00:00,105,0,4,8200,8929,17238,40162
2022-11-17 03:00:00,2022-11-17 04:00:00,108,0,4,7918,8628,16658,40565
2022-11-17 04:00:00,2022-11-17 05:00:00,105,0,4,7953,8550,16612,42821
2022-11-17 05:00:00,2022-11-17 06:00:00,104,0,4,7810,9076,16994,48305
2022-11-17 06:00:00,2022-11-17 07:00:00,105,0,4,8042,9017,17168,54658
2022-11-17 07:00:00,2022-11-17 08:00:00,103,0,9,8086,8893,17091,57535
2022-11-17 08:00:00,2022-11-17 09:00:00,104,0,40,8092,8767,17003,58517
2022-11-17 09:00:00,2022-11-17 10:00:00,113,0,56,8113,8672,16954,58160
2022-11-17 10:00:00,2022-11-17 11:00:00,128,0,79,8253,8516,16976,57711
2022-11-17 11:00:00,2022-11-17 12:00:00,117,0,89,8455,8560,17221,57234
2022-11-17 12:00:00,2022-11-17 13:00:00,118,0,91,8522,8479,17210,57955
2022-11-17 13:00:00,2022-11-17 14:00:00,96,0,52,8619,8561,17328,58067
2022-11-17 14:00:00,2022-11-17 15:00:00,118,0,21,8796,8155,17090,59302
2022-11-17 15:00:00,2022-11-17 16:00:00,120,0,8,8814,8562,17504,61151
2022-11-17 16:00:00,2022-11-17 17:00:00,122,0,8,8894,8824,17848,63013
2022-11-17 17:00:00,2022-11-17 18:00:00,117,0,8,8814,8710,17649,60553
2022-11-17 18:00:00,2022-11-17 19:00:00,116,0,8,8811,8400,17335,58104
2022-11-17 19:00:00,2022-11-17 20:00:00,116,0,8,8694,8020,16838,55461
2022-11-17 20:00:00,2022-11-17 21:00:00,116,0,8,8585,7575,16284,52653
2022-11-17 21:00:00,2022-11-17 22:00:00,104,0,8,8435,6792,15339,49499
2022-11-17 22:00:00,2022-11-17 23:00:00,98,0,8,8445,6239,14790,46734
2022-11-17 23:00:00,2022-11-18 00:00:00,102,0,8,8649,5376,14135,44471
2022-11-18 00:00:00,2022-11-18 01:00:00,105,0,8,8359,4867,13339,42714
2022-11-18 01:00:00,2022-11-18 02:00:00,106,0,8,7870,4502,12486,41498
2022-11-18 02:00:00,2022-11-18 03:00:00,100,0,8,6987,4078,11173,41014
2022-11-18 03:00:00,2022-11-18 04:00:00,100,0,8,6377,3646,10131,41174
2022-11-18 04:00:00,2022-11-18 05:00:00,100,0,8,6477,3714,10299,43288
2022-11-18 05:00:00,2022-11-18 06:00:00,99,0,8,6043,3959,10109,48293
2022-11-18 06:00:00,2022-11-18 07:00:00,93,0,8,5098,3518,8717,53930
2022-11-18 07:00:00,2022-11-18 08:00:00,96,0,19,4606,3329,8050,56453
2022-11-18 08:00:00,2022-11-18 09:00:00,110,0,65,4828,2986,7989,55295
2022-11-18 09:00:00,2022-11-18 10:00:00,108,0,105,5255,2649,8117,53237
2022-11-18 10:00:00,2022-11-18 11:00:00,108,0,135,5046,2520,7809,53302
2022-11-18 11:00:00,2022-11-18 12:00:00,109,0,109,4555,2620,7393,54139
2022-11-18 12:00:00,2022-11-18 13:00:00,110,0,92,3944,2786,6932,55631
2022-11-18 13:00:00,2022-11-18 14:00:00,108,0,54,3959,3032,7153,56634
2022-11-18 14:00:00,2022-11-18 15:00:00,109,0,17,3954,2860,6940,58036
2022-11-18 15:00:00,2022-11-18 16:00:00,106,0,4,3630,2927,6667,60429
2022-11-18 16:00:00,2022-11-18 17:00:00,105,0,4,3894,3341,7344,62385
2022-11-18 17:00:00,2022-11-18 18:00:00,108,0,4,4333,4275,8720,59828
2022-11-18 18:00:00,2022-11-18 19:00:00,109,0,4,4782,4636,9531,57295
2022-11-18 19:00:00,2022-11-18 20:00:00,104,0,4,5552,5202,10862,54377
2022-11-18 20:00:00,2022-11-18 21:00:00,104,0,4,6083,5393,11584,51513
2022-11-18 21:00:00,2022-11-18 22:00:00,103,0,4,6167,5356,11630,48569
2022-11-18 22:00:00,2022-11-18 23:00:00,97,0,4,6176,4692,10969,46370
2022-11-18 23:00:00,2022-11-19 00:00:00,100,0,4,5827,4815,10746,43732
2022-11-19 00:00:00,2022-11-19 01:00:00,102,0,4,5368,5036,10510,41731
2022-11-19 01:00:00,2022-11-19 02:00:00,103,0,4,5202,5195,10504,40318
2022-11-19 02:00:00,2022-11-19 03:00:00,103,0,4,5228,5464,10799,40026
2022-11-19 03:00:00,2022-11-19 04:00:00,102,0,4,5318,5741,11165,40022
2022-11-19 04:00:00,2022-11-19 05:00:00,101,0,4,5256,5860,11221,40671
2022-11-19 05:00:00,2022-11-19 06:00:00,104,0,4,5255,5710,11073,42929
2022-11-19 06:00:00,2022-11-19 07:00:00,104,0,4,5474,5925,11507,46303
2022-11-19 07:00:00,2022-11-19 08:00:00,92,0,71,5573,5959,11695,48608
2022-11-19 08:00:00,2022-11-19 09:00:00,96,0,274,4773,5316,10459,48349
2022-11-19 09:00:00,2022-11-19 10:00:00,100,0,499,3883,4506,8988,46525
2022-11-19 10:00:00,2022-11-19 11:00:00,98,0,616,3271,4172,8157,44959
2022-11-19 11:00:00,2022-11-19 12:00:00,100,0,629,2526,4311,7566,44187
2022-11-19 12:00:00,2022-11-19 13:00:00,95,0,531,1972,4205,6803,44832
2022-11-19 13:00:00,2022-11-19 14:00:00,92,0,323,1603,3611,5629,46753
2022-11-19 14:00:00,2022-11-19 15:00:00,91,0,102,1247,2819,4259,50435
2022-11-19 15:00:00,2022-11-19 16:00:00,81,0,5,1017,2494,3597,55273
2022-11-19 16:00:00,2022-11-19 17:00:00,80,0,4,1175,1821,3080,58458
2022-11-19 17:00:00,2022-11-19 18:00:00,80,0,4,990,1461,2535,56753
2022-11-19 18:00:00,2022-11-19 19:00:00,80,0,4,876,1661,2621,54584
2022-11-19 19:00:00,2022-11-19 20:00:00,80,0,4,701,1520,2305,52656
2022-11-19 20:00:00,2022-11-19 21:00:00,80,0,4,687,1148,1919,50517
2022-11-19 21:00:00,2022-11-19 22:00:00,79,0,4,557,753,1393,48303
2022-11-19 22:00:00,2022-11-19 23:00:00,77,0,4,266,662,1009,45920
2022-11-19 23:00:00,2022-11-20 00:00:00,77,0,4,133,538,752,43855
2022-11-20 00:00:00,2022-11-20 01:00:00,77,0,4,127,414,622,42352
2022-11-20 01:00:00,2022-11-20 02:00:00,78,0,4,108,411,601,41327
2022-11-20 02:00:00,2022-11-20 03:00:00,78,0,4,124,397,603,40827
2022-11-20 03:00:00,2022-11-20 04:00:00,76,0,4,490,400,970,40718
2022-11-20 04:00:00,2022-11-20 05:00:00,77,0,4,577,431,1089,40936
2022-11-20 05:00:00,2022-11-20 06:00:00,76,0,4,683,443,1206,41726
2022-11-20 06:00:00,2022-11-20 07:00:00,69,0,3,1408,659,2139,43864
2022-11-20 07:00:00,2022-11-20 08:00:00,67,0,41,1626,879,2613,45470
2022-11-20 08:00:00,2022-11-20 09:00:00,69,0,107,1772,1350,3298,45980
2022-11-20 09:00:00,2022-11-20 10:00:00,68,0,204,2818,1849,4939,46313
2022-11-20 10:00:00,2022-11-20 11:00:00,68,0,320,3777,2128,6293,47231
2022-11-20 11:00:00,2022-11-20 12:00:00,68,0,245,4390,1981,6684,49025
2022-11-20 12:00:00,2022-11-20 13:00:00,72,0,278,6097,2104,8551,50983
2022-11-20 13:00:00,2022-11-20 14:00:00,72,0,178,6341,2609,9200,51876
2022-11-20 14:00:00,2022-11-20 15:00:00,69,0,41,6298,3178,9586,52874
2022-11-20 15:00:00,2022-11-20 16:00:00,61,0,4,6404,3595,10064,55900
2022-11-20 16:00:00,2022-11-20 17:00:00,75,0,4,6263,3408,9750,58184
2022-11-20 17:00:00,2022-11-20 18:00:00,65,0,4,6072,4022,10163,56396
2022-11-20 18:00:00,2022-11-20 19:00:00,70,0,4,5625,4116,9815,54539
2022-11-20 19:00:00,2022-11-20 20:00:00,64,0,4,5561,3790,9419,52394
2022-11-20 20:00:00,2022-11-20 21:00:00,64,0,4,5601,3128,8797,49869
2022-11-20 21:00:00,2022-11-20 22:00:00,64,0,4,5375,2494,7937,47306
2022-11-20 22:00:00,2022-11-20 23:00:00,64,0,4,5569,2057,7694,44929
2022-11-20 23:00:00,2022-11-21 00:00:00,63,0,4,4275,1734,6076,43171
2022-11-21 00:00:00,2022-11-21 01:00:00,64,0,4,3335,1099,4502,41730
2022-11-21 01:00:00,2022-11-21 02:00:00,69,0,4,2319,781,3173,40948
2022-11-21 02:00:00,2022-11-21 03:00:00,86,0,4,1678,797,2565,41120
2022-11-21 03:00:00,2022-11-21 04:00:00,84,0,4,1721,804,2613,41564
2022-11-21 04:00:00,2022-11-21 05:00:00,82,0,4,1519,867,2472,43671
2022-11-21 05:00:00,2022-11-21 06:00:00,81,0,4,825,1040,1950,48297
2022-11-21 06:00:00,2022-11-21 07:00:00,80,0,4,742,1294,2120,56136
2022-11-21 07:00:00,2022-11-21 08:00:00,82,0,57,1062,1496,2697,59475
2022-11-21 08:00:00,2022-11-21 09:00:00,81,0,235,1447,1737,3500,58446
2022-11-21 09:00:00,2022-11-21 10:00:00,82,0,252,2445,1778,4557,55930
2022-11-21 10:00:00,2022-11-21 11:00:00,81,0,279,2555,1965,4880,53982
2022-11-21 11:00:00,2022-11-21 12:00:00,83,0,331,3162,1959,5535,52680
2022-11-21 12:00:00,2022-11-21 13:00:00,82,0,184,4340,2320,6926,56291
2022-11-21 13:00:00,2022-11-21 14:00:00,82,0,115,4654,2368,7219,58191
2022-11-21 14:00:00,2022-11-21 15:00:00,80,0,20,6362,3173,9635,60773
2022-11-21 15:00:00,2022-11-21 16:00:00,84,0,4,7747,3639,11474,64173
2022-11-21 16:00:00,2022-11-21 17:00:00,82,0,4,8019,4170,12275,65092
2022-11-21 17:00:00,2022-11-21 18:00:00,84,0,4,7848,5206,13142,61106
2022-11-21 18:00:00,2022-11-21 19:00:00,84,0,4,8071,6066,14225,59541
2022-11-21 19:00:00,2022-11-21 20:00:00,84,0,4,8440,6547,15075,56360
2022-11-21 20:00:00,2022-11-21 21:00:00,84,0,4,8475,6624,15187,53225
2022-11-21 21:00:00,2022-11-21 22:00:00,84,0,4,8862,6379,15329,50029
2022-11-21 22:00:00,2022-11-21 23:00:00,82,0,4,9001,6363,15450,47200
2022-11-21 23:00:00,2022-11-22 00:00:00,82,0,4,9034,6634,15754,44567
2022-11-22 00:00:00,2022-11-22 01:00:00,84,0,4,9002,6602,15692,42543
2022-11-22 01:00:00,2022-11-22 02:00:00,83,0,4,9036,6164,15287,41601
2022-11-22 02:00:00,2022-11-22 03:00:00,81,0,4,9107,5649,14841,41146
2022-11-22 03:00:00,2022-11-22 04:00:00,80,0,4,8741,5889,14714,41594
2022-11-22 04:00:00,2022-11-22 05:00:00,80,0,4,9025,6132,15241,43856
2022-11-22 05:00:00,2022-11-22 06:00:00,80,0,4,8941,6161,15186,49387
2022-11-22 06:00:00,2022-11-22 07:00:00,80,0,4,8439,6802,15325,55969
2022-11-22 07:00:00,2022-11-22 08:00:00,80,0,25,7793,6843,14741,58752
2022-11-22 08:00:00,2022-11-22 09:00:00,80,0,166,8008,6957,15211,58849
2022-11-22 09:00:00,2022-11-22 10:00:00,73,0,246,8036,6775,15130,57929
2022-11-22 10:00:00,2022-11-22 11:00:00,69,0,260,8389,6578,15296,57390
2022-11-22 11:00:00,2022-11-22 12:00:00,68,0,292,8038,6045,14443,57552
2022-11-22 12:00:00,2022-11-22 13:00:00,68,0,125,7547,5528,13268,57792
2022-11-22 13:00:00,2022-11-22 14:00:00,67,0,54,7850,5271,13242,58692
2022-11-22 14:00:00,2022-11-22 15:00:00,63,0,13,7799,5239,13114,60433
2022-11-22 15:00:00,2022-11-22 16:00:00,62,0,4,7224,5542,12832,63061
2022-11-22 16:00:00,2022-11-22 17:00:00,61,0,4,6852,5733,12650,64862
2022-11-22 17:00:00,2022-11-22 18:00:00,62,0,4,5792,5598,11456,61790
2022-11-22 18:00:00,2022-11-22 19:00:00,63,0,4,4940,5399,10406,59236
2022-11-22 19:00:00,2022-11-22 20:00:00,64,0,4,4781,4953,9802,56256
2022-11-22 20:00:00,2022-11-22 21:00:00,63,0,4,4736,4895,9698,53021
2022-11-22 21:00:00,2022-11-22 22:00:00,64,0,4,4410,4738,9216,49746
2022-11-22 22:00:00,2022-11-22 23:00:00,60,0,4,4312,4974,9350,46488
2022-11-22 23:00:00,2022-11-23 00:00:00,62,0,4,4704,4760,9530,44045
2022-11-23 00:00:00,2022-11-23 01:00:00,62,0,4,4589,4675,9330,42158
2022-11-23 01:00:00,2022-11-23 02:00:00,64,0,4,5393,4996,10457,41475
2022-11-23 02:00:00,2022-11-23 03:00:00,63,0,4,5308,4857,10232,41109
2022-11-23 03:00:00,2022-11-23 04:00:00,63,0,4,5453,5645,11165,41420
2022-11-23 04:00:00,2022-11-23 05:00:00,61,0,4,6945,5324,12334,43662
2022-11-23 05:00:00,2022-11-23 06:00:00,61,0,4,6077,5218,11360,48007
2022-11-23 06:00:00,2022-11-23 07:00:00,59,0,4,7306,5151,12520,54477
2022-11-23 07:00:00,2022-11-23 08:00:00,70,0,24,8039,5516,13649,57431
2022-11-23 08:00:00,2022-11-23 09:00:00,82,0,99,8807,6073,15061,55812
2022-11-23 09:00:00,2022-11-23 10:00:00,79,0,155,8940,6060,15234,51929
2022-11-23 10:00:00,2022-11-23 11:00:00,79,0,193,8763,5913,14948,49312
2022-11-23 11:00:00,2022-11-23 12:00:00,80,0,428,8255,5964,14727,48798
2022-11-23 12:00:00,2022-11-23 13:00:00,79,0,351,8877,7119,16426,52512
2022-11-23 13:00:00,2022-11-23 14:00:00,79,0,208,8769,7361,16417,56858
2022-11-23 14:00:00,2022-11-23 15:00:00,73,0,38,8742,7751,16604,59595
2022-11-23 15:00:00,2022-11-23 16:00:00,67,0,4,8532,7956,16559,62523
2022-11-23 16:00:00,2022-11-23 17:00:00,67,0,4,8480,7644,16195,64234
2022-11-23 17:00:00,2022-11-23 18:00:00,68,0,4,8750,7520,16342,61271
2022-11-23 18:00:00,2022-11-23 19:00:00,68,0,4,8996,7652,16720,58976
2022-11-23 19:00:00,2022-11-23 20:00:00,69,0,4,8994,7634,16701,56243
2022-11-23 20:00:00,2022-11-23 21:00:00,68,0,4,8637,7724,16433,52949
2022-11-23 21:00:00,2022-11-23 22:00:00,69,0,4,8822,7562,16457,49368
2022-11-23 22:00:00,2022-11-23 23:00:00,68,0,4,8848,7668,16588,46188
2022-11-23 23:00:00,2022-11-24 00:00:00,68,0,4,8251,7965,16288,43705
2022-11-24 00:00:00,2022-11-24 01:00:00,68,0,4,8525,7833,16430,41797
2022-11-24 01:00:00,2022-11-24 02:00:00,68,0,4,8608,7684,16364,40676
2022-11-24 02:00:00,2022-11-24 03:00:00,68,0,4,6905,7674,14651,40360
2022-11-24 03:00:00,2022-11-24 04:00:00,68,0,4,5771,6570,12413,40059
2022-11-24 04:00:00,2022-11-24 05:00:00,68,0,4,7556,5538,13166,43001
2022-11-24 05:00:00,2022-11-24 06:00:00,68,0,4,7645,5648,13365,48410
2022-11-24 06:00:00,2022-11-24 07:00:00,66,0,3,5748,4781,10598,54756
2022-11-24 07:00:00,2022-11-24 08:00:00,68,0,32,3836,4530,8466,57246
2022-11-24 08:00:00,2022-11-24 09:00:00,70,0,202,3752,4567,8591,54543
2022-11-24 09:00:00,2022-11-24 10:00:00,77,0,406,3547,4001,8031,49201
2022-11-24 10:00:00,2022-11-24 11:00:00,69,0,436,4267,3546,8318,46150
2022-11-24 11:00:00,2022-11-24 12:00:00,68,0,490,5525,3290,9373,44571
2022-11-24 12:00:00,2022-11-24 13:00:00,68,0,450,5668,3411,9597,45925
2022-11-24 13:00:00,2022-11-24 14:00:00,69,0,240,7078,3438,10825,50129
2022-11-24 14:00:00,2022-11-24 15:00:00,66,0,71,7867,3971,11975,56105
2022-11-24 15:00:00,2022-11-24 16:00:00,66,0,4,8430,5429,13929,60501
2022-11-24 16:00:00,2022-11-24 17:00:00,79,0,4,8654,6667,15404,63030
2022-11-24 17:00:00,2022-11-24 18:00:00,79,0,4,8930,7627,16640,60505
2022-11-24 18:00:00,2022-11-24 19:00:00,72,0,4,8965,8082,17123,58362
2022-11-24 19:00:00,2022-11-24 20:00:00,69,0,4,8930,8233,17236,55469
2022-11-24 20:00:00,2022-11-24 21:00:00,71,0,4,8809,8141,17025,52078
2022-11-24 21:00:00,2022-11-24 22:00:00,72,0,4,7851,7934,15861,48548
2022-11-24 22:00:00,2022-11-24 23:00:00,71,0,4,6336,7337,13748,45285
2022-11-24 23:00:00,2022-11-25 00:00:00,70,0,4,8387,6755,15216,43500
2022-11-25 00:00:00,2022-11-25 01:00:00,70,0,4,8292,6375,14741,42084
2022-11-25 01:00:00,2022-11-25 02:00:00,68,0,4,7094,5586,12752,41085
2022-11-25 02:00:00,2022-11-25 03:00:00,69,0,4,6685,5139,11897,40756
2022-11-25 03:00:00,2022-11-25 04:00:00,68,0,4,7610,5040,12722,41291
2022-11-25 04:00:00,2022-11-25 05:00:00,68,0,4,7240,5238,12550,43507
2022-11-25 05:00:00,2022-11-25 06:00:00,68,0,4,7233,5698,13003,48052
2022-11-25 06:00:00,2022-11-25 07:00:00,66,0,4,7488,5649,13207,54838
2022-11-25 07:00:00,2022-11-25 08:00:00,64,0,23,6455,6162,12704,57129
2022-11-25 08:00:00,2022-11-25 09:00:00,70,0,164,6051,5998,12283,53654
2022-11-25 09:00:00,2022-11-25 10:00:00,71,0,379,5636,5378,11464,49468
2022-11-25 10:00:00,2022-11-25 11:00:00,72,0,497,4944,4572,10085,47429
2022-11-25 11:00:00,2022-11-25 12:00:00,72,0,486,4210,4294,9062,46969
2022-11-25 12:00:00,2022-11-25 13:00:00,71,0,321,3437,2998,6827,49001
2022-11-25 13:00:00,2022-11-25 14:00:00,72,0,226,2790,2232,5320,52355
2022-11-25 14:00:00,2022-11-25 15:00:00,72,0,51,2793,2125,5041,55965
2022-11-25 15:00:00,2022-11-25 16:00:00,72,0,4,2975,2074,5125,59480
2022-11-25 16:00:00,2022-11-25 17:00:00,76,0,4,3608,2680,6368,61253
2022-11-25 17:00:00,2022-11-25 18:00:00,76,0,4,3680,3199,6959,58444
2022-11-25 18:00:00,2022-11-25 19:00:00,76,0,4,3039,3237,6356,56612
2022-11-25 19:00:00,2022-11-25 20:00:00,76,0,4,2972,2732,5784,53817
2022-11-25 20:00:00,2022-11-25 21:00:00,76,0,4,3371,2373,5824,50338
2022-11-25 21:00:00,2022-11-25 22:00:00,79,0,4,2881,2854,5818,47616
2022-11-25 22:00:00,2022-11-25 23:00:00,78,0,4,2223,2432,4737,45496
2022-11-25 23:00:00,2022-11-26 00:00:00,75,0,4,2007,2110,4196,43418
2022-11-26 00:00:00,2022-11-26 01:00:00,79,0,4,1826,1987,3896,41407
2022-11-26 01:00:00,2022-11-26 02:00:00,80,0,4,1948,2036,4068,40204
2022-11-26 02:00:00,2022-11-26 03:00:00,80,0,4,2184,2743,5011,40079
2022-11-26 03:00:00,2022-11-26 04:00:00,80,0,4,1963,3026,5073,39789
2022-11-26 04:00:00,2022-11-26 05:00:00,80,0,4,2060,3565,5709,40096
2022-11-26 05:00:00,2022-11-26 06:00:00,80,0,4,2073,3830,5987,41935
2022-11-26 06:00:00,2022-11-26 07:00:00,77,0,4,2338,4021,6440,45357
2022-11-26 07:00:00,2022-11-26 08:00:00,76,0,35,2207,3991,6309,47855
2022-11-26 08:00:00,2022-11-26 09:00:00,79,0,150,2457,4104,6790,48187
2022-11-26 09:00:00,2022-11-26 10:00:00,80,0,205,2764,3824,6873,47536
2022-11-26 10:00:00,2022-11-26 11:00:00,80,0,215,3326,3241,6862,45777
2022-11-26 11:00:00,2022-11-26 12:00:00,80,0,246,3719,3012,7057,44387
2022-11-26 12:00:00,2022-11-26 13:00:00,80,0,204,3744,2705,6733,44908
2022-11-26 13:00:00,2022-11-26 14:00:00,77,0,123,4051,2760,7011,45190
2022-11-26 14:00:00,2022-11-26 15:00:00,75,0,56,4702,3104,7937,48369
2022-11-26 15:00:00,2022-11-26 16:00:00,78,0,6,5774,3837,9695,53378
2022-11-26 16:00:00,2022-11-26 17:00:00,76,0,4,6538,4729,11347,56412
2022-11-26 17:00:00,2022-11-26 18:00:00,51,0,4,6780,5439,12274,54620
2022-11-26 18:00:00,2022-11-26 19:00:00,56,0,4,7486,5923,13469,52653
2022-11-26 19:00:00,2022-11-26 20:00:00,77,0,4,7988,6345,14414,50310
2022-11-26 20:00:00,2022-11-26 21:00:00,80,0,4,8556,5926,14566,48254
2022-11-26 21:00:00,2022-11-26 22:00:00,80,0,4,8577,6184,14845,45821
2022-11-26 22:00:00,2022-11-26 23:00:00,66,0,4,8722,6693,15485,43691
2022-11-26 23:00:00,2022-11-27 00:00:00,60,0,4,8903,7046,16013,41948
2022-11-27 00:00:00,2022-11-27 01:00:00,62,0,4,8923,7222,16211,40669
2022-11-27 01:00:00,2022-11-27 02:00:00,68,0,4,8950,7607,16629,39649
2022-11-27 02:00:00,2022-11-27 03:00:00,68,0,4,8935,7602,16609,38948
2022-11-27 03:00:00,2022-11-27 04:00:00,68,0,4,8946,7408,16426,38692
2022-11-27 04:00:00,2022-11-27 05:00:00,68,0,4,8975,7568,16615,39269
2022-11-27 05:00:00,2022-11-27 06:00:00,68,0,4,8982,7469,16523,40174
2022-11-27 06:00:00,2022-11-27 07:00:00,68,0,4,8953,7090,16115,42489
2022-11-27 07:00:00,2022-11-27 08:00:00,70,0,19,8870,6999,15958,45296
2022-11-27 08:00:00,2022-11-27 09:00:00,68,0,65,8439,6335,14907,47867
2022-11-27 09:00:00,2022-11-27 10:00:00,69,0,59,7941,6193,14262,48491
2022-11-27 10:00:00,2022-11-27 11:00:00,69,0,75,7337,6091,13572,49320
2022-11-27 11:00:00,2022-11-27 12:00:00,68,0,92,6486,5597,12243,49788
2022-11-27 12:00:00,2022-11-27 13:00:00,69,0,89,6107,5005,11270,50060
2022-11-27 13:00:00,2022-11-27 14:00:00,68,0,44,5156,4687,9955,50367
2022-11-27 14:00:00,2022-11-27 15:00:00,64,0,10,4913,4549,9536,51078
2022-11-27 15:00:00,2022-11-27 16:00:00,60,0,4,4753,4350,9167,54024
2022-11-27 16:00:00,2022-11-27 17:00:00,64,0,4,4452,4490,9010,56236
2022-11-27 17:00:00,2022-11-27 18:00:00,64,0,4,4173,4085,8326,54567
2022-11-27 18:00:00,2022-11-27 19:00:00,64,0,4,3929,3779,7776,53193
2022-11-27 19:00:00,2022-11-27 20:00:00,64,0,4,3393,3498,6959,51148
2022-11-27 20:00:00,2022-11-27 21:00:00,64,0,4,2584,3372,6024,48709
2022-11-27 21:00:00,2022-11-27 22:00:00,64,0,4,2238,3564,5870,45857
2022-11-27 22:00:00,2022-11-27 23:00:00,64,0,4,2108,3596,5772,43607
2022-11-27 23:00:00,2022-11-28 00:00:00,60,0,4,2217,3383,5664,41332
2022-11-28 00:00:00,2022-11-28 01:00:00,63,0,4,1800,3476,5343,40182
2022-11-28 01:00:00,2022-11-28 02:00:00,62,0,4,1853,3273,5192,39460
2022-11-28 02:00:00,2022-11-28 03:00:00,60,0,4,1875,3087,5026,39388
2022-11-28 03:00:00,2022-11-28 04:00:00,60,0,4,1903,3041,5008,39991
2022-11-28 04:00:00,2022-11-28 05:00:00,60,0,4,1478,2982,4524,42366
2022-11-28 05:00:00,2022-11-28 06:00:00,60,0,4,1006,3124,4194,48254
2022-11-28 06:00:00,2022-11-28 07:00:00,59,0,4,1186,2803,4052,55864
2022-11-28 07:00:00,2022-11-28 08:00:00,65,0,6,1348,2294,3713,59640
2022-11-28 08:00:00,2022-11-28 09:00:00,67,0,26,803,1788,2684,60302
2022-11-28 09:00:00,2022-11-28 10:00:00,64,0,64,435,1495,2058,59854
2022-11-28 10:00:00,2022-11-28 11:00:00,64,0,80,311,1175,1630,59560
2022-11-28 11:00:00,2022-11-28 12:00:00,64,0,97,231,755,1147,59254
2022-11-28 12:00:00,2022-11-28 13:00:00,65,0,81,232,697,1075,59124
2022-11-28 13:00:00,2022-11-28 14:00:00,64,0,61,296,644,1065,59305
2022-11-28 14:00:00,2022-11-28 15:00:00,64,0,19,354,628,1065,60840
2022-11-28 15:00:00,2022-11-28 16:00:00,60,0,4,300,456,820,63758
2022-11-28 16:00:00,2022-11-28 17:00:00,63,0,4,293,494,854,65476
2022-11-28 17:00:00,2022-11-28 18:00:00,62,0,4,461,600,1127,62347
2022-11-28 18:00:00,2022-11-28 19:00:00,64,0,4,776,608,1452,59864
2022-11-28 19:00:00,2022-11-28 20:00:00,63,0,4,830,680,1577,57002
2022-11-28 20:00:00,2022-11-28 21:00:00,61,0,4,646,599,1310,53691
2022-11-28 21:00:00,2022-11-28 22:00:00,61,0,4,498,463,1026,50046
2022-11-28 22:00:00,2022-11-28 23:00:00,62,0,4,407,426,899,46616
2022-11-28 23:00:00,2022-11-29 00:00:00,60,0,4,396,411,871,44536
2022-11-29 00:00:00,2022-11-29 01:00:00,64,0,4,386,405,859,42917
2022-11-29 01:00:00,2022-11-29 02:00:00,64,0,4,438,365,871,42403
2022-11-29 02:00:00,2022-11-29 03:00:00,64,0,4,400,342,810,42179
2022-11-29 03:00:00,2022-11-29 04:00:00,64,0,4,225,292,585,42298
2022-11-29 04:00:00,2022-11-29 05:00:00,64,0,4,235,304,607,44121
2022-11-29 05:00:00,2022-11-29 06:00:00,64,0,4,281,427,776,49764
2022-11-29 06:00:00,2022-11-29 07:00:00,60,0,4,327,501,892,56640
2022-11-29 07:00:00,2022-11-29 08:00:00,62,0,15,384,526,987,60375
2022-11-29 08:00:00,2022-11-29 09:00:00,63,0,65,534,691,1353,60539
2022-11-29 09:00:00,2022-11-29 10:00:00,64,0,110,657,722,1553,58528
2022-11-29 10:00:00,2022-11-29 11:00:00,64,0,125,693,846,1728,56946
2022-11-29 11:00:00,2022-11-29 12:00:00,65,0,128,495,1103,1791,55787
2022-11-29 12:00:00,2022-11-29 13:00:00,60,0,98,473,1518,2149,56420
2022-11-29 13:00:00,2022-11-29 14:00:00,64,0,60,521,1957,2602,57570
2022-11-29 14:00:00,2022-11-29 15:00:00,64,0,15,454,1725,2258,59915
2022-11-29 15:00:00,2022-11-29 16:00:00,64,0,4,392,1156,1616,62719
2022-11-29 16:00:00,2022-11-29 17:00:00,64,0,4,253,773,1094,64488
2022-11-29 17:00:00,2022-11-29 18:00:00,62,0,4,241,573,880,61824
2022-11-29 18:00:00,2022-11-29 19:00:00,62,0,4,232,499,797,59398
2022-11-29 19:00:00,2022-11-29 20:00:00,64,0,4,207,414,689,56575
2022-11-29 20:00:00,2022-11-29 21:00:00,65,0,4,175,382,626,53756
2022-11-29 21:00:00,2022-11-29 22:00:00,66,0,4,122,371,563,50540
2022-11-29 22:00:00,2022-11-29 23:00:00,59,0,4,219,325,607,47408
2022-11-29 23:00:00,2022-11-30 00:00:00,60,0,4,158,325,547,44582
2022-11-30 00:00:00,2022-11-30 01:00:00,64,0,4,174,306,548,42600
2022-11-30 01:00:00,2022-11-30 02:00:00,65,0,4,143,294,506,41921
2022-11-30 02:00:00,2022-11-30 03:00:00,64,0,4,176,287,531,41854
2022-11-30 03:00:00,2022-11-30 04:00:00,64,0,4,348,294,710,42185
2022-11-30 04:00:00,2022-11-30 05:00:00,64,0,4,300,331,699,44372
2022-11-30 05:00:00,2022-11-30 06:00:00,64,0,4,287,333,688,49704
2022-11-30 06:00:00,2022-11-30 07:00:00,62,0,4,302,364,732,56612
2022-11-30 07:00:00,2022-11-30 08:00:00,62,0,6,435,367,870,60531
2022-11-30 08:00:00,2022-11-30 09:00:00,64,0,50,403,381,898,60097
2022-11-30 09:00:00,2022-11-30 10:00:00,64,0,124,254,440,882,58063
2022-11-30 10:00:00,2022-11-30 11:00:00,64,0,132,228,400,824,55830
2022-11-30 11:00:00,2022-11-30 12:00:00,64,0,122,217,406,809,54137
2022-11-30 12:00:00,2022-11-30 13:00:00,63,0,97,275,456,891,55056
2022-11-30 13:00:00,2022-11-30 14:00:00,63,0,73,489,500,1125,57845
2022-11-30 14:00:00,2022-11-30 15:00:00,59,0,19,469,487,1034,60716
2022-11-30 15:00:00,2022-11-30 16:00:00,62,0,4,423,472,961,64082
2022-11-30 16:00:00,2022-11-30 17:00:00,67,0,4,1020,515,1606,66096
2022-11-30 17:00:00,2022-11-30 18:00:00,64,0,4,810,721,1599,62941
2022-11-30 18:00:00,2022-11-30 19:00:00,64,0,4,655,932,1655,60578
2022-11-30 19:00:00,2022-11-30 20:00:00,64,0,4,685,962,1715,57679
2022-11-30 20:00:00,2022-11-30 21:00:00,64,0,4,762,1052,1882,54727
2022-11-30 21:00:00,2022-11-30 22:00:00,64,0,4,808,1158,2034,51362
2022-11-30 22:00:00,2022-11-30 23:00:00,63,0,4,967,1104,2138,48197
2022-11-30 23:00:00,2022-12-01 00:00:00,64,0,4,1300,1016,2384,45064
2022-12-01 00:00:00,2022-12-01 01:00:00,64,0,4,1050,913,2031,43044
2022-12-01 01:00:00,2022-12-01 02:00:00,64,0,4,1240,995,2303,42218
2022-12-01 02:00:00,2022-12-01 03:00:00,64,0,4,1567,926,2561,42260
2022-12-01 03:00:00,2022-12-01 04:00:00,64,0,4,1341,859,2268,42616
2022-12-01 04:00:00,2022-12-01 05:00:00,65,0,4,1732,841,2642,44903
2022-12-01 05:00:00,2022-12-01 06:00:00,65,0,4,1648,894,2611,50382
2022-12-01 06:00:00,2022-12-01 07:00:00,65,0,4,1515,943,2527,57161
2022-12-01 07:00:00,2022-12-01 08:00:00,64,0,13,1239,915,2231,60553
2022-12-01 08:00:00,2022-12-01 09:00:00,65,0,71,1017,862,2015,59429
2022-12-01 09:00:00,2022-12-01 10:00:00,64,0,148,964,749,1925,56369
2022-12-01 10:00:00,2022-12-01 11:00:00,66,0,187,746,612,1611,53615
2022-12-01 11:00:00,2022-12-01 12:00:00,64,0,203,599,538,1404,52311
2022-12-01 12:00:00,2022-12-01 13:00:00,64,0,156,561,556,1337,53414
2022-12-01 13:00:00,2022-12-01 14:00:00,62,0,87,641,659,1449,55632
2022-12-01 14:00:00,2022-12-01 15:00:00,61,0,24,679,756,1520,59435
2022-12-01 15:00:00,2022-12-01 16:00:00,64,0,5,1447,824,2340,63413
2022-12-01 16:00:00,2022-12-01 17:00:00,66,0,4,1731,895,2696,65541
2022-12-01 17:00:00,2022-12-01 18:00:00,64,0,4,1261,1037,2366,62862
2022-12-01 18:00:00,2022-12-01 19:00:00,65,0,4,1152,1049,2270,60356
2022-12-01 19:00:00,2022-12-01 20:00:00,64,0,4,921,1105,2094,57857
2022-12-01 20:00:00,2022-12-01 21:00:00,72,0,4,1144,1176,2396,54713
2022-12-01 21:00:00,2022-12-01 22:00:00,91,0,4,668,1063,1826,50756
2022-12-01 22:00:00,2022-12-01 23:00:00,90,0,4,832,985,1911,47841
2022-12-01 23:00:00,2022-12-02 00:00:00,84,0,4,547,956,1591,45215
2022-12-02 00:00:00,2022-12-02 01:00:00,82,0,4,463,1224,1773,43241
2022-12-02 01:00:00,2022-12-02 02:00:00,80,0,4,408,1452,1944,42005
2022-12-02 02:00:00,2022-12-02 03:00:00,80,0,4,1108,1386,2578,41432
2022-12-02 03:00:00,2022-12-02 04:00:00,80,0,4,2261,1688,4033,41844
2022-12-02 04:00:00,2022-12-02 05:00:00,80,0,4,2710,2130,4924,44021
2022-12-02 05:00:00,2022-12-02 06:00:00,80,0,4,3485,2686,6255,49455
2022-12-02 06:00:00,2022-12-02 07:00:00,77,0,4,4543,2443,7067,56555
2022-12-02 07:00:00,2022-12-02 08:00:00,80,0,5,5275,2613,7973,60759
2022-12-02 08:00:00,2022-12-02 09:00:00,80,0,43,6078,2982,9183,61754
2022-12-02 09:00:00,2022-12-02 10:00:00,80,0,100,7174,4141,11495,60890
2022-12-02 10:00:00,2022-12-02 11:00:00,80,0,104,7658,4142,11984,60241
2022-12-02 11:00:00,2022-12-02 12:00:00,80,0,93,6794,3696,10663,59607
2022-12-02 12:00:00,2022-12-02 13:00:00,80,0,64,6916,4374,11434,60406
2022-12-02 13:00:00,2022-12-02 14:00:00,80,0,28,8280,4515,12903,61529
2022-12-02 14:00:00,2022-12-02 15:00:00,79,0,18,8466,4774,13337,62662
2022-12-02 15:00:00,2022-12-02 16:00:00,79,0,4,8585,5016,13684,64574
2022-12-02 16:00:00,2022-12-02 17:00:00,82,0,4,8808,5470,14364,65682
2022-12-02 17:00:00,2022-12-02 18:00:00,84,0,4,7946,5535,13569,62797
2022-12-02 18:00:00,2022-12-02 19:00:00,84,0,4,8518,6243,14849,59591
2022-12-02 19:00:00,2022-12-02 20:00:00,84,0,4,8752,6070,14910,56939
2022-12-02 20:00:00,2022-12-02 21:00:00,84,0,4,7966,6079,14133,53707
2022-12-02 21:00:00,2022-12-02 22:00:00,84,0,4,8094,5415,13597,50276
2022-12-02 22:00:00,2022-12-02 23:00:00,80,0,4,8352,5215,13651,47569
2022-12-02 23:00:00,2022-12-03 00:00:00,76,0,4,8678,4833,13591,44962
2022-12-03 00:00:00,2022-12-03 01:00:00,74,0,4,8620,4694,13392,42597
2022-12-03 01:00:00,2022-12-03 02:00:00,72,0,4,8551,4529,13156,41337
2022-12-03 02:00:00,2022-12-03 03:00:00,73,0,4,8363,4662,13102,41017
2022-12-03 03:00:00,2022-12-03 04:00:00,73,0,4,7870,4952,12899,40857
2022-12-03 04:00:00,2022-12-03 05:00:00,74,0,4,8281,4718,13077,41358
2022-12-03 05:00:00,2022-12-03 06:00:00,76,0,4,8433,4477,12990,43774
2022-12-03 06:00:00,2022-12-03 07:00:00,71,0,4,7724,5017,12816,47734
2022-12-03 07:00:00,2022-12-03 08:00:00,68,0,7,6521,4865,11461,51310
2022-12-03 08:00:00,2022-12-03 09:00:00,75,0,64,6288,4599,11026,53600
2022-12-03 09:00:00,2022-12-03 10:00:00,76,0,148,5894,4112,10230,54420
2022-12-03 10:00:00,2022-12-03 11:00:00,76,0,183,5618,3704,9581,54695
2022-12-03 11:00:00,2022-12-03 12:00:00,70,0,282,4926,3346,8624,54593
2022-12-03 12:00:00,2022-12-03 13:00:00,70,0,243,4187,3342,7842,54625
2022-12-03 13:00:00,2022-12-03 14:00:00,73,0,75,4020,3260,7428,55036
2022-12-03 14:00:00,2022-12-03 15:00:00,73,0,14,4307,3644,8038,56029
2022-12-03 15:00:00,2022-12-03 16:00:00,72,0,4,4559,3946,8581,57690
2022-12-03 16:00:00,2022-12-03 17:00:00,75,0,4,4976,4125,9180,58660
2022-12-03 17:00:00,2022-12-03 18:00:00,75,0,4,5113,3800,8992,57904
2022-12-03 18:00:00,2022-12-03 19:00:00,76,0,4,5250,3752,9082,55788
2022-12-03 19:00:00,2022-12-03 20:00:00,74,0,4,5519,4049,9646,53602
2022-12-03 20:00:00,2022-12-03 21:00:00,74,0,4,5416,4289,9783,51283
2022-12-03 21:00:00,2022-12-03 22:00:00,72,0,4,5254,3750,9080,48805
2022-12-03 22:00:00,2022-12-03 23:00:00,68,0,4,4814,3518,8404,46100
2022-12-03 23:00:00,2022-12-04 00:00:00,73,0,4,4112,3015,7204,43619
2022-12-04 00:00:00,2022-12-04 01:00:00,75,0,4,3843,2721,6643,41621
2022-12-04 01:00:00,2022-12-04 02:00:00,75,0,4,4372,2524,6975,40867
2022-12-04 02:00:00,2022-12-04 03:00:00,63,0,4,4614,2765,7446,40463
2022-12-04 03:00:00,2022-12-04 04:00:00,72,0,4,4491,2827,7394,40381
2022-12-04 04:00:00,2022-12-04 05:00:00,57,0,4,4889,3085,8035,40737
2022-12-04 05:00:00,2022-12-04 06:00:00,56,0,4,4647,3303,8010,41717
2022-12-04 06:00:00,2022-12-04 07:00:00,56,0,4,5147,3396,8603,44120
2022-12-04 07:00:00,2022-12-04 08:00:00,59,0,4,5934,3706,9703,47400
2022-12-04 08:00:00,2022-12-04 09:00:00,67,0,14,6683,3882,10646,50557
2022-12-04 09:00:00,2022-12-04 10:00:00,68,0,50,5748,3567,9433,51747
2022-12-04 10:00:00,2022-12-04 11:00:00,71,0,86,4972,3825,8954,52787
2022-12-04 11:00:00,2022-12-04 12:00:00,70,0,72,4624,3908,8674,54149
2022-12-04 12:00:00,2022-12-04 13:00:00,70,0,52,4708,4408,9238,54328
2022-12-04 13:00:00,2022-12-04 14:00:00,69,0,26,4848,4767,9710,54412
2022-12-04 14:00:00,2022-12-04 15:00:00,72,0,6,5272,5048,10398,54857
2022-12-04 15:00:00,2022-12-04 16:00:00,71,0,4,5505,5376,10956,57084
2022-12-04 16:00:00,2022-12-04 17:00:00,72,0,4,5406,5054,10536,58900
2022-12-04 17:00:00,2022-12-04 18:00:00,72,0,4,5310,4939,10325,57501
2022-12-04 18:00:00,2022-12-04 19:00:00,72,0,4,5302,5267,10645,55899
2022-12-04 19:00:00,2022-12-04 20:00:00,72,0,4,5376,4767,10219,53880
2022-12-04 20:00:00,2022-12-04 21:00:00,73,0,4,5364,4533,9974,51512
2022-12-04 21:00:00,2022-12-04 22:00:00,72,0,4,5392,4461,9929,48569
2022-12-04 22:00:00,2022-12-04 23:00:00,68,0,4,5483,4111,9666,45562
2022-12-04 23:00:00,2022-12-05 00:00:00,65,0,4,5580,3804,9453,43142
2022-12-05 00:00:00,2022-12-05 01:00:00,58,0,4,6055,4006,10123,41637
2022-12-05 01:00:00,2022-12-05 02:00:00,63,0,4,5990,4277,10334,41134
2022-12-05 02:00:00,2022-12-05 03:00:00,71,0,4,6078,3898,10051,41040
2022-12-05 03:00:00,2022-12-05 04:00:00,76,0,4,5862,3829,9771,41344
2022-12-05 04:00:00,2022-12-05 05:00:00,76,0,4,6261,4112,10453,44330
2022-12-05 05:00:00,2022-12-05 06:00:00,74,0,4,6432,4146,10656,50108
2022-12-05 06:00:00,2022-12-05 07:00:00,69,0,4,6226,4105,10404,56851
2022-12-05 07:00:00,2022-12-05 08:00:00,69,0,4,6394,4019,10486,61673
2022-12-05 08:00:00,2022-12-05 09:00:00,72,0,13,5772,3323,9180,63227
2022-12-05 09:00:00,2022-12-05 10:00:00,72,0,26,5587,3094,8779,63150
2022-12-05 10:00:00,2022-12-05 11:00:00,72,0,32,5303,2693,8100,62842
2022-12-05 11:00:00,2022-12-05 12:00:00,72,0,45,4525,2513,7155,62197
2022-12-05 12:00:00,2022-12-05 13:00:00,72,0,31,4793,2138,7034,62357
2022-12-05 13:00:00,2022-12-05 14:00:00,72,0,16,4544,2252,6884,62177
2022-12-05 14:00:00,2022-12-05 15:00:00,70,0,7,4173,2232,6482,62682
2022-12-05 15:00:00,2022-12-05 16:00:00,68,0,4,4352,2238,6662,64656
2022-12-05 16:00:00,2022-12-05 17:00:00,72,0,4,4336,2504,6916,65673
2022-12-05 17:00:00,2022-12-05 18:00:00,72,0,4,4230,2376,6682,62719
2022-12-05 18:00:00,2022-12-05 19:00:00,72,0,4,4423,2295,6794,60075
2022-12-05 19:00:00,2022-12-05 20:00:00,72,0,4,3827,2108,6011,57206
2022-12-05 20:00:00,2022-12-05 21:00:00,72,0,4,3503,2139,5718,54398
2022-12-05 21:00:00,2022-12-05 22:00:00,72,0,4,3318,2144,5538,50607
2022-12-05 22:00:00,2022-12-05 23:00:00,71,0,4,3136,1614,4825,47356
2022-12-05 23:00:00,2022-12-06 00:00:00,70,0,4,2960,1456,4490,44342
2022-12-06 00:00:00,2022-12-06 01:00:00,71,0,4,3042,1796,4913,42632
2022-12-06 01:00:00,2022-12-06 02:00:00,74,0,4,2989,1623,4690,41915
2022-12-06 02:00:00,2022-12-06 03:00:00,73,0,4,3315,1572,4964,41530
2022-12-06 03:00:00,2022-12-06 04:00:00,72,0,4,2622,1254,3952,41828
2022-12-06 04:00:00,2022-12-06 05:00:00,72,0,4,2701,1074,3851,44124
2022-12-06 05:00:00,2022-12-06 06:00:00,72,0,4,3291,1065,4432,50117
2022-12-06 06:00:00,2022-12-06 07:00:00,72,0,4,2430,748,3254,57747
2022-12-06 07:00:00,2022-12-06 08:00:00,72,0,19,2765,442,3298,61202
2022-12-06 08:00:00,2022-12-06 09:00:00,75,0,164,1302,448,1989,59405
2022-12-06 09:00:00,2022-12-06 10:00:00,73,0,288,753,500,1614,55145
2022-12-06 10:00:00,2022-12-06 11:00:00,72,0,409,600,598,1679,52946
2022-12-06 11:00:00,2022-12-06 12:00:00,72,0,347,848,856,2123,52743
2022-12-06 12:00:00,2022-12-06 13:00:00,76,0,324,1145,1040,2585,54523
2022-12-06 13:00:00,2022-12-06 14:00:00,79,0,181,1895,1240,3395,57014
2022-12-06 14:00:00,2022-12-06 15:00:00,78,0,31,2401,1704,4214,60181
2022-12-06 15:00:00,2022-12-06 16:00:00,72,0,5,4718,1818,6613,63786
2022-12-06 16:00:00,2022-12-06 17:00:00,74,0,4,4989,2291,7358,65559
2022-12-06 17:00:00,2022-12-06 18:00:00,80,0,4,5190,2141,7415,62703
2022-12-06 18:00:00,2022-12-06 19:00:00,80,0,4,5480,2027,7591,60696
2022-12-06 19:00:00,2022-12-06 20:00:00,79,0,4,5691,2051,7825,57902
2022-12-06 20:00:00,2022-12-06 21:00:00,80,0,4,5619,2057,7760,54568
2022-12-06 21:00:00,2022-12-06 22:00:00,79,0,4,5872,1856,7811,50345
2022-12-06 22:00:00,2022-12-06 23:00:00,78,0,4,5638,2378,8098,47306
2022-12-06 23:00:00,2022-12-07 00:00:00,76,0,4,6028,2880,8988,44802
2022-12-07 00:00:00,2022-12-07 01:00:00,80,0,4,5907,2823,8814,42710
2022-12-07 01:00:00,2022-12-07 02:00:00,76,0,4,6203,3035,9318,41941
2022-12-07 02:00:00,2022-12-07 03:00:00,78,0,4,6188,3082,9352,41627
2022-12-07 03:00:00,2022-12-07 04:00:00,80,0,4,6017,3405,9506,42163
2022-12-07 04:00:00,2022-12-07 05:00:00,79,0,4,5742,3481,9306,44635
2022-12-07 05:00:00,2022-12-07 06:00:00,80,0,4,6393,2890,9367,50223
2022-12-07 06:00:00,2022-12-07 07:00:00,76,0,4,6160,2489,8729,57558
2022-12-07 07:00:00,2022-12-07 08:00:00,77,0,21,5822,2204,8124,60730
2022-12-07 08:00:00,2022-12-07 09:00:00,80,0,126,4884,1774,6864,59164
2022-12-07 09:00:00,2022-12-07 10:00:00,80,0,300,4780,1932,7092,56002
2022-12-07 10:00:00,2022-12-07 11:00:00,80,0,331,4221,1469,6101,54138
2022-12-07 11:00:00,2022-12-07 12:00:00,79,0,263,5165,1429,6936,54096
2022-12-07 12:00:00,2022-12-07 13:00:00,80,0,251,4170,1605,6106,55774
2022-12-07 13:00:00,2022-12-07 14:00:00,79,0,115,4652,1977,6823,57683
2022-12-07 14:00:00,2022-12-07 15:00:00,78,0,27,5037,1711,6853,60590
2022-12-07 15:00:00,2022-12-07 16:00:00,78,0,4,4110,2215,6407,64326
2022-12-07 16:00:00,2022-12-07 17:00:00,71,0,4,4418,1962,6455,66191
2022-12-07 17:00:00,2022-12-07 18:00:00,70,0,4,5114,1667,6855,63902
2022-12-07 18:00:00,2022-12-07 19:00:00,72,0,4,5511,2373,7960,61329
2022-12-07 19:00:00,2022-12-07 20:00:00,69,0,4,5548,2916,8537,58566
2022-12-07 20:00:00,2022-12-07 21:00:00,71,0,4,5679,2345,8099,55335
2022-12-07 21:00:00,2022-12-07 22:00:00,70,0,4,5396,2450,7920,51536
2022-12-07 22:00:00,2022-12-07 23:00:00,67,0,4,5708,2976,8755,48159
2022-12-07 23:00:00,2022-12-08 00:00:00,63,0,4,5156,2731,7954,44679
2022-12-08 00:00:00,2022-12-08 01:00:00,65,0,4,5175,3356,8600,43227
2022-12-08 01:00:00,2022-12-08 02:00:00,69,0,4,6035,3372,9480,42476
2022-12-08 02:00:00,2022-12-08 03:00:00,68,0,4,5980,3067,9119,42100
2022-12-08 03:00:00,2022-12-08 04:00:00,68,0,4,5713,2622,8407,42376
2022-12-08 04:00:00,2022-12-08 05:00:00,68,0,4,4946,2808,7826,44641
2022-12-08 05:00:00,2022-12-08 06:00:00,68,0,4,4121,2187,6380,50283
2022-12-08 06:00:00,2022-12-08 07:00:00,66,0,4,4209,1734,6013,58171
2022-12-08 07:00:00,2022-12-08 08:00:00,65,0,8,3384,1540,4997,61855
2022-12-08 08:00:00,2022-12-08 09:00:00,72,0,55,2593,1181,3901,62309
2022-12-08 09:00:00,2022-12-08 10:00:00,72,0,135,3158,1174,4539,60567
2022-12-08 10:00:00,2022-12-08 11:00:00,70,0,342,2700,1387,4499,59892
2022-12-08 11:00:00,2022-12-08 12:00:00,72,0,379,3379,1104,4934,58886
2022-12-08 12:00:00,2022-12-08 13:00:00,71,0,317,3608,1186,5182,58339
2022-12-08 13:00:00,2022-12-08 14:00:00,68,0,166,3535,1184,4953,59622
2022-12-08 14:00:00,2022-12-08 15:00:00,69,0,44,3690,1262,5065,62281
2022-12-08 15:00:00,2022-12-08 16:00:00,76,0,3,4303,1173,5555,65717
2022-12-08 16:00:00,2022-12-08 17:00:00,77,0,4,3043,914,4038,67649
2022-12-08 17:00:00,2022-12-08 18:00:00,76,0,4,2141,748,2969,64885
2022-12-08 18:00:00,2022-12-08 19:00:00,76,0,4,1912,934,2926,62587
2022-12-08 19:00:00,2022-12-08 20:00:00,76,0,4,1775,819,2674,59734
2022-12-08 20:00:00,2022-12-08 21:00:00,76,0,4,1586,663,2329,56711
2022-12-08 21:00:00,2022-12-08 22:00:00,76,0,4,1767,558,2405,52801
2022-12-08 22:00:00,2022-12-08 23:00:00,76,0,4,1752,512,2344,49520
2022-12-08 23:00:00,2022-12-09 00:00:00,72,0,4,1665,516,2257,46734
2022-12-09 00:00:00,2022-12-09 01:00:00,76,0,4,1813,455,2348,44993
2022-12-09 01:00:00,2022-12-09 02:00:00,76,0,4,1853,555,2488,43911
2022-12-09 02:00:00,2022-12-09 03:00:00,76,0,4,1475,757,2312,43671
2022-12-09 03:00:00,2022-12-09 04:00:00,75,0,4,1319,802,2200,43945
2022-12-09 04:00:00,2022-12-09 05:00:00,75,0,4,757,823,1659,45813
2022-12-09 05:00:00,2022-12-09 06:00:00,76,0,4,723,867,1670,51372
2022-12-09 06:00:00,2022-12-09 07:00:00,69,0,4,852,861,1786,58344
2022-12-09 07:00:00,2022-12-09 08:00:00,71,0,21,645,837,1574,62549
2022-12-09 08:00:00,2022-12-09 09:00:00,75,0,142,516,896,1629,62574
2022-12-09 09:00:00,2022-12-09 10:00:00,78,0,231,403,828,1540,59820
2022-12-09 10:00:00,2022-12-09 11:00:00,79,0,262,460,768,1569,57882
2022-12-09 11:00:00,2022-12-09 12:00:00,76,0,237,680,619,1612,57595
2022-12-09 12:00:00,2022-12-09 13:00:00,78,0,189,1880,535,2682,59005
2022-12-09 13:00:00,2022-12-09 14:00:00,76,0,126,769,500,1471,60012
2022-12-09 14:00:00,2022-12-09 15:00:00,79,0,40,438,436,993,61910
2022-12-09 15:00:00,2022-12-09 16:00:00,77,0,3,664,469,1213,65421
2022-12-09 16:00:00,2022-12-09 17:00:00,76,0,4,877,737,1694,67186
2022-12-09 17:00:00,2022-12-09 18:00:00,76,0,4,1259,1032,2371,63870
2022-12-09 18:00:00,2022-12-09 19:00:00,77,0,4,1606,1053,2740,60942
2022-12-09 19:00:00,2022-12-09 20:00:00,77,0,4,1454,1274,2809,57235
2022-12-09 20:00:00,2022-12-09 21:00:00,78,0,4,2156,1420,3658,54227
2022-12-09 21:00:00,2022-12-09 22:00:00,76,0,4,2238,1555,3873,51580
2022-12-09 22:00:00,2022-12-09 23:00:00,73,0,4,1626,1333,3036,49704
2022-12-09 23:00:00,2022-12-10 00:00:00,75,0,4,1560,1155,2794,47032
2022-12-10 00:00:00,2022-12-10 01:00:00,76,0,4,1383,1065,2528,44742
2022-12-10 01:00:00,2022-12-10 02:00:00,76,0,4,1015,995,2090,43627
2022-12-10 02:00:00,2022-12-10 03:00:00,79,0,4,1007,846,1936,43287
2022-12-10 03:00:00,2022-12-10 04:00:00,80,0,4,1330,759,2173,43212
2022-12-10 04:00:00,2022-12-10 05:00:00,80,0,4,1458,647,2189,43787
2022-12-10 05:00:00,2022-12-10 06:00:00,78,0,4,1216,562,1860,45605
2022-12-10 06:00:00,2022-12-10 07:00:00,76,0,4,1248,573,1901,49260
2022-12-10 07:00:00,2022-12-10 08:00:00,79,0,8,1330,504,1921,53248
2022-12-10 08:00:00,2022-12-10 09:00:00,80,0,69,1414,540,2103,55715
2022-12-10 09:00:00,2022-12-10 10:00:00,80,0,133,1212,598,2023,56135
2022-12-10 10:00:00,2022-12-10 11:00:00,80,0,175,1271,682,2208,56197
2022-12-10 11:00:00,2022-12-10 12:00:00,80,0,194,1239,584,2097,56331
2022-12-10 12:00:00,2022-12-10 13:00:00,80,0,103,1063,450,1696,56173
2022-12-10 13:00:00,2022-12-10 14:00:00,78,0,68,1189,452,1787,56528
2022-12-10 14:00:00,2022-12-10 15:00:00,79,0,16,1055,520,1670,57442
2022-12-10 15:00:00,2022-12-10 16:00:00,85,0,4,678,610,1377,59565
2022-12-10 16:00:00,2022-12-10 17:00:00,97,0,4,546,606,1253,61054
2022-12-10 17:00:00,2022-12-10 18:00:00,129,0,4,602,758,1493,59638
2022-12-10 18:00:00,2022-12-10 19:00:00,128,0,4,417,749,1298,57362
2022-12-10 19:00:00,2022-12-10 20:00:00,128,0,4,396,765,1293,55169
2022-12-10 20:00:00,2022-12-10 21:00:00,128,0,4,958,694,1784,52615
2022-12-10 21:00:00,2022-12-10 22:00:00,128,0,4,2265,743,3140,50087
2022-12-10 22:00:00,2022-12-10 23:00:00,128,0,4,2862,708,3702,47283
2022-12-10 23:00:00,2022-12-11 00:00:00,128,0,4,2192,786,3110,44850
2022-12-11 00:00:00,2022-12-11 01:00:00,129,0,4,1010,926,2069,42921
2022-12-11 01:00:00,2022-12-11 02:00:00,128,0,4,415,765,1312,41777
2022-12-11 02:00:00,2022-12-11 03:00:00,128,0,4,1050,616,1798,41467
2022-12-11 03:00:00,2022-12-11 04:00:00,128,0,4,1122,580,1834,41449
2022-12-11 04:00:00,2022-12-11 05:00:00,128,0,4,965,572,1669,41571
2022-12-11 05:00:00,2022-12-11 06:00:00,128,0,4,1671,506,2309,42662
2022-12-11 06:00:00,2022-12-11 07:00:00,125,0,4,1880,545,2554,45033
2022-12-11 07:00:00,2022-12-11 08:00:00,125,0,4,2085,692,2906,48077
2022-12-11 08:00:00,2022-12-11 09:00:00,117,0,19,1869,797,2802,50535
2022-12-11 09:00:00,2022-12-11 10:00:00,100,0,48,1888,864,2900,51562
2022-12-11 10:00:00,2022-12-11 11:00:00,100,0,74,1906,925,3005,52052
2022-12-11 11:00:00,2022-12-11 12:00:00,100,0,72,1865,933,2970,52562
2022-12-11 12:00:00,2022-12-11 13:00:00,100,0,63,1602,706,2471,52912
2022-12-11 13:00:00,2022-12-11 14:00:00,100,0,38,1177,620,1935,53319
2022-12-11 14:00:00,2022-12-11 15:00:00,97,0,6,814,519,1436,54618
2022-12-11 15:00:00,2022-12-11 16:00:00,97,0,4,787,548,1436,57504
2022-12-11 16:00:00,2022-12-11 17:00:00,100,0,4,1134,563,1801,60236
2022-12-11 17:00:00,2022-12-11 18:00:00,100,0,4,1346,556,2006,58808
2022-12-11 18:00:00,2022-12-11 19:00:00,100,0,4,1685,523,2312,57023
2022-12-11 19:00:00,2022-12-11 20:00:00,100,0,4,1821,603,2528,55044
2022-12-11 20:00:00,2022-12-11 21:00:00,101,0,4,1486,636,2227,52652
2022-12-11 21:00:00,2022-12-11 22:00:00,100,0,4,1079,662,1845,49724
2022-12-11 22:00:00,2022-12-11 23:00:00,96,0,4,803,608,1511,46445
2022-12-11 23:00:00,2022-12-12 00:00:00,99,0,4,774,552,1429,44508
2022-12-12 00:00:00,2022-12-12 01:00:00,100,0,4,706,524,1334,43175
2022-12-12 01:00:00,2022-12-12 02:00:00,101,0,4,910,481,1496,42511
2022-12-12 02:00:00,2022-12-12 03:00:00,100,0,4,1045,433,1582,42463
2022-12-12 03:00:00,2022-12-12 04:00:00,100,0,4,1036,402,1542,43238
2022-12-12 04:00:00,2022-12-12 05:00:00,100,0,4,893,423,1420,45915
2022-12-12 05:00:00,2022-12-12 06:00:00,100,0,4,814,485,1403,51659
2022-12-12 06:00:00,2022-12-12 07:00:00,100,0,4,697,447,1248,59367
2022-12-12 07:00:00,2022-12-12 08:00:00,101,0,11,724,315,1151,63748
2022-12-12 08:00:00,2022-12-12 09:00:00,100,0,85,910,360,1455,62380
2022-12-12 09:00:00,2022-12-12 10:00:00,101,0,195,832,379,1507,57926
2022-12-12 10:00:00,2022-12-12 11:00:00,100,0,295,828,415,1638,53923
2022-12-12 11:00:00,2022-12-12 12:00:00,100,0,322,669,411,1502,51826
2022-12-12 12:00:00,2022-12-12 13:00:00,100,0,298,986,334,1718,53230
2022-12-12 13:00:00,2022-12-12 14:00:00,98,0,167,984,275,1524,56349
2022-12-12 14:00:00,2022-12-12 15:00:00,97,0,46,1116,246,1505,61801
2022-12-12 15:00:00,2022-12-12 16:00:00,99,0,4,1315,221,1639,67228
2022-12-12 16:00:00,2022-12-12 17:00:00,102,0,4,1836,309,2251,69937
2022-12-12 17:00:00,2022-12-12 18:00:00,101,0,4,2234,464,2803,67244
2022-12-12 18:00:00,2022-12-12 19:00:00,103,0,4,2012,462,2581,64640
2022-12-12 19:00:00,2022-12-12 20:00:00,102,0,4,1811,524,2441,61605
2022-12-12 20:00:00,2022-12-12 21:00:00,100,0,4,1531,580,2215,58264
2022-12-12 21:00:00,2022-12-12 22:00:00,100,0,4,1466,656,2226,54481
2022-12-12 22:00:00,2022-12-12 23:00:00,96,0,4,1632,727,2459,51072
2022-12-12 23:00:00,2022-12-13 00:00:00,97,0,4,1642,707,2450,48158
2022-12-13 00:00:00,2022-12-13 01:00:00,100,0,4,1609,692,2405,46214
2022-12-13 01:00:00,2022-12-13 02:00:00,101,0,4,1287,648,2040,45404
2022-12-13 02:00:00,2022-12-13 03:00:00,100,0,4,1289,516,1909,45267
2022-12-13 03:00:00,2022-12-13 04:00:00,100,0,4,1065,438,1607,45651
2022-12-13 04:00:00,2022-12-13 05:00:00,100,0,4,966,539,1609,47788
2022-12-13 05:00:00,2022-12-13 06:00:00,101,0,4,1086,605,1796,53643
2022-12-13 06:00:00,2022-12-13 07:00:00,100,0,4,1002,706,1812,61196
2022-12-13 07:00:00,2022-12-13 08:00:00,100,0,15,1112,700,1927,65142
2022-12-13 08:00:00,2022-12-13 09:00:00,99,0,122,1310,656,2187,63748
2022-12-13 09:00:00,2022-12-13 10:00:00,96,0,267,2024,624,3011,59291
2022-12-13 10:00:00,2022-12-13 11:00:00,99,0,417,2120,532,3168,56345
2022-12-13 11:00:00,2022-12-13 12:00:00,99,0,468,1477,434,2478,55434
2022-12-13 12:00:00,2022-12-13 13:00:00,100,0,369,1278,409,2156,57423
2022-12-13 13:00:00,2022-12-13 14:00:00,98,0,195,1454,501,2248,61369
2022-12-13 14:00:00,2022-12-13 15:00:00,92,0,33,1894,729,2748,64996
2022-12-13 15:00:00,2022-12-13 16:00:00,95,0,4,2303,931,3333,68390
2022-12-13 16:00:00,2022-12-13 17:00:00,97,0,4,2822,1018,3941,70480
2022-12-13 17:00:00,2022-12-13 18:00:00,97,0,4,3936,1322,5359,67556
2022-12-13 18:00:00,2022-12-13 19:00:00,96,0,4,3706,1695,5501,65014
2022-12-13 19:00:00,2022-12-13 20:00:00,97,0,4,3473,1863,5437,61777
2022-12-13 20:00:00,2022-12-13 21:00:00,100,0,4,3255,1928,5287,58385
2022-12-13 21:00:00,2022-12-13 22:00:00,100,0,4,3025,1613,4742,54427
2022-12-13 22:00:00,2022-12-13 23:00:00,95,0,4,2332,1407,3838,50804
2022-12-13 23:00:00,2022-12-14 00:00:00,93,0,4,1860,1247,3204,47823
2022-12-14 00:00:00,2022-12-14 01:00:00,96,0,4,1451,1247,2798,45691
2022-12-14 01:00:00,2022-12-14 02:00:00,96,0,4,1207,1354,2661,45051
2022-12-14 02:00:00,2022-12-14 03:00:00,96,0,4,903,1440,2443,44895
2022-12-14 03:00:00,2022-12-14 04:00:00,98,0,4,745,1168,2015,45364
2022-12-14 04:00:00,2022-12-14 05:00:00,87,0,4,370,844,1305,47721
2022-12-14 05:00:00,2022-12-14 06:00:00,88,0,4,405,592,1089,53381
2022-12-14 06:00:00,2022-12-14 07:00:00,87,0,4,619,420,1130,61023
2022-12-14 07:00:00,2022-12-14 08:00:00,86,0,7,836,278,1207,65808
2022-12-14 08:00:00,2022-12-14 09:00:00,88,0,119,1092,268,1567,64655
2022-12-14 09:00:00,2022-12-14 10:00:00,75,0,297,1418,269,2059,58472
2022-12-14 10:00:00,2022-12-14 11:00:00,68,0,476,1340,239,2123,53953
2022-12-14 11:00:00,2022-12-14 12:00:00,65,0,527,1314,235,2141,51768
2022-12-14 12:00:00,2022-12-14 13:00:00,67,0,431,1310,235,2043,52933
2022-12-14 13:00:00,2022-12-14 14:00:00,80,0,242,1098,205,1625,56585
2022-12-14 14:00:00,2022-12-14 15:00:00,92,0,57,1426,161,1736,62996
2022-12-14 15:00:00,2022-12-14 16:00:00,96,0,3,1564,258,1921,68229
2022-12-14 16:00:00,2022-12-14 17:00:00,82,0,4,1066,468,1620,70641
2022-12-14 17:00:00,2022-12-14 18:00:00,80,0,4,1122,817,2023,67419
2022-12-14 18:00:00,2022-12-14 19:00:00,81,0,4,1830,831,2746,65169
2022-12-14 19:00:00,2022-12-14 20:00:00,80,0,4,1275,1179,2538,61874
2022-12-14 20:00:00,2022-12-14 21:00:00,80,0,4,2336,1207,3627,58867
2022-12-14 21:00:00,2022-12-14 22:00:00,80,0,4,2820,1025,3929,55319
2022-12-14 22:00:00,2022-12-14 23:00:00,77,0,4,3281,1212,4574,51610
2022-12-14 23:00:00,2022-12-15 00:00:00,83,0,4,2605,1018,3710,48182
2022-12-15 00:00:00,2022-12-15 01:00:00,84,0,4,2135,1027,3250,45864
2022-12-15 01:00:00,2022-12-15 02:00:00,84,0,4,2002,1218,3308,44853
2022-12-15 02:00:00,2022-12-15 03:00:00,84,0,4,2340,1334,3762,44685
2022-12-15 03:00:00,2022-12-15 04:00:00,84,0,4,2530,1317,3935,45043
2022-12-15 04:00:00,2022-12-15 05:00:00,84,0,4,2678,1832,4598,47185
2022-12-15 05:00:00,2022-12-15 06:00:00,83,0,4,2597,2710,5394,53305
2022-12-15 06:00:00,2022-12-15 07:00:00,77,0,4,2815,2788,5684,61050
2022-12-15 07:00:00,2022-12-15 08:00:00,76,0,10,3081,2862,6029,64890
2022-12-15 08:00:00,2022-12-15 09:00:00,81,0,102,2471,3088,5742,63207
2022-12-15 09:00:00,2022-12-15 10:00:00,83,0,235,2765,3144,6227,58024
2022-12-15 10:00:00,2022-12-15 11:00:00,84,0,378,2249,2935,5646,54332
2022-12-15 11:00:00,2022-12-15 12:00:00,84,0,473,1747,3217,5521,52283
2022-12-15 12:00:00,2022-12-15 13:00:00,81,0,390,1605,3476,5552,53521
2022-12-15 13:00:00,2022-12-15 14:00:00,80,0,223,1431,3074,4808,56432
2022-12-15 14:00:00,2022-12-15 15:00:00,80,0,52,1592,2942,4666,61440
2022-12-15 15:00:00,2022-12-15 16:00:00,80,0,4,1720,2536,4340,66232
2022-12-15 16:00:00,2022-12-15 17:00:00,80,0,4,2241,2132,4457,68595
2022-12-15 17:00:00,2022-12-15 18:00:00,81,0,4,3649,1782,5516,66496
2022-12-15 18:00:00,2022-12-15 19:00:00,80,0,4,4041,1637,5762,64276
2022-12-15 19:00:00,2022-12-15 20:00:00,80,0,4,4597,1727,6408,60973
2022-12-15 20:00:00,2022-12-15 21:00:00,80,0,4,7626,1702,9412,57542
2022-12-15 21:00:00,2022-12-15 22:00:00,81,0,4,7643,1668,9396,53568
2022-12-15 22:00:00,2022-12-15 23:00:00,77,0,4,7984,2150,10215,50134
2022-12-15 23:00:00,2022-12-16 00:00:00,81,0,4,7654,3981,11720,47317
2022-12-16 00:00:00,2022-12-16 01:00:00,83,0,4,5845,4855,10787,45203
2022-12-16 01:00:00,2022-12-16 02:00:00,84,0,4,5432,3770,9290,44028
2022-12-16 02:00:00,2022-12-16 03:00:00,84,0,4,4881,3069,8038,43541
2022-12-16 03:00:00,2022-12-16 04:00:00,84,0,4,4114,2661,6863,43806
2022-12-16 04:00:00,2022-12-16 05:00:00,84,0,4,3717,2002,5807,45974
2022-12-16 05:00:00,2022-12-16 06:00:00,84,0,4,2743,1306,4137,51379
2022-12-16 06:00:00,2022-12-16 07:00:00,80,0,4,2502,1194,3780,58904
2022-12-16 07:00:00,2022-12-16 08:00:00,80,0,4,1154,1498,2736,63588
2022-12-16 08:00:00,2022-12-16 09:00:00,80,0,25,873,1655,2633,63551
2022-12-16 09:00:00,2022-12-16 10:00:00,81,0,64,678,1348,2171,60671
2022-12-16 10:00:00,2022-12-16 11:00:00,80,0,98,328,1000,1506,58331
2022-12-16 11:00:00,2022-12-16 12:00:00,80,0,127,211,564,982,57065
2022-12-16 12:00:00,2022-12-16 13:00:00,81,0,125,125,323,654,57645
2022-12-16 13:00:00,2022-12-16 14:00:00,80,0,88,131,319,618,59384
2022-12-16 14:00:00,2022-12-16 15:00:00,80,0,28,114,231,453,62448
2022-12-16 15:00:00,2022-12-16 16:00:00,82,0,4,115,179,380,65794
2022-12-16 16:00:00,2022-12-16 17:00:00,84,0,4,125,138,351,67660
2022-12-16 17:00:00,2022-12-16 18:00:00,82,0,4,146,133,365,64756
2022-12-16 18:00:00,2022-12-16 19:00:00,82,0,4,240,156,482,62124
2022-12-16 19:00:00,2022-12-16 20:00:00,82,0,4,387,163,636,59341
2022-12-16 20:00:00,2022-12-16 21:00:00,81,0,4,813,212,1110,56367
2022-12-16 21:00:00,2022-12-16 22:00:00,84,0,4,1601,285,1974,53306
2022-12-16 22:00:00,2022-12-16 23:00:00,84,0,4,2107,385,2580,50425
2022-12-16 23:00:00,2022-12-17 00:00:00,82,0,4,2430,494,3010,47813
2022-12-17 00:00:00,2022-12-17 01:00:00,82,0,4,2691,667,3444,45868
2022-12-17 01:00:00,2022-12-17 02:00:00,83,0,4,2884,880,3851,44522
2022-12-17 02:00:00,2022-12-17 03:00:00,83,0,4,3694,1178,4959,43979
2022-12-17 03:00:00,2022-12-17 04:00:00,83,0,4,4140,1434,5661,43858
2022-12-17 04:00:00,2022-12-17 05:00:00,83,0,4,4536,1775,6398,44558
2022-12-17 05:00:00,2022-12-17 06:00:00,82,0,4,4935,2228,7249,46695
2022-12-17 06:00:00,2022-12-17 07:00:00,78,0,4,5584,2424,8090,50143
2022-12-17 07:00:00,2022-12-17 08:00:00,77,0,5,5316,2723,8121,54188
2022-12-17 08:00:00,2022-12-17 09:00:00,84,0,46,5586,2907,8623,56288
2022-12-17 09:00:00,2022-12-17 10:00:00,81,0,126,5815,3018,9040,54881
2022-12-17 10:00:00,2022-12-17 11:00:00,82,0,205,5540,2838,8665,53116
2022-12-17 11:00:00,2022-12-17 12:00:00,84,0,258,5215,2827,8384,51793
2022-12-17 12:00:00,2022-12-17 13:00:00,84,0,211,5301,2871,8467,51723
2022-12-17 13:00:00,2022-12-17 14:00:00,84,0,126,5373,2862,8445,53656
2022-12-17 14:00:00,2022-12-17 15:00:00,84,0,34,5147,2618,7883,56647
2022-12-17 15:00:00,2022-12-17 16:00:00,80,0,4,4876,2619,7579,60345
2022-12-17 16:00:00,2022-12-17 17:00:00,78,0,4,4635,2807,7524,62568
2022-12-17 17:00:00,2022-12-17 18:00:00,80,0,4,4634,2657,7375,61074
2022-12-17 18:00:00,2022-12-17 19:00:00,80,0,4,4605,2404,7093,59096
2022-12-17 19:00:00,2022-12-17 20:00:00,80,0,4,5114,2224,7422,56957
2022-12-17 20:00:00,2022-12-17 21:00:00,81,0,4,5409,1856,7350,54596
2022-12-17 21:00:00,2022-12-17 22:00:00,82,0,4,5415,1636,7137,51994
2022-12-17 22:00:00,2022-12-17 23:00:00,81,0,4,5214,1620,6919,49167
2022-12-17 23:00:00,2022-12-18 00:00:00,81,0,4,5111,1531,6727,46459
2022-12-18 00:00:00,2022-12-18 01:00:00,82,0,4,4969,1611,6666,44918
2022-12-18 01:00:00,2022-12-18 02:00:00,81,0,4,5194,1618,6897,44100
2022-12-18 02:00:00,2022-12-18 03:00:00,82,0,4,4874,1720,6680,43660
2022-12-18 03:00:00,2022-12-18 04:00:00,80,0,4,4325,1808,6217,43500
2022-12-18 04:00:00,2022-12-18 05:00:00,82,0,4,3710,1790,5586,43610
2022-12-18 05:00:00,2022-12-18 06:00:00,80,0,4,4203,1776,6063,45000
2022-12-18 06:00:00,2022-12-18 07:00:00,76,0,4,5324,2250,7654,47543
2022-12-18 07:00:00,2022-12-18 08:00:00,78,0,17,5297,2840,8232,50383
2022-12-18 08:00:00,2022-12-18 09:00:00,82,0,102,4952,3206,8342,50899
2022-12-18 09:00:00,2022-12-18 10:00:00,81,0,231,4823,3549,8684,50610
2022-12-18 10:00:00,2022-12-18 11:00:00,80,0,203,4454,3342,8079,51917
2022-12-18 11:00:00,2022-12-18 12:00:00,80,0,175,4940,3027,8222,53397
2022-12-18 12:00:00,2022-12-18 13:00:00,81,0,147,5223,2772,8223,54268
2022-12-18 13:00:00,2022-12-18 14:00:00,80,0,95,7055,3028,10258,55541
2022-12-18 14:00:00,2022-12-18 15:00:00,79,0,22,7883,3911,11895,57130
2022-12-18 15:00:00,2022-12-18 16:00:00,77,0,4,8400,4679,13160,60050
2022-12-18 16:00:00,2022-12-18 17:00:00,79,0,4,7913,5287,13283,61968
2022-12-18 17:00:00,2022-12-18 18:00:00,83,0,4,8778,4906,13771,60116
2022-12-18 18:00:00,2022-12-18 19:00:00,81,0,4,8988,4771,13844,58816
2022-12-18 19:00:00,2022-12-18 20:00:00,80,0,4,9368,5031,14483,56892
2022-12-18 20:00:00,2022-12-18 21:00:00,80,0,4,9553,4650,14287,54327
2022-12-18 21:00:00,2022-12-18 22:00:00,81,0,4,9571,4477,14133,50679
2022-12-18 22:00:00,2022-12-18 23:00:00,80,0,4,9573,4834,14491,47572
2022-12-18 23:00:00,2022-12-19 00:00:00,80,0,4,9571,5068,14723,44899
2022-12-19 00:00:00,2022-12-19 01:00:00,80,0,4,9567,5116,14767,43341
2022-12-19 01:00:00,2022-12-19 02:00:00,80,0,4,9563,5430,15077,42675
2022-12-19 02:00:00,2022-12-19 03:00:00,80,0,4,9554,5867,15505,42662
2022-12-19 03:00:00,2022-12-19 04:00:00,80,0,4,9560,6417,16061,43363
2022-12-19 04:00:00,2022-12-19 05:00:00,80,0,4,9556,6829,16469,45581
2022-12-19 05:00:00,2022-12-19 06:00:00,80,0,4,9554,7075,16713,50629
2022-12-19 06:00:00,2022-12-19 07:00:00,80,0,4,9524,7511,17119,57633
2022-12-19 07:00:00,2022-12-19 08:00:00,81,0,3,9554,7932,17570,61999
2022-12-19 08:00:00,2022-12-19 09:00:00,83,0,14,9543,8414,18054,63424
2022-12-19 09:00:00,2022-12-19 10:00:00,84,0,35,9542,8720,18381,62960
2022-12-19 10:00:00,2022-12-19 11:00:00,85,0,73,9554,8831,18543,62132
2022-12-19 11:00:00,2022-12-19 12:00:00,85,0,66,9560,8854,18565,60975
2022-12-19 12:00:00,2022-12-19 13:00:00,84,0,57,9522,8786,18449,60652
2022-12-19 13:00:00,2022-12-19 14:00:00,84,0,40,9493,8900,18517,60758
2022-12-19 14:00:00,2022-12-19 15:00:00,81,0,7,9531,8944,18563,61551
2022-12-19 15:00:00,2022-12-19 16:00:00,83,0,4,9493,9069,18649,64077
2022-12-19 16:00:00,2022-12-19 17:00:00,84,0,4,9493,9254,18835,65847
2022-12-19 17:00:00,2022-12-19 18:00:00,85,0,4,9482,9286,18857,62911
2022-12-19 18:00:00,2022-12-19 19:00:00,84,0,4,9499,9278,18865,60194
2022-12-19 19:00:00,2022-12-19 20:00:00,84,0,4,9499,9309,18896,57108
2022-12-19 20:00:00,2022-12-19 21:00:00,86,0,4,9475,9416,18981,54011
2022-12-19 21:00:00,2022-12-19 22:00:00,85,0,4,9385,9291,18765,50424
2022-12-19 22:00:00,2022-12-19 23:00:00,79,0,4,9389,8999,18471,47047
2022-12-19 23:00:00,2022-12-20 00:00:00,79,0,4,9406,9093,18582,44313
2022-12-20 00:00:00,2022-12-20 01:00:00,87,0,4,9406,9170,18667,42422
2022-12-20 01:00:00,2022-12-20 02:00:00,86,0,4,9490,9213,18793,41241
2022-12-20 02:00:00,2022-12-20 03:00:00,86,0,4,9457,9137,18684,40711
2022-12-20 03:00:00,2022-12-20 04:00:00,86,0,4,9356,9090,18536,41297
2022-12-20 04:00:00,2022-12-20 05:00:00,84,0,4,9389,9044,18521,43377
2022-12-20 05:00:00,2022-12-20 06:00:00,84,0,4,9474,8898,18460,48770
2022-12-20 06:00:00,2022-12-20 07:00:00,78,0,4,9494,8830,18406,55259
2022-12-20 07:00:00,2022-12-20 08:00:00,81,0,7,9488,9113,18689,59125
2022-12-20 08:00:00,2022-12-20 09:00:00,84,0,41,9473,9075,18673,60370
2022-12-20 09:00:00,2022-12-20 10:00:00,87,0,72,9488,9036,18683,60028
2022-12-20 10:00:00,2022-12-20 11:00:00,84,0,76,9395,8973,18528,60082
2022-12-20 11:00:00,2022-12-20 12:00:00,84,0,78,8607,8578,17347,60208
2022-12-20 12:00:00,2022-12-20 13:00:00,85,0,54,7480,7879,15498,60650
2022-12-20 13:00:00,2022-12-20 14:00:00,85,0,26,5367,7279,12757,60993
2022-12-20 14:00:00,2022-12-20 15:00:00,80,0,6,3351,6304,9741,61398
2022-12-20 15:00:00,2022-12-20 16:00:00,84,0,4,2048,4964,7100,63170
2022-12-20 16:00:00,2022-12-20 17:00:00,85,0,4,1578,4181,5848,64600
2022-12-20 17:00:00,2022-12-20 18:00:00,85,0,4,1279,3547,4915,62415
2022-12-20 18:00:00,2022-12-20 19:00:00,84,0,4,1214,2723,4025,59954
2022-12-20 19:00:00,2022-12-20 20:00:00,86,0,4,1307,1918,3315,57205
2022-12-20 20:00:00,2022-12-20 21:00:00,85,0,4,1091,1468,2648,54011
2022-12-20 21:00:00,2022-12-20 22:00:00,85,0,4,1175,1544,2808,50494
2022-12-20 22:00:00,2022-12-20 23:00:00,84,0,4,1219,1759,3066,47439
2022-12-20 23:00:00,2022-12-21 00:00:00,79,0,4,1002,2026,3111,45188
2022-12-21 00:00:00,2022-12-21 01:00:00,85,0,4,819,1730,2638,43239
2022-12-21 01:00:00,2022-12-21 02:00:00,86,0,4,689,1223,2002,42399
2022-12-21 02:00:00,2022-12-21 03:00:00,86,0,4,961,1143,2194,42036
2022-12-21 03:00:00,2022-12-21 04:00:00,86,0,4,1448,1275,2813,42258
2022-12-21 04:00:00,2022-12-21 05:00:00,86,0,4,1974,1503,3567,44186
2022-12-21 05:00:00,2022-12-21 06:00:00,84,0,4,2543,1927,4558,49132
2022-12-21 06:00:00,2022-12-21 07:00:00,80,0,4,3452,2499,6035,56058
2022-12-21 07:00:00,2022-12-21 08:00:00,89,0,5,4946,2865,7905,60106
2022-12-21 08:00:00,2022-12-21 09:00:00,99,0,48,6327,3838,10312,60012
2022-12-21 09:00:00,2022-12-21 10:00:00,99,0,134,7678,4378,12289,57815
2022-12-21 10:00:00,2022-12-21 11:00:00,98,0,231,8530,4909,13768,56110
2022-12-21 11:00:00,2022-12-21 12:00:00,98,0,365,8354,5933,14750,55781
2022-12-21 12:00:00,2022-12-21 13:00:00,99,0,259,8782,6385,15525,56849
2022-12-21 13:00:00,2022-12-21 14:00:00,97,0,136,8984,6391,15608,58249
2022-12-21 14:00:00,2022-12-21 15:00:00,90,0,31,6637,6543,13301,59856
2022-12-21 15:00:00,2022-12-21 16:00:00,106,0,4,6736,6366,13212,62554
2022-12-21 16:00:00,2022-12-21 17:00:00,108,0,4,7720,6532,14364,64319
2022-12-21 17:00:00,2022-12-21 18:00:00,108,0,4,8653,6483,15248,61671
2022-12-21 18:00:00,2022-12-21 19:00:00,104,0,4,7558,6197,13863,59143
2022-12-21 19:00:00,2022-12-21 20:00:00,104,0,4,6237,5430,11775,56429
2022-12-21 20:00:00,2022-12-21 21:00:00,104,0,4,5228,4591,9927,53339
2022-12-21 21:00:00,2022-12-21 22:00:00,104,0,4,4650,4399,9157,49969
2022-12-21 22:00:00,2022-12-21 23:00:00,100,0,4,4022,3821,7947,46836
2022-12-21 23:00:00,2022-12-22 00:00:00,103,0,4,2855,3092,6054,44811
2022-12-22 00:00:00,2022-12-22 01:00:00,104,0,4,2120,2416,4644,43385
2022-12-22 01:00:00,2022-12-22 02:00:00,104,0,4,1718,1633,3459,42447
2022-12-22 02:00:00,2022-12-22 03:00:00,104,0,4,1086,1136,2330,42079
2022-12-22 03:00:00,2022-12-22 04:00:00,104,0,4,1000,1017,2125,42509
2022-12-22 04:00:00,2022-12-22 05:00:00,108,0,4,1357,1081,2550,44649
2022-12-22 05:00:00,2022-12-22 06:00:00,107,0,4,1690,1168,2969,49271
2022-12-22 06:00:00,2022-12-22 07:00:00,103,0,4,2018,1616,3741,55582
2022-12-22 07:00:00,2022-12-22 08:00:00,104,0,8,2523,1863,4498,59339
2022-12-22 08:00:00,2022-12-22 09:00:00,111,0,95,2946,2549,5701,58750
2022-12-22 09:00:00,2022-12-22 10:00:00,110,0,142,3891,3091,7234,55166
2022-12-22 10:00:00,2022-12-22 11:00:00,105,0,285,4970,4135,9495,52122
2022-12-22 11:00:00,2022-12-22 12:00:00,104,0,446,4829,4952,10331,51560
2022-12-22 12:00:00,2022-12-22 13:00:00,104,0,336,5146,4744,10330,54155
2022-12-22 13:00:00,2022-12-22 14:00:00,109,0,216,6305,4842,11472,57272
2022-12-22 14:00:00,2022-12-22 15:00:00,108,0,57,6034,3729,9928,59807
2022-12-22 15:00:00,2022-12-22 16:00:00,113,0,6,6661,3502,10282,61937
2022-12-22 16:00:00,2022-12-22 17:00:00,118,0,8,4907,3888,8921,62710
2022-12-22 17:00:00,2022-12-22 18:00:00,120,0,8,5037,3897,9062,60336
2022-12-22 18:00:00,2022-12-22 19:00:00,117,0,8,5983,3636,9744,58590
2022-12-22 19:00:00,2022-12-22 20:00:00,116,0,8,5548,3244,8916,55931
2022-12-22 20:00:00,2022-12-22 21:00:00,119,0,8,4484,3349,7960,52969
2022-12-22 21:00:00,2022-12-22 22:00:00,116,0,8,3687,3219,7030,49506
2022-12-22 22:00:00,2022-12-22 23:00:00,114,0,8,3483,2954,6559,46498
2022-12-22 23:00:00,2022-12-23 00:00:00,165,0,8,3464,2576,6213,44283
2022-12-23 00:00:00,2022-12-23 01:00:00,180,0,8,2794,2690,5672,42402
2022-12-23 01:00:00,2022-12-23 02:00:00,180,0,8,2386,2128,4702,41232
2022-12-23 02:00:00,2022-12-23 03:00:00,180,0,8,1452,1525,3165,41044
2022-12-23 03:00:00,2022-12-23 04:00:00,180,0,8,999,927,2114,41658
2022-12-23 04:00:00,2022-12-23 05:00:00,180,0,8,674,706,1568,43627
2022-12-23 05:00:00,2022-12-23 06:00:00,180,0,8,464,673,1325,47918
2022-12-23 06:00:00,2022-12-23 07:00:00,180,0,8,303,708,1199,53746
2022-12-23 07:00:00,2022-12-23 08:00:00,180,0,6,125,524,835,57985
2022-12-23 08:00:00,2022-12-23 09:00:00,180,0,47,231,512,970,59723
2022-12-23 09:00:00,2022-12-23 10:00:00,180,0,115,383,839,1517,59117
2022-12-23 10:00:00,2022-12-23 11:00:00,180,0,124,805,873,1982,59103
2022-12-23 11:00:00,2022-12-23 12:00:00,180,0,90,1456,1320,3046,59182
2022-12-23 12:00:00,2022-12-23 13:00:00,180,0,65,2375,1597,4217,59076
2022-12-23 13:00:00,2022-12-23 14:00:00,180,0,22,2544,1835,4581,58439
2022-12-23 14:00:00,2022-12-23 15:00:00,176,0,5,5816,2646,8643,58317
2022-12-23 15:00:00,2022-12-23 16:00:00,135,0,4,5914,3235,9288,59924
2022-12-23 16:00:00,2022-12-23 17:00:00,8,0,4,6269,3360,9641,61411
2022-12-23 17:00:00,2022-12-23 18:00:00,8,0,4,7641,3518,11171,58977
2022-12-23 18:00:00,2022-12-23 19:00:00,8,0,4,8086,4226,12324,56338
2022-12-23 19:00:00,2022-12-23 20:00:00,12,0,4,8400,4937,13353,53751
2022-12-23 20:00:00,2022-12-23 21:00:00,12,0,4,8547,5392,13955,50738
2022-12-23 21:00:00,2022-12-23 22:00:00,12,0,4,8381,6148,14545,47797
2022-12-23 22:00:00,2022-12-23 23:00:00,12,0,4,8009,6619,14644,44971
2022-12-23 23:00:00,2022-12-24 00:00:00,12,0,4,8028,6843,14887,42376
2022-12-24 00:00:00,2022-12-24 01:00:00,12,0,4,7774,7737,15527,40656
2022-12-24 01:00:00,2022-12-24 02:00:00,53,0,4,7309,7854,15220,39822
2022-12-24 02:00:00,2022-12-24 03:00:00,166,0,4,7429,7535,15134,39318
2022-12-24 03:00:00,2022-12-24 04:00:00,176,0,4,7480,7062,14722,39188
2022-12-24 04:00:00,2022-12-24 05:00:00,176,0,4,7126,6819,14125,39684
2022-12-24 05:00:00,2022-12-24 06:00:00,177,0,4,6899,6998,14078,41287
2022-12-24 06:00:00,2022-12-24 07:00:00,179,0,4,6264,7074,13521,44320
2022-12-24 07:00:00,2022-12-24 08:00:00,178,0,5,6426,6870,13479,47100
2022-12-24 08:00:00,2022-12-24 09:00:00,180,0,35,6253,7105,13573,49358
2022-12-24 09:00:00,2022-12-24 10:00:00,180,0,111,4914,6633,11838,48900
2022-12-24 10:00:00,2022-12-24 11:00:00,180,0,193,3120,5851,9344,47426
2022-12-24 11:00:00,2022-12-24 12:00:00,180,0,182,3010,5405,8777,47070
2022-12-24 12:00:00,2022-12-24 13:00:00,180,0,184,3263,5111,8738,46620
2022-12-24 13:00:00,2022-12-24 14:00:00,179,0,122,2883,4508,7692,46380
2022-12-24 14:00:00,2022-12-24 15:00:00,173,0,30,3055,4223,7481,48651
2022-12-24 15:00:00,2022-12-24 16:00:00,177,0,5,3384,3405,6971,52893
2022-12-24 16:00:00,2022-12-24 17:00:00,180,0,4,2461,3477,6122,55325
2022-12-24 17:00:00,2022-12-24 18:00:00,180,0,4,2901,3614,6699,53608
2022-12-24 18:00:00,2022-12-24 19:00:00,180,0,4,3461,4041,7686,51001
2022-12-24 19:00:00,2022-12-24 20:00:00,180,0,4,3543,4676,8403,48750
2022-12-24 20:00:00,2022-12-24 21:00:00,180,0,4,5216,4881,10281,46844
2022-12-24 21:00:00,2022-12-24 22:00:00,179,0,4,5739,5293,11215,44939
2022-12-24 22:00:00,2022-12-24 23:00:00,176,0,4,4478,5562,10220,42894
2022-12-24 23:00:00,2022-12-25 00:00:00,179,0,4,5025,5460,10668,40896
2022-12-25 00:00:00,2022-12-25 01:00:00,180,0,4,5287,5058,10529,39144
2022-12-25 01:00:00,2022-12-25 02:00:00,180,0,4,5482,4979,10645,38104
2022-12-25 02:00:00,2022-12-25 03:00:00,180,0,4,5477,4648,10309,37507
2022-12-25 03:00:00,2022-12-25 04:00:00,180,0,4,5796,4546,10526,37328
2022-12-25 04:00:00,2022-12-25 05:00:00,180,0,4,5899,4896,10979,37762
2022-12-25 05:00:00,2022-12-25 06:00:00,180,0,4,4970,4355,9509,38791
2022-12-25 06:00:00,2022-12-25 07:00:00,179,0,4,3902,3465,7550,40758
2022-12-25 07:00:00,2022-12-25 08:00:00,180,0,7,3738,3083,7008,43730
2022-12-25 08:00:00,2022-12-25 09:00:00,180,0,25,4342,3545,8092,47051
2022-12-25 09:00:00,2022-12-25 10:00:00,180,0,54,4126,3207,7567,47637
2022-12-25 10:00:00,2022-12-25 11:00:00,180,0,85,3722,3098,7085,48013
2022-12-25 11:00:00,2022-12-25 12:00:00,180,0,127,3205,2327,5839,47939
2022-12-25 12:00:00,2022-12-25 13:00:00,180,0,63,2492,1434,4169,47892
2022-12-25 13:00:00,2022-12-25 14:00:00,180,0,24,1956,1640,3800,47617
2022-12-25 14:00:00,2022-12-25 15:00:00,177,0,7,1925,1996,4105,48573
2022-12-25 15:00:00,2022-12-25 16:00:00,180,0,8,1784,1285,3257,49687
2022-12-25 16:00:00,2022-12-25 17:00:00,180,0,8,1812,572,2572,51940
2022-12-25 17:00:00,2022-12-25 18:00:00,180,0,8,1452,530,2170,50956
2022-12-25 18:00:00,2022-12-25 19:00:00,180,0,8,1742,708,2638,48815
2022-12-25 19:00:00,2022-12-25 20:00:00,180,0,8,2514,888,3590,47316
2022-12-25 20:00:00,2022-12-25 21:00:00,180,0,8,2983,1097,4268,45706
2022-12-25 21:00:00,2022-12-25 22:00:00,179,0,8,3345,1445,4977,44103
2022-12-25 22:00:00,2022-12-25 23:00:00,176,0,8,4157,1973,6314,42258
2022-12-25 23:00:00,2022-12-26 00:00:00,180,0,8,4098,2625,6911,40061
2022-12-26 00:00:00,2022-12-26 01:00:00,180,0,8,6364,3915,10467,38723
2022-12-26 01:00:00,2022-12-26 02:00:00,180,0,8,7789,5369,13346,37979
2022-12-26 02:00:00,2022-12-26 03:00:00,180,0,8,9029,6033,15250,37432
2022-12-26 03:00:00,2022-12-26 04:00:00,180,0,8,9329,7066,16583,37100
2022-12-26 04:00:00,2022-12-26 05:00:00,180,0,8,9493,7785,17466,37732
2022-12-26 05:00:00,2022-12-26 06:00:00,180,0,8,9400,8247,17835,39238
2022-12-26 06:00:00,2022-12-26 07:00:00,180,0,8,9360,8313,17861,41211
2022-12-26 07:00:00,2022-12-26 08:00:00,180,0,8,9444,8641,18273,43948
2022-12-26 08:00:00,2022-12-26 09:00:00,180,0,69,9207,8533,17989,46316
2022-12-26 09:00:00,2022-12-26 10:00:00,180,0,56,8448,8273,16957,47296
2022-12-26 10:00:00,2022-12-26 11:00:00,180,0,216,6847,6690,13933,45749
2022-12-26 11:00:00,2022-12-26 12:00:00,180,0,201,6233,5510,12124,44206
2022-12-26 12:00:00,2022-12-26 13:00:00,180,0,208,6338,5264,11990,43390
2022-12-26 13:00:00,2022-12-26 14:00:00,180,0,226,6961,5313,12680,43955
2022-12-26 14:00:00,2022-12-26 15:00:00,180,0,59,6408,4675,11322,45685
2022-12-26 15:00:00,2022-12-26 16:00:00,180,0,4,7114,4877,12175,50176
2022-12-26 16:00:00,2022-12-26 17:00:00,180,0,4,8789,5390,14363,53613
2022-12-26 17:00:00,2022-12-26 18:00:00,180,0,4,9478,5880,15542,52555
2022-12-26 18:00:00,2022-12-26 19:00:00,180,0,4,9511,6590,16285,50659
2022-12-26 19:00:00,2022-12-26 20:00:00,180,0,4,9495,6733,16412,49178
2022-12-26 20:00:00,2022-12-26 21:00:00,180,0,4,9457,6555,16196,47550
2022-12-26 21:00:00,2022-12-26 22:00:00,179,0,4,9291,6811,16285,45648
2022-12-26 22:00:00,2022-12-26 23:00:00,178,0,4,8731,7035,15948,43774
2022-12-26 23:00:00,2022-12-27 00:00:00,180,0,4,9134,7138,16456,41658
2022-12-27 00:00:00,2022-12-27 01:00:00,180,0,4,9004,7141,16329,39856
2022-12-27 01:00:00,2022-12-27 02:00:00,180,0,4,8967,6827,15978,38947
2022-12-27 02:00:00,2022-12-27 03:00:00,180,0,4,8395,6424,15003,38597
2022-12-27 03:00:00,2022-12-27 04:00:00,180,0,4,8254,6122,14560,39037
2022-12-27 04:00:00,2022-12-27 05:00:00,180,0,4,6941,5690,12815,40693
2022-12-27 05:00:00,2022-12-27 06:00:00,180,0,4,6183,5657,12024,44066
2022-12-27 06:00:00,2022-12-27 07:00:00,180,0,4,5135,5275,10594,48256
2022-12-27 07:00:00,2022-12-27 08:00:00,180,0,8,4546,5163,9897,51836
2022-12-27 08:00:00,2022-12-27 09:00:00,180,0,99,4622,4807,9708,51839
2022-12-27 09:00:00,2022-12-27 10:00:00,180,0,243,5059,4685,10167,49152
2022-12-27 10:00:00,2022-12-27 11:00:00,180,0,396,5111,4946,10633,48108
2022-12-27 11:00:00,2022-12-27 12:00:00,180,0,355,5682,4708,10925,48661
2022-12-27 12:00:00,2022-12-27 13:00:00,180,0,250,6642,4546,11618,50007
2022-12-27 13:00:00,2022-12-27 14:00:00,180,0,171,8288,4940,13579,52189
2022-12-27 14:00:00,2022-12-27 15:00:00,180,0,45,9116,5181,14522,54162
2022-12-27 15:00:00,2022-12-27 16:00:00,180,0,4,9433,5919,15536,58049
2022-12-27 16:00:00,2022-12-27 17:00:00,180,0,4,9723,6833,16740,60772
2022-12-27 17:00:00,2022-12-27 18:00:00,180,0,4,9655,7895,17734,58165
2022-12-27 18:00:00,2022-12-27 19:00:00,180,0,4,9751,8562,18497,55529
2022-12-27 19:00:00,2022-12-27 20:00:00,180,0,4,9731,8696,18611,52774
2022-12-27 20:00:00,2022-12-27 21:00:00,180,0,4,9545,8759,18488,50200
2022-12-27 21:00:00,2022-12-27 22:00:00,179,0,4,9471,9035,18689,47287
2022-12-27 22:00:00,2022-12-27 23:00:00,176,0,4,9570,8599,18349,44810
2022-12-27 23:00:00,2022-12-28 00:00:00,180,0,4,9427,8349,17960,42536
2022-12-28 00:00:00,2022-12-28 01:00:00,180,0,4,9146,8213,17543,40643
2022-12-28 01:00:00,2022-12-28 02:00:00,180,0,4,9096,8373,17653,39593
2022-12-28 02:00:00,2022-12-28 03:00:00,180,0,4,8972,8437,17593,39204
2022-12-28 03:00:00,2022-12-28 04:00:00,180,0,4,9160,8367,17711,39478
2022-12-28 04:00:00,2022-12-28 05:00:00,180,0,4,9416,8546,18146,41120
2022-12-28 05:00:00,2022-12-28 06:00:00,180,0,4,9240,8332,17756,44725
2022-12-28 06:00:00,2022-12-28 07:00:00,177,0,4,9319,8589,18089,48904
2022-12-28 07:00:00,2022-12-28 08:00:00,180,0,4,9393,8844,18421,52290
2022-12-28 08:00:00,2022-12-28 09:00:00,180,0,21,9457,8913,18571,54132
2022-12-28 09:00:00,2022-12-28 10:00:00,180,0,51,9158,8777,18166,54798
2022-12-28 10:00:00,2022-12-28 11:00:00,180,0,81,9116,8753,18130,54873
2022-12-28 11:00:00,2022-12-28 12:00:00,180,0,102,9323,8719,18324,54955
2022-12-28 12:00:00,2022-12-28 13:00:00,180,0,75,9463,8836,18554,55453
2022-12-28 13:00:00,2022-12-28 14:00:00,180,0,42,9550,8775,18547,55341
2022-12-28 14:00:00,2022-12-28 15:00:00,180,0,10,9648,9062,18900,54895
2022-12-28 15:00:00,2022-12-28 16:00:00,180,0,4,9642,9165,18991,57444
2022-12-28 16:00:00,2022-12-28 17:00:00,180,0,4,9663,9268,19115,59623
2022-12-28 17:00:00,2022-12-28 18:00:00,180,0,4,9649,9334,19167,57416
2022-12-28 18:00:00,2022-12-28 19:00:00,180,0,4,9643,9412,19239,55006
2022-12-28 19:00:00,2022-12-28 20:00:00,180,0,4,9632,9337,19153,52209
2022-12-28 20:00:00,2022-12-28 21:00:00,180,0,4,9644,9211,19039,49725
2022-12-28 21:00:00,2022-12-28 22:00:00,180,0,4,9560,8894,18638,46955
2022-12-28 22:00:00,2022-12-28 23:00:00,180,0,4,8987,8395,17566,44336
2022-12-28 23:00:00,2022-12-29 00:00:00,180,0,4,6115,7980,14279,40922
2022-12-29 00:00:00,2022-12-29 01:00:00,180,0,4,6283,7728,14195,39566
2022-12-29 01:00:00,2022-12-29 02:00:00,180,0,4,6703,7699,14586,38937
2022-12-29 02:00:00,2022-12-29 03:00:00,180,0,4,6719,7777,14680,38593
2022-12-29 03:00:00,2022-12-29 04:00:00,180,0,4,6708,7454,14346,38967
2022-12-29 04:00:00,2022-12-29 05:00:00,180,0,4,6542,7574,14300,40610
2022-12-29 05:00:00,2022-12-29 06:00:00,180,0,4,6947,7851,14982,44468
2022-12-29 06:00:00,2022-12-29 07:00:00,180,0,4,9541,8426,18151,48948
2022-12-29 07:00:00,2022-12-29 08:00:00,180,0,5,9543,8946,18674,52593
2022-12-29 08:00:00,2022-12-29 09:00:00,180,0,67,9636,8898,18781,53190
2022-12-29 09:00:00,2022-12-29 10:00:00,180,0,99,9621,9120,19020,52649
2022-12-29 10:00:00,2022-12-29 11:00:00,180,0,91,9466,9046,18783,51304
2022-12-29 11:00:00,2022-12-29 12:00:00,180,0,213,9359,8588,18340,50294
2022-12-29 12:00:00,2022-12-29 13:00:00,180,0,219,9311,8621,18331,50851
2022-12-29 13:00:00,2022-12-29 14:00:00,180,0,139,9346,8834,18499,51627
2022-12-29 14:00:00,2022-12-29 15:00:00,180,0,33,9521,8546,18280,53295
2022-12-29 15:00:00,2022-12-29 16:00:00,180,0,7,9539,8618,18344,56644
2022-12-29 16:00:00,2022-12-29 17:00:00,180,0,8,9586,8847,18621,59119
2022-12-29 17:00:00,2022-12-29 18:00:00,180,0,8,9476,8916,18580,56836
2022-12-29 18:00:00,2022-12-29 19:00:00,180,0,8,9485,8922,18595,54765
2022-12-29 19:00:00,2022-12-29 20:00:00,180,0,8,9458,8633,18279,52290
2022-12-29 20:00:00,2022-12-29 21:00:00,180,0,8,9585,8640,18413,49653
2022-12-29 21:00:00,2022-12-29 22:00:00,180,0,8,9556,8548,18292,47337
2022-12-29 22:00:00,2022-12-29 23:00:00,180,0,8,8996,8072,17256,45005
2022-12-29 23:00:00,2022-12-30 00:00:00,180,0,8,8534,7303,16025,42694
2022-12-30 00:00:00,2022-12-30 01:00:00,180,0,8,7896,6791,14875,40904
2022-12-30 01:00:00,2022-12-30 02:00:00,180,0,8,7293,6716,14197,39836
2022-12-30 02:00:00,2022-12-30 03:00:00,180,0,8,7989,6495,14672,39028
2022-12-30 03:00:00,2022-12-30 04:00:00,180,0,8,8677,6594,15459,40029
2022-12-30 04:00:00,2022-12-30 05:00:00,180,0,8,8645,6645,15478,41775
2022-12-30 05:00:00,2022-12-30 06:00:00,180,0,8,8633,6835,15656,45152
2022-12-30 06:00:00,2022-12-30 07:00:00,176,0,8,9180,7059,16423,49202
2022-12-30 07:00:00,2022-12-30 08:00:00,178,0,12,9370,7621,17181,53048
2022-12-30 08:00:00,2022-12-30 09:00:00,180,0,84,9521,8285,18070,54416
2022-12-30 09:00:00,2022-12-30 10:00:00,180,0,155,9574,8511,18420,53694
2022-12-30 10:00:00,2022-12-30 11:00:00,180,0,234,9602,8900,18916,53595
2022-12-30 11:00:00,2022-12-30 12:00:00,180,0,183,9542,9051,18956,54132
2022-12-30 12:00:00,2022-12-30 13:00:00,180,0,118,9530,9104,18932,54507
2022-12-30 13:00:00,2022-12-30 14:00:00,180,0,60,9553,9318,19111,54700
2022-12-30 14:00:00,2022-12-30 15:00:00,179,0,16,9534,9198,18927,55256
2022-12-30 15:00:00,2022-12-30 16:00:00,180,0,8,9529,9160,18877,57090
2022-12-30 16:00:00,2022-12-30 17:00:00,180,0,8,9547,9275,19010,58772
2022-12-30 17:00:00,2022-12-30 18:00:00,180,0,8,9433,9180,18801,56394
2022-12-30 18:00:00,2022-12-30 19:00:00,180,0,8,9361,9233,18782,53963
2022-12-30 19:00:00,2022-12-30 20:00:00,180,0,8,9260,9064,18512,51460
2022-12-30 20:00:00,2022-12-30 21:00:00,180,0,8,9292,8596,18076,49046
2022-12-30 21:00:00,2022-12-30 22:00:00,180,0,8,9232,8491,17911,46475
2022-12-30 22:00:00,2022-12-30 23:00:00,180,0,8,9146,7854,17188,44192
2022-12-30 23:00:00,2022-12-31 00:00:00,180,0,8,8726,6877,15791,41998
2022-12-31 00:00:00,2022-12-31 01:00:00,180,0,8,8652,6486,15326,40329
2022-12-31 01:00:00,2022-12-31 02:00:00,180,0,8,8589,5726,14503,39444
2022-12-31 02:00:00,2022-12-31 03:00:00,180,0,8,7514,5008,12710,38899
2022-12-31 03:00:00,2022-12-31 04:00:00,180,0,8,7317,5098,12603,38906
2022-12-31 04:00:00,2022-12-31 05:00:00,180,0,8,8158,4894,13240,39604
2022-12-31 05:00:00,2022-12-31 06:00:00,178,0,8,7781,5734,13701,41280
2022-12-31 06:00:00,2022-12-31 07:00:00,176,0,8,7944,6337,14465,43602
2022-12-31 07:00:00,2022-12-31 08:00:00,179,0,8,8876,7330,16393,47041
2022-12-31 08:00:00,2022-12-31 09:00:00,180,0,14,8794,7705,16693,50297
2022-12-31 09:00:00,2022-12-31 10:00:00,180,0,85,8320,8222,16807,50554
2022-12-31 10:00:00,2022-12-31 11:00:00,180,0,83,8929,8309,17501,50950
2022-12-31 11:00:00,2022-12-31 12:00:00,180,0,71,8969,8831,18051,51581
2022-12-31 12:00:00,2022-12-31 13:00:00,180,0,92,8991,8809,18072,51206
2022-12-31 13:00:00,2022-12-31 14:00:00,180,0,20,8962,8947,18109,51029
2022-12-31 14:00:00,2022-12-31 15:00:00,179,0,11,8810,9180,18180,50595
2022-12-31 15:00:00,2022-12-31 16:00:00,180,0,8,9009,9148,18345,51304
2022-12-31 16:00:00,2022-12-31 17:00:00,180,0,8,9099,8754,18041,52281
2022-12-31 17:00:00,2022-12-31 18:00:00,180,0,8,9042,8439,17669,50816
2022-12-31 18:00:00,2022-12-31 19:00:00,180,0,8,9213,8526,17927,48440
2022-12-31 19:00:00,2022-12-31 20:00:00,180,0,8,8916,8137,17241,45646
2022-12-31 20:00:00,2022-12-31 21:00:00,180,0,8,8895,8150,17233,43425
2022-12-31 21:00:00,2022-12-31 22:00:00,180,0,8,8553,8388,17129,41766
2022-12-31 22:00:00,2022-12-31 23:00:00,180,0,8,7891,7860,15939,40415
2022-12-31 23:00:00,2023-01-01 00:00:00,180,0,8,4865,7226,12279,39398
