StartTime,EndTime,quantity_B01,quantity_B10,quantity_B11,quantity_B12,quantity_B16,quantity_B19,total_green_energy,Load
2022-01-01 00:00:00,2022-01-01 01:00:00,221,0,199,0,0,4071,4491,13935
2022-01-01 01:00:00,2022-01-01 02:00:00,223,0,216,0,0,3997,4436,13579
2022-01-01 02:00:00,2022-01-01 03:00:00,225,0,238,0,0,4105,4568,13397
2022-01-01 03:00:00,2022-01-01 04:00:00,229,0,245,0,0,4085,4559,13364
2022-01-01 04:00:00,2022-01-01 05:00:00,230,0,242,0,0,3902,4374,13449
2022-01-01 05:00:00,2022-01-01 06:00:00,232,0,234,0,0,3837,4303,13444
2022-01-01 06:00:00,2022-01-01 07:00:00,231,0,227,0,21,3891,4370,13527
2022-01-01 07:00:00,2022-01-01 08:00:00,234,34,207,0,114,3951,4540,14202
2022-01-01 08:00:00,2022-01-01 09:00:00,232,22,197,0,219,3732,4402,14851
2022-01-01 09:00:00,2022-01-01 10:00:00,230,3,208,0,300,3525,4266,15643
2022-01-01 10:00:00,2022-01-01 11:00:00,231,0,202,0,310,3271,4014,16235
2022-01-01 11:00:00,2022-01-01 12:00:00,230,4,210,0,249,2878,3571,16712
2022-01-01 12:00:00,2022-01-01 13:00:00,230,15,211,0,162,2485,3103,16874
2022-01-01 13:00:00,2022-01-01 14:00:00,230,152,226,0,51,1997,2656,17032
2022-01-01 14:00:00,2022-01-01 15:00:00,229,395,247,38,1,1458,2368,17715
2022-01-01 15:00:00,2022-01-01 16:00:00,229,779,254,43,0,1122,2427,17887
2022-01-01 16:00:00,2022-01-01 17:00:00,229,744,259,43,0,858,2133,17929
2022-01-01 17:00:00,2022-01-01 18:00:00,229,793,257,43,0,668,1990,17898
2022-01-01 18:00:00,2022-01-01 19:00:00,230,764,237,43,0,670,1944,17594
2022-01-01 19:00:00,2022-01-01 20:00:00,230,504,217,43,0,721,1715,16972
2022-01-01 20:00:00,2022-01-01 21:00:00,229,422,216,5,0,753,1625,16426
2022-01-01 21:00:00,2022-01-01 22:00:00,229,70,216,0,0,878,1393,15411
2022-01-01 22:00:00,2022-01-01 23:00:00,225,0,211,0,0,1329,1765,14480
2022-01-01 23:00:00,2022-01-02 00:00:00,224,0,210,0,0,1861,2295,13833
2022-01-02 00:00:00,2022-01-02 01:00:00,224,0,210,0,0,2306,2740,13451
2022-01-02 01:00:00,2022-01-02 02:00:00,224,0,210,0,0,2746,3180,13267
2022-01-02 02:00:00,2022-01-02 03:00:00,229,0,209,0,0,3169,3607,13326
2022-01-02 03:00:00,2022-01-02 04:00:00,222,0,208,0,0,3345,3775,13714
2022-01-02 04:00:00,2022-01-02 05:00:00,233,0,207,38,0,3504,3982,14230
2022-01-02 05:00:00,2022-01-02 06:00:00,234,0,207,43,0,3522,4006,14542
2022-01-02 06:00:00,2022-01-02 07:00:00,235,0,207,43,62,3608,4155,14960
2022-01-02 07:00:00,2022-01-02 08:00:00,233,270,208,43,258,3643,4655,15855
2022-01-02 08:00:00,2022-01-02 09:00:00,233,293,204,43,543,3771,5087,16709
2022-01-02 09:00:00,2022-01-02 10:00:00,231,284,199,43,633,3919,5309,17032
2022-01-02 10:00:00,2022-01-02 11:00:00,233,284,194,43,705,4001,5460,17414
2022-01-02 11:00:00,2022-01-02 12:00:00,230,216,191,43,600,4039,5319,18006
2022-01-02 12:00:00,2022-01-02 13:00:00,232,0,200,43,324,4092,4891,17914
2022-01-02 13:00:00,2022-01-02 14:00:00,232,157,203,43,98,4253,4986,18024
2022-01-02 14:00:00,2022-01-02 15:00:00,235,410,222,43,1,4629,5540,18627
2022-01-02 15:00:00,2022-01-02 16:00:00,234,793,233,43,0,5233,6536,18737
2022-01-02 16:00:00,2022-01-02 17:00:00,234,1019,236,43,0,5499,7031,18753
2022-01-02 17:00:00,2022-01-02 18:00:00,233,560,231,43,0,5881,6948,18774
2022-01-02 18:00:00,2022-01-02 19:00:00,234,214,227,43,0,5931,6649,18378
2022-01-02 19:00:00,2022-01-02 20:00:00,232,19,210,43,0,6053,6557,17527
2022-01-02 20:00:00,2022-01-02 21:00:00,227,33,201,5,0,6148,6614,16897
2022-01-02 21:00:00,2022-01-02 22:00:00,229,4,200,0,0,6062,6495,15711
2022-01-02 22:00:00,2022-01-02 23:00:00,224,0,194,0,0,6079,6497,14918
2022-01-02 23:00:00,2022-01-03 00:00:00,225,0,184,0,0,5754,6163,14446
2022-01-03 00:00:00,2022-01-03 01:00:00,225,0,184,0,0,5437,5846,14223
2022-01-03 01:00:00,2022-01-03 02:00:00,225,0,184,0,0,5104,5513,14320
2022-01-03 02:00:00,2022-01-03 03:00:00,223,0,184,0,0,4712,5119,14814
2022-01-03 03:00:00,2022-01-03 04:00:00,227,16,187,0,0,4129,4559,15727
2022-01-03 04:00:00,2022-01-03 05:00:00,231,68,199,38,0,3884,4420,18749
2022-01-03 05:00:00,2022-01-03 06:00:00,229,80,212,43,1,3611,4176,20921
2022-01-03 06:00:00,2022-01-03 07:00:00,231,176,223,43,57,3675,4405,22135
2022-01-03 07:00:00,2022-01-03 08:00:00,234,47,237,43,144,3750,4455,22929
2022-01-03 08:00:00,2022-01-03 09:00:00,235,1,238,43,274,3986,4777,22935
2022-01-03 09:00:00,2022-01-03 10:00:00,234,46,238,43,417,4319,5297,23366
2022-01-03 10:00:00,2022-01-03 11:00:00,236,247,241,43,533,4585,5885,23608
2022-01-03 11:00:00,2022-01-03 12:00:00,234,189,242,43,432,4829,5969,23666
2022-01-03 12:00:00,2022-01-03 13:00:00,235,56,243,43,331,4879,5787,23374
2022-01-03 13:00:00,2022-01-03 14:00:00,235,415,243,43,107,4919,5962,23417
2022-01-03 14:00:00,2022-01-03 15:00:00,233,681,249,43,7,4769,5982,23971
2022-01-03 15:00:00,2022-01-03 16:00:00,234,777,252,43,0,4535,5841,23882
2022-01-03 16:00:00,2022-01-03 17:00:00,235,708,267,43,0,4279,5532,23558
2022-01-03 17:00:00,2022-01-03 18:00:00,234,338,260,43,0,4236,5111,23340
2022-01-03 18:00:00,2022-01-03 19:00:00,235,105,252,43,0,4350,4985,22852
2022-01-03 19:00:00,2022-01-03 20:00:00,234,6,239,43,0,4373,4895,21306
2022-01-03 20:00:00,2022-01-03 21:00:00,233,0,239,43,0,4298,4813,19825
2022-01-03 21:00:00,2022-01-03 22:00:00,233,0,237,43,0,4367,4880,18509
2022-01-03 22:00:00,2022-01-03 23:00:00,226,0,237,5,0,4259,4727,17594
2022-01-03 23:00:00,2022-01-04 00:00:00,226,0,237,0,0,3958,4421,16880
2022-01-04 00:00:00,2022-01-04 01:00:00,228,0,238,0,0,3712,4178,16612
2022-01-04 01:00:00,2022-01-04 02:00:00,229,0,238,0,0,3718,4185,16603
2022-01-04 02:00:00,2022-01-04 03:00:00,230,0,237,0,0,3503,3970,16936
2022-01-04 03:00:00,2022-01-04 04:00:00,235,0,236,0,0,3286,3757,17763
2022-01-04 04:00:00,2022-01-04 05:00:00,235,2,228,38,0,3065,3568,20158
2022-01-04 05:00:00,2022-01-04 06:00:00,235,16,228,43,1,2777,3300,22051
2022-01-04 06:00:00,2022-01-04 07:00:00,235,20,235,43,62,2703,3298,23023
2022-01-04 07:00:00,2022-01-04 08:00:00,234,20,248,43,183,2316,3044,23454
2022-01-04 08:00:00,2022-01-04 09:00:00,232,44,256,43,368,1861,2804,23660
2022-01-04 09:00:00,2022-01-04 10:00:00,234,296,270,43,478,1630,2951,24118
2022-01-04 10:00:00,2022-01-04 11:00:00,234,254,273,43,462,1436,2702,24361
2022-01-04 11:00:00,2022-01-04 12:00:00,236,347,272,43,346,1293,2537,24276
2022-01-04 12:00:00,2022-01-04 13:00:00,236,378,273,43,252,1303,2485,24024
2022-01-04 13:00:00,2022-01-04 14:00:00,234,401,277,43,71,1498,2524,23959
2022-01-04 14:00:00,2022-01-04 15:00:00,232,391,280,43,1,1633,2580,24402
2022-01-04 15:00:00,2022-01-04 16:00:00,230,478,287,43,0,1841,2879,24328
2022-01-04 16:00:00,2022-01-04 17:00:00,233,618,281,43,0,2102,3277,23992
2022-01-04 17:00:00,2022-01-04 18:00:00,234,340,263,43,0,2493,3373,23736
2022-01-04 18:00:00,2022-01-04 19:00:00,234,129,263,43,0,2913,3582,23112
2022-01-04 19:00:00,2022-01-04 20:00:00,233,258,264,43,0,2873,3671,21669
2022-01-04 20:00:00,2022-01-04 21:00:00,236,126,247,43,0,2927,3579,20229
2022-01-04 21:00:00,2022-01-04 22:00:00,232,0,243,43,0,3099,3617,18802
2022-01-04 22:00:00,2022-01-04 23:00:00,227,0,250,5,0,3280,3762,17752
2022-01-04 23:00:00,2022-01-05 00:00:00,227,0,250,0,0,3143,3620,17163
2022-01-05 00:00:00,2022-01-05 01:00:00,228,0,250,0,0,2822,3300,16787
2022-01-05 01:00:00,2022-01-05 02:00:00,229,0,251,0,0,2634,3114,16803
2022-01-05 02:00:00,2022-01-05 03:00:00,232,0,250,0,0,2384,2866,17166
2022-01-05 03:00:00,2022-01-05 04:00:00,235,0,249,0,0,2260,2744,17874
2022-01-05 04:00:00,2022-01-05 05:00:00,233,21,247,38,0,2300,2839,20243
2022-01-05 05:00:00,2022-01-05 06:00:00,233,46,247,43,0,2412,2981,22207
2022-01-05 06:00:00,2022-01-05 07:00:00,233,301,257,43,43,2440,3317,23028
2022-01-05 07:00:00,2022-01-05 08:00:00,232,448,270,43,132,2547,3672,23535
2022-01-05 08:00:00,2022-01-05 09:00:00,233,292,274,43,295,2616,3753,23727
2022-01-05 09:00:00,2022-01-05 10:00:00,232,161,275,43,409,2848,3968,24107
2022-01-05 10:00:00,2022-01-05 11:00:00,234,174,274,43,415,3036,4176,24197
2022-01-05 11:00:00,2022-01-05 12:00:00,232,296,274,43,287,3042,4174,24215
2022-01-05 12:00:00,2022-01-05 13:00:00,234,364,274,43,202,3344,4461,23969
2022-01-05 13:00:00,2022-01-05 14:00:00,232,433,273,43,83,3530,4594,23816
2022-01-05 14:00:00,2022-01-05 15:00:00,233,417,273,43,5,3724,4695,24338
2022-01-05 15:00:00,2022-01-05 16:00:00,234,462,282,43,0,3832,4853,24205
2022-01-05 16:00:00,2022-01-05 17:00:00,233,621,283,43,0,3953,5133,23697
2022-01-05 17:00:00,2022-01-05 18:00:00,232,577,287,43,0,3982,5121,23425
2022-01-05 18:00:00,2022-01-05 19:00:00,235,120,297,43,0,4109,4804,22866
2022-01-05 19:00:00,2022-01-05 20:00:00,233,0,297,43,0,4132,4705,21540
2022-01-05 20:00:00,2022-01-05 21:00:00,234,0,295,43,0,4103,4675,20089
2022-01-05 21:00:00,2022-01-05 22:00:00,232,0,281,43,0,4021,4577,18792
2022-01-05 22:00:00,2022-01-05 23:00:00,230,0,273,5,0,4068,4576,17750
2022-01-05 23:00:00,2022-01-06 00:00:00,229,0,271,0,0,3948,4448,16977
2022-01-06 00:00:00,2022-01-06 01:00:00,229,0,271,0,0,4027,4527,16561
2022-01-06 01:00:00,2022-01-06 02:00:00,228,0,266,0,0,3936,4430,16399
2022-01-06 02:00:00,2022-01-06 03:00:00,232,0,260,0,0,4219,4711,16401
2022-01-06 03:00:00,2022-01-06 04:00:00,233,0,251,0,0,4351,4835,16213
2022-01-06 04:00:00,2022-01-06 05:00:00,232,16,248,0,0,3941,4437,16250
2022-01-06 05:00:00,2022-01-06 06:00:00,232,2,253,0,1,3550,4038,16590
2022-01-06 06:00:00,2022-01-06 07:00:00,232,33,263,0,62,3502,4092,17087
2022-01-06 07:00:00,2022-01-06 08:00:00,230,194,282,38,197,3825,4766,18076
2022-01-06 08:00:00,2022-01-06 09:00:00,228,97,285,43,431,4079,5163,18799
2022-01-06 09:00:00,2022-01-06 10:00:00,230,91,285,43,589,4461,5699,19315
2022-01-06 10:00:00,2022-01-06 11:00:00,229,84,290,43,642,4803,6091,19658
2022-01-06 11:00:00,2022-01-06 12:00:00,228,16,291,43,490,4665,5733,19860
2022-01-06 12:00:00,2022-01-06 13:00:00,228,20,291,43,423,4347,5352,19875
2022-01-06 13:00:00,2022-01-06 14:00:00,227,30,291,43,213,3952,4756,19753
2022-01-06 14:00:00,2022-01-06 15:00:00,226,481,291,43,16,3773,4830,20402
2022-01-06 15:00:00,2022-01-06 16:00:00,224,705,291,43,0,3754,5017,20552
2022-01-06 16:00:00,2022-01-06 17:00:00,226,660,291,43,0,3409,4629,20465
2022-01-06 17:00:00,2022-01-06 18:00:00,228,696,291,43,0,3091,4349,20485
2022-01-06 18:00:00,2022-01-06 19:00:00,227,323,291,43,0,2897,3781,20226
2022-01-06 19:00:00,2022-01-06 20:00:00,227,44,288,43,0,2840,3442,19556
2022-01-06 20:00:00,2022-01-06 21:00:00,227,120,268,43,0,2771,3429,18884
2022-01-06 21:00:00,2022-01-06 22:00:00,225,17,268,5,0,2803,3318,17761
2022-01-06 22:00:00,2022-01-06 23:00:00,221,0,261,0,0,2789,3271,16997
2022-01-06 23:00:00,2022-01-07 00:00:00,221,0,259,0,0,2736,3216,16433
2022-01-07 00:00:00,2022-01-07 01:00:00,220,0,259,0,0,2817,3296,16186
2022-01-07 01:00:00,2022-01-07 02:00:00,218,0,259,0,0,2780,3257,16161
2022-01-07 02:00:00,2022-01-07 03:00:00,224,0,259,0,0,2825,3308,16425
2022-01-07 03:00:00,2022-01-07 04:00:00,226,0,258,0,0,2959,3443,17182
2022-01-07 04:00:00,2022-01-07 05:00:00,229,11,262,0,0,3107,3609,18906
2022-01-07 05:00:00,2022-01-07 06:00:00,230,19,262,0,2,3080,3593,20101
2022-01-07 06:00:00,2022-01-07 07:00:00,230,99,276,0,101,3085,3791,20909
2022-01-07 07:00:00,2022-01-07 08:00:00,230,154,304,0,586,2999,4273,21505
2022-01-07 08:00:00,2022-01-07 09:00:00,229,95,303,38,1093,2743,4501,21346
2022-01-07 09:00:00,2022-01-07 10:00:00,228,11,299,43,1381,2482,4444,21264
2022-01-07 10:00:00,2022-01-07 11:00:00,230,23,299,43,1401,2411,4407,21228
2022-01-07 11:00:00,2022-01-07 12:00:00,230,235,286,43,1278,2447,4519,21885
2022-01-07 12:00:00,2022-01-07 13:00:00,230,286,285,43,732,2582,4158,22107
2022-01-07 13:00:00,2022-01-07 14:00:00,230,378,306,43,242,2976,4175,22319
2022-01-07 14:00:00,2022-01-07 15:00:00,227,605,324,43,13,3373,4585,22930
2022-01-07 15:00:00,2022-01-07 16:00:00,168,518,325,43,0,3537,4591,23000
2022-01-07 16:00:00,2022-01-07 17:00:00,183,464,320,43,0,3590,4600,22792
2022-01-07 17:00:00,2022-01-07 18:00:00,229,61,297,43,0,3584,4214,22451
2022-01-07 18:00:00,2022-01-07 19:00:00,230,14,288,5,0,3505,4042,22022
2022-01-07 19:00:00,2022-01-07 20:00:00,228,19,283,0,0,3244,3774,20822
2022-01-07 20:00:00,2022-01-07 21:00:00,230,3,267,0,0,3058,3558,19960
2022-01-07 21:00:00,2022-01-07 22:00:00,228,0,265,0,0,2737,3230,18816
2022-01-07 22:00:00,2022-01-07 23:00:00,221,0,248,0,0,2472,2941,17743
2022-01-07 23:00:00,2022-01-08 00:00:00,219,0,245,0,0,2423,2887,17243
2022-01-08 00:00:00,2022-01-08 01:00:00,221,0,243,0,0,2425,2889,16879
2022-01-08 01:00:00,2022-01-08 02:00:00,219,0,243,0,0,2402,2864,16792
2022-01-08 02:00:00,2022-01-08 03:00:00,228,0,243,0,0,2275,2746,16860
2022-01-08 03:00:00,2022-01-08 04:00:00,229,0,243,0,0,2206,2678,17340
2022-01-08 04:00:00,2022-01-08 05:00:00,227,4,244,0,0,2204,2679,18151
2022-01-08 05:00:00,2022-01-08 06:00:00,229,14,244,0,2,2228,2717,18785
2022-01-08 06:00:00,2022-01-08 07:00:00,229,5,262,0,99,2270,2865,19579
2022-01-08 07:00:00,2022-01-08 08:00:00,227,146,278,0,339,2226,3216,20444
2022-01-08 08:00:00,2022-01-08 09:00:00,228,98,293,38,639,2165,3461,21138
2022-01-08 09:00:00,2022-01-08 10:00:00,226,65,296,43,735,2102,3467,21373
2022-01-08 10:00:00,2022-01-08 11:00:00,228,10,313,43,712,1946,3252,21507
2022-01-08 11:00:00,2022-01-08 12:00:00,228,26,315,43,687,1898,3197,21676
2022-01-08 12:00:00,2022-01-08 13:00:00,230,219,305,43,450,1851,3098,21486
2022-01-08 13:00:00,2022-01-08 14:00:00,229,251,281,43,155,1827,2786,21476
2022-01-08 14:00:00,2022-01-08 15:00:00,228,512,303,43,8,1895,2989,22045
2022-01-08 15:00:00,2022-01-08 16:00:00,226,473,310,43,0,1937,2989,22051
2022-01-08 16:00:00,2022-01-08 17:00:00,228,457,319,43,0,1990,3037,21857
2022-01-08 17:00:00,2022-01-08 18:00:00,228,386,295,43,0,1964,2916,21552
2022-01-08 18:00:00,2022-01-08 19:00:00,228,58,285,5,0,1781,2357,21136
2022-01-08 19:00:00,2022-01-08 20:00:00,227,112,263,0,0,1545,2147,20230
2022-01-08 20:00:00,2022-01-08 21:00:00,227,2,247,0,0,1462,1938,19224
2022-01-08 21:00:00,2022-01-08 22:00:00,226,17,243,0,0,1575,2061,18046
2022-01-08 22:00:00,2022-01-08 23:00:00,222,2,243,0,0,1616,2083,17078
2022-01-08 23:00:00,2022-01-09 00:00:00,221,0,242,0,0,1649,2112,16344
2022-01-09 00:00:00,2022-01-09 01:00:00,218,0,242,0,0,1840,2300,15913
2022-01-09 01:00:00,2022-01-09 02:00:00,218,0,242,0,0,2021,2481,15681
2022-01-09 02:00:00,2022-01-09 03:00:00,223,0,242,0,0,2142,2607,15813
2022-01-09 03:00:00,2022-01-09 04:00:00,227,0,242,0,0,2508,2977,16037
2022-01-09 04:00:00,2022-01-09 05:00:00,224,0,241,0,0,2686,3151,16484
2022-01-09 05:00:00,2022-01-09 06:00:00,182,0,241,0,2,2860,3285,16835
2022-01-09 06:00:00,2022-01-09 07:00:00,165,8,247,0,117,2860,3397,17299
2022-01-09 07:00:00,2022-01-09 08:00:00,216,172,259,0,600,2628,3875,17983
2022-01-09 08:00:00,2022-01-09 09:00:00,224,106,255,0,1111,2103,3799,18427
2022-01-09 09:00:00,2022-01-09 10:00:00,226,92,254,0,1320,1699,3591,18352
2022-01-09 10:00:00,2022-01-09 11:00:00,225,11,256,0,1313,1575,3380,18561
2022-01-09 11:00:00,2022-01-09 12:00:00,224,0,266,0,1082,1521,3093,19111
2022-01-09 12:00:00,2022-01-09 13:00:00,226,20,271,0,711,1511,2739,19472
2022-01-09 13:00:00,2022-01-09 14:00:00,226,288,276,38,234,1763,2825,19621
2022-01-09 14:00:00,2022-01-09 15:00:00,225,610,299,43,17,2234,3428,20519
2022-01-09 15:00:00,2022-01-09 16:00:00,225,683,303,43,0,2503,3757,20863
2022-01-09 16:00:00,2022-01-09 17:00:00,225,671,303,43,0,2560,3802,20845
2022-01-09 17:00:00,2022-01-09 18:00:00,224,754,302,43,0,2399,3722,20952
2022-01-09 18:00:00,2022-01-09 19:00:00,225,573,279,43,0,2025,3145,20552
2022-01-09 19:00:00,2022-01-09 20:00:00,226,51,270,5,0,1861,2413,19668
2022-01-09 20:00:00,2022-01-09 21:00:00,225,0,245,0,0,1707,2177,18919
2022-01-09 21:00:00,2022-01-09 22:00:00,227,0,242,0,0,1504,1973,17734
2022-01-09 22:00:00,2022-01-09 23:00:00,220,0,243,0,0,1313,1776,17084
2022-01-09 23:00:00,2022-01-10 00:00:00,219,0,242,0,0,1300,1761,16764
2022-01-10 00:00:00,2022-01-10 01:00:00,219,0,241,0,0,1221,1681,16569
2022-01-10 01:00:00,2022-01-10 02:00:00,217,0,241,0,0,1126,1584,16597
2022-01-10 02:00:00,2022-01-10 03:00:00,223,0,241,0,0,1103,1567,17014
2022-01-10 03:00:00,2022-01-10 04:00:00,230,0,239,0,0,1095,1564,18255
2022-01-10 04:00:00,2022-01-10 05:00:00,229,0,237,0,0,1162,1628,21426
2022-01-10 05:00:00,2022-01-10 06:00:00,230,118,237,0,1,1279,1865,23775
2022-01-10 06:00:00,2022-01-10 07:00:00,230,562,249,0,81,1417,2539,24863
2022-01-10 07:00:00,2022-01-10 08:00:00,228,371,266,0,276,1330,2471,25265
2022-01-10 08:00:00,2022-01-10 09:00:00,229,125,274,38,658,873,2197,25116
2022-01-10 09:00:00,2022-01-10 10:00:00,228,38,267,43,910,574,2060,25331
2022-01-10 10:00:00,2022-01-10 11:00:00,229,0,279,43,928,506,1985,25351
2022-01-10 11:00:00,2022-01-10 12:00:00,229,0,283,43,807,451,1813,25602
2022-01-10 12:00:00,2022-01-10 13:00:00,231,14,288,43,604,532,1712,25658
2022-01-10 13:00:00,2022-01-10 14:00:00,228,248,289,5,216,655,1641,25608
2022-01-10 14:00:00,2022-01-10 15:00:00,231,699,293,38,11,933,2205,26061
2022-01-10 15:00:00,2022-01-10 16:00:00,229,503,300,43,0,1188,2263,26078
2022-01-10 16:00:00,2022-01-10 17:00:00,230,375,300,43,0,1437,2385,25776
2022-01-10 17:00:00,2022-01-10 18:00:00,227,300,300,5,0,1343,2175,25573
2022-01-10 18:00:00,2022-01-10 19:00:00,229,36,281,0,0,1297,1843,25001
2022-01-10 19:00:00,2022-01-10 20:00:00,227,0,250,0,0,1256,1733,23570
2022-01-10 20:00:00,2022-01-10 21:00:00,229,0,229,0,0,1184,1642,22125
2022-01-10 21:00:00,2022-01-10 22:00:00,228,0,223,0,0,1005,1456,20728
2022-01-10 22:00:00,2022-01-10 23:00:00,222,0,224,0,0,819,1265,19612
2022-01-10 23:00:00,2022-01-11 00:00:00,220,0,224,0,0,752,1196,19218
2022-01-11 00:00:00,2022-01-11 01:00:00,221,0,223,0,0,655,1099,19022
2022-01-11 01:00:00,2022-01-11 02:00:00,217,0,223,0,0,525,965,18956
2022-01-11 02:00:00,2022-01-11 03:00:00,225,0,223,0,0,469,917,19357
2022-01-11 03:00:00,2022-01-11 04:00:00,225,0,223,0,0,385,833,20257
2022-01-11 04:00:00,2022-01-11 05:00:00,228,5,223,0,0,277,733,23058
2022-01-11 05:00:00,2022-01-11 06:00:00,227,60,225,0,2,185,699,25135
2022-01-11 06:00:00,2022-01-11 07:00:00,227,122,243,0,79,127,798,25809
2022-01-11 07:00:00,2022-01-11 08:00:00,226,116,260,25,425,95,1147,26075
2022-01-11 08:00:00,2022-01-11 09:00:00,226,64,267,29,877,88,1551,25763
2022-01-11 09:00:00,2022-01-11 10:00:00,228,44,275,29,1105,71,1752,25852
2022-01-11 10:00:00,2022-01-11 11:00:00,229,39,277,29,1154,62,1790,25870
2022-01-11 11:00:00,2022-01-11 12:00:00,228,38,281,29,1051,65,1692,25904
2022-01-11 12:00:00,2022-01-11 13:00:00,230,5,272,41,680,81,1309,25717
2022-01-11 13:00:00,2022-01-11 14:00:00,231,49,271,43,271,135,1000,25699
2022-01-11 14:00:00,2022-01-11 15:00:00,230,367,271,43,19,237,1167,26334
2022-01-11 15:00:00,2022-01-11 16:00:00,228,643,271,43,0,335,1520,26376
2022-01-11 16:00:00,2022-01-11 17:00:00,229,649,271,43,0,426,1618,26035
2022-01-11 17:00:00,2022-01-11 18:00:00,229,309,271,43,0,604,1456,25912
2022-01-11 18:00:00,2022-01-11 19:00:00,228,31,267,43,0,680,1249,25398
2022-01-11 19:00:00,2022-01-11 20:00:00,228,271,249,5,0,765,1518,23890
2022-01-11 20:00:00,2022-01-11 21:00:00,228,200,242,0,0,911,1581,22446
2022-01-11 21:00:00,2022-01-11 22:00:00,228,20,241,0,0,945,1434,21031
2022-01-11 22:00:00,2022-01-11 23:00:00,223,0,237,0,0,902,1362,19948
2022-01-11 23:00:00,2022-01-12 00:00:00,221,0,236,0,0,908,1365,19416
2022-01-12 00:00:00,2022-01-12 01:00:00,222,0,236,0,0,853,1311,19111
2022-01-12 01:00:00,2022-01-12 02:00:00,222,0,237,0,0,842,1301,19177
2022-01-12 02:00:00,2022-01-12 03:00:00,228,0,237,0,0,775,1240,19437
2022-01-12 03:00:00,2022-01-12 04:00:00,229,0,237,0,0,699,1165,20287
2022-01-12 04:00:00,2022-01-12 05:00:00,230,1,238,0,0,665,1134,23115
2022-01-12 05:00:00,2022-01-12 06:00:00,230,293,238,0,4,654,1419,25064
2022-01-12 06:00:00,2022-01-12 07:00:00,231,540,253,38,88,716,1866,25790
2022-01-12 07:00:00,2022-01-12 08:00:00,230,566,266,43,278,753,2136,26069
2022-01-12 08:00:00,2022-01-12 09:00:00,232,410,266,43,444,865,2260,25847
2022-01-12 09:00:00,2022-01-12 10:00:00,230,339,271,5,682,917,2444,25975
2022-01-12 10:00:00,2022-01-12 11:00:00,232,291,269,0,814,973,2579,26042
2022-01-12 11:00:00,2022-01-12 12:00:00,229,172,266,0,730,1128,2525,26149
2022-01-12 12:00:00,2022-01-12 13:00:00,232,34,276,0,532,1136,2210,25998
2022-01-12 13:00:00,2022-01-12 14:00:00,233,49,278,0,214,1144,1918,25887
2022-01-12 14:00:00,2022-01-12 15:00:00,231,313,293,38,20,1360,2255,26379
2022-01-12 15:00:00,2022-01-12 16:00:00,232,248,294,43,0,1567,2384,26427
2022-01-12 16:00:00,2022-01-12 17:00:00,232,111,286,43,0,1800,2472,26034
2022-01-12 17:00:00,2022-01-12 18:00:00,232,239,273,5,0,1959,2708,25898
2022-01-12 18:00:00,2022-01-12 19:00:00,231,16,252,0,0,2130,2629,25191
2022-01-12 19:00:00,2022-01-12 20:00:00,232,0,247,0,0,2216,2695,23629
2022-01-12 20:00:00,2022-01-12 21:00:00,229,0,229,0,0,2667,3125,22070
2022-01-12 21:00:00,2022-01-12 22:00:00,228,0,226,0,0,3233,3687,20596
2022-01-12 22:00:00,2022-01-12 23:00:00,224,0,224,0,0,3693,4141,19522
2022-01-12 23:00:00,2022-01-13 00:00:00,225,0,221,0,0,4045,4491,18956
2022-01-13 00:00:00,2022-01-13 01:00:00,225,0,221,0,0,4412,4858,18505
2022-01-13 01:00:00,2022-01-13 02:00:00,225,0,221,0,0,4604,5050,18538
2022-01-13 02:00:00,2022-01-13 03:00:00,224,0,220,0,0,4798,5242,18834
2022-01-13 03:00:00,2022-01-13 04:00:00,229,0,220,0,0,5063,5512,19708
2022-01-13 04:00:00,2022-01-13 05:00:00,231,4,220,0,0,5262,5717,22367
2022-01-13 05:00:00,2022-01-13 06:00:00,232,64,221,0,3,5310,5830,24378
2022-01-13 06:00:00,2022-01-13 07:00:00,233,138,231,0,56,5443,6101,25144
2022-01-13 07:00:00,2022-01-13 08:00:00,232,167,254,38,183,5539,6413,25506
2022-01-13 08:00:00,2022-01-13 09:00:00,230,101,253,43,334,5605,6566,25399
2022-01-13 09:00:00,2022-01-13 10:00:00,229,104,253,5,445,5675,6711,25798
2022-01-13 10:00:00,2022-01-13 11:00:00,229,294,246,0,437,5754,6960,25862
2022-01-13 11:00:00,2022-01-13 12:00:00,230,223,245,0,349,5757,6804,25982
2022-01-13 12:00:00,2022-01-13 13:00:00,222,129,246,0,239,5759,6595,25504
2022-01-13 13:00:00,2022-01-13 14:00:00,230,225,254,0,104,5814,6627,25343
2022-01-13 14:00:00,2022-01-13 15:00:00,232,510,258,38,15,5930,6983,25750
2022-01-13 15:00:00,2022-01-13 16:00:00,233,654,263,43,0,6004,7197,25674
2022-01-13 16:00:00,2022-01-13 17:00:00,234,629,240,5,0,6084,7192,25204
2022-01-13 17:00:00,2022-01-13 18:00:00,234,399,232,0,0,6125,6990,25007
2022-01-13 18:00:00,2022-01-13 19:00:00,232,226,229,0,0,6127,6814,24344
2022-01-13 19:00:00,2022-01-13 20:00:00,230,175,219,0,0,6182,6806,22806
2022-01-13 20:00:00,2022-01-13 21:00:00,229,106,215,0,0,6177,6727,21317
2022-01-13 21:00:00,2022-01-13 22:00:00,227,0,216,0,0,6197,6640,20023
2022-01-13 22:00:00,2022-01-13 23:00:00,223,0,208,0,0,6214,6645,19024
2022-01-13 23:00:00,2022-01-14 00:00:00,224,0,202,0,0,6224,6650,18411
2022-01-14 00:00:00,2022-01-14 01:00:00,228,0,201,0,0,6184,6613,18028
2022-01-14 01:00:00,2022-01-14 02:00:00,224,0,201,0,0,6177,6602,17956
2022-01-14 02:00:00,2022-01-14 03:00:00,230,0,201,0,0,6170,6601,18262
2022-01-14 03:00:00,2022-01-14 04:00:00,232,3,200,0,0,6195,6630,19109
2022-01-14 04:00:00,2022-01-14 05:00:00,232,28,201,0,0,6278,6739,21798
2022-01-14 05:00:00,2022-01-14 06:00:00,230,12,209,0,1,6194,6646,23805
2022-01-14 06:00:00,2022-01-14 07:00:00,233,55,211,0,44,6241,6784,24720
2022-01-14 07:00:00,2022-01-14 08:00:00,231,258,212,0,121,6261,7083,25181
2022-01-14 08:00:00,2022-01-14 09:00:00,231,244,213,0,315,6192,7195,25134
2022-01-14 09:00:00,2022-01-14 10:00:00,230,224,214,0,583,6294,7545,25513
2022-01-14 10:00:00,2022-01-14 11:00:00,230,192,215,0,653,6302,7592,25605
2022-01-14 11:00:00,2022-01-14 12:00:00,232,378,214,0,531,6267,7622,25639
2022-01-14 12:00:00,2022-01-14 13:00:00,233,116,219,0,381,6228,7177,25065
2022-01-14 13:00:00,2022-01-14 14:00:00,233,0,224,0,177,6157,6791,24740
2022-01-14 14:00:00,2022-01-14 15:00:00,233,269,243,38,19,6016,6818,25220
2022-01-14 15:00:00,2022-01-14 16:00:00,232,555,276,43,0,5861,6967,25213
2022-01-14 16:00:00,2022-01-14 17:00:00,230,460,279,43,0,5745,6757,24849
2022-01-14 17:00:00,2022-01-14 18:00:00,226,302,279,43,0,5666,6516,24676
2022-01-14 18:00:00,2022-01-14 19:00:00,227,348,258,5,0,5567,6405,24094
2022-01-14 19:00:00,2022-01-14 20:00:00,229,226,225,0,0,5476,6156,22589
2022-01-14 20:00:00,2022-01-14 21:00:00,230,22,219,0,0,5122,5593,21186
2022-01-14 21:00:00,2022-01-14 22:00:00,226,0,217,0,0,4800,5243,19919
2022-01-14 22:00:00,2022-01-14 23:00:00,222,0,210,0,0,4657,5089,18910
2022-01-14 23:00:00,2022-01-15 00:00:00,224,0,206,0,0,4451,4881,18231
2022-01-15 00:00:00,2022-01-15 01:00:00,222,0,207,0,0,4407,4836,17854
2022-01-15 01:00:00,2022-01-15 02:00:00,218,0,207,0,0,4290,4715,17782
2022-01-15 02:00:00,2022-01-15 03:00:00,221,0,206,0,0,4126,4553,17762
2022-01-15 03:00:00,2022-01-15 04:00:00,223,0,207,0,0,3955,4385,18041
2022-01-15 04:00:00,2022-01-15 05:00:00,223,0,207,0,0,3689,4119,19143
2022-01-15 05:00:00,2022-01-15 06:00:00,220,0,208,0,9,3313,3750,19989
2022-01-15 06:00:00,2022-01-15 07:00:00,226,80,216,0,108,2921,3551,20751
2022-01-15 07:00:00,2022-01-15 08:00:00,227,109,224,0,602,2619,3781,21392
2022-01-15 08:00:00,2022-01-15 09:00:00,226,107,235,38,1190,2270,4066,21711
2022-01-15 09:00:00,2022-01-15 10:00:00,227,14,237,43,1476,2117,4114,21778
2022-01-15 10:00:00,2022-01-15 11:00:00,229,37,237,5,1487,2067,4062,21716
2022-01-15 11:00:00,2022-01-15 12:00:00,229,40,255,0,1303,2002,3829,21781
2022-01-15 12:00:00,2022-01-15 13:00:00,230,39,256,0,914,1714,3153,21572
2022-01-15 13:00:00,2022-01-15 14:00:00,228,85,256,0,368,1602,2539,21702
2022-01-15 14:00:00,2022-01-15 15:00:00,230,653,266,38,32,1623,2842,22466
2022-01-15 15:00:00,2022-01-15 16:00:00,229,688,269,43,0,1599,2828,22635
2022-01-15 16:00:00,2022-01-15 17:00:00,228,670,286,43,0,1366,2593,22493
2022-01-15 17:00:00,2022-01-15 18:00:00,228,552,288,43,0,1166,2277,22252
2022-01-15 18:00:00,2022-01-15 19:00:00,229,661,267,5,0,987,2149,21645
2022-01-15 19:00:00,2022-01-15 20:00:00,230,372,243,0,0,912,1757,20587
2022-01-15 20:00:00,2022-01-15 21:00:00,231,54,224,0,0,925,1434,19554
2022-01-15 21:00:00,2022-01-15 22:00:00,228,5,219,0,0,917,1369,18446
2022-01-15 22:00:00,2022-01-15 23:00:00,226,0,214,0,0,849,1289,17306
2022-01-15 23:00:00,2022-01-16 00:00:00,225,0,214,0,0,866,1305,16688
2022-01-16 00:00:00,2022-01-16 01:00:00,228,0,214,0,0,905,1347,16257
2022-01-16 01:00:00,2022-01-16 02:00:00,224,0,214,0,0,977,1415,16146
2022-01-16 02:00:00,2022-01-16 03:00:00,228,0,214,0,0,1046,1488,16130
2022-01-16 03:00:00,2022-01-16 04:00:00,229,0,214,0,0,1110,1553,16368
2022-01-16 04:00:00,2022-01-16 05:00:00,227,0,215,0,0,1203,1645,16822
2022-01-16 05:00:00,2022-01-16 06:00:00,228,0,215,0,4,1341,1788,17139
2022-01-16 06:00:00,2022-01-16 07:00:00,230,47,208,0,138,1609,2232,17722
2022-01-16 07:00:00,2022-01-16 08:00:00,230,93,212,38,460,1685,2718,18481
2022-01-16 08:00:00,2022-01-16 09:00:00,209,165,241,43,825,1649,3132,18857
2022-01-16 09:00:00,2022-01-16 10:00:00,172,300,241,43,1147,1640,3543,19179
2022-01-16 10:00:00,2022-01-16 11:00:00,188,321,240,43,1229,1771,3792,19485
2022-01-16 11:00:00,2022-01-16 12:00:00,226,226,240,43,923,2112,3770,19756
2022-01-16 12:00:00,2022-01-16 13:00:00,226,212,247,5,560,2308,3558,19652
2022-01-16 13:00:00,2022-01-16 14:00:00,228,247,237,0,313,2941,3966,19637
2022-01-16 14:00:00,2022-01-16 15:00:00,228,617,238,0,43,3873,4999,20182
2022-01-16 15:00:00,2022-01-16 16:00:00,228,704,242,0,0,4495,5669,20605
2022-01-16 16:00:00,2022-01-16 17:00:00,228,560,242,0,0,4875,5905,20589
2022-01-16 17:00:00,2022-01-16 18:00:00,227,441,228,0,0,5299,6195,20640
2022-01-16 18:00:00,2022-01-16 19:00:00,227,369,205,0,0,5574,6375,20107
2022-01-16 19:00:00,2022-01-16 20:00:00,227,398,200,0,0,5819,6644,19233
2022-01-16 20:00:00,2022-01-16 21:00:00,224,84,198,0,0,5955,6461,18586
2022-01-16 21:00:00,2022-01-16 22:00:00,222,0,197,0,0,6062,6481,17580
2022-01-16 22:00:00,2022-01-16 23:00:00,216,0,201,0,0,6194,6611,16767
2022-01-16 23:00:00,2022-01-17 00:00:00,217,0,200,0,0,6232,6649,16271
2022-01-17 00:00:00,2022-01-17 01:00:00,217,0,200,0,0,6179,6596,16081
2022-01-17 01:00:00,2022-01-17 02:00:00,216,0,200,0,0,6071,6487,16105
2022-01-17 02:00:00,2022-01-17 03:00:00,220,0,201,0,0,5914,6335,16490
2022-01-17 03:00:00,2022-01-17 04:00:00,223,0,200,0,0,5672,6095,17714
2022-01-17 04:00:00,2022-01-17 05:00:00,224,49,201,0,0,5650,6124,20912
2022-01-17 05:00:00,2022-01-17 06:00:00,222,241,201,0,1,5615,6280,22947
2022-01-17 06:00:00,2022-01-17 07:00:00,224,59,206,0,39,5698,6226,24306
2022-01-17 07:00:00,2022-01-17 08:00:00,227,77,225,0,133,5772,6434,24917
2022-01-17 08:00:00,2022-01-17 09:00:00,225,90,230,0,339,5890,6774,24964
2022-01-17 09:00:00,2022-01-17 10:00:00,218,92,228,0,589,5865,6992,25191
2022-01-17 10:00:00,2022-01-17 11:00:00,226,11,228,0,739,6030,7234,25205
2022-01-17 11:00:00,2022-01-17 12:00:00,226,0,225,0,929,6080,7460,25259
2022-01-17 12:00:00,2022-01-17 13:00:00,229,0,225,0,732,6109,7295,24959
2022-01-17 13:00:00,2022-01-17 14:00:00,222,0,229,38,278,6127,6894,24699
2022-01-17 14:00:00,2022-01-17 15:00:00,205,220,238,43,26,5877,6609,25194
2022-01-17 15:00:00,2022-01-17 16:00:00,226,550,247,43,0,5569,6635,25435
2022-01-17 16:00:00,2022-01-17 17:00:00,227,296,246,43,0,5399,6211,25071
2022-01-17 17:00:00,2022-01-17 18:00:00,228,320,225,43,0,5026,5842,25026
2022-01-17 18:00:00,2022-01-17 19:00:00,230,525,224,5,0,4674,5658,24421
2022-01-17 19:00:00,2022-01-17 20:00:00,229,145,220,0,0,4416,5010,22938
2022-01-17 20:00:00,2022-01-17 21:00:00,227,0,210,0,0,4342,4779,21378
2022-01-17 21:00:00,2022-01-17 22:00:00,227,0,204,0,0,4303,4734,20149
2022-01-17 22:00:00,2022-01-17 23:00:00,221,0,198,0,0,4312,4731,19151
2022-01-17 23:00:00,2022-01-18 00:00:00,222,0,191,0,0,4438,4851,18590
2022-01-18 00:00:00,2022-01-18 01:00:00,213,0,188,0,0,4404,4805,18218
2022-01-18 01:00:00,2022-01-18 02:00:00,215,0,187,0,0,4406,4808,18234
2022-01-18 02:00:00,2022-01-18 03:00:00,223,0,187,0,0,4101,4511,18524
2022-01-18 03:00:00,2022-01-18 04:00:00,228,0,186,0,0,3829,4243,19384
2022-01-18 04:00:00,2022-01-18 05:00:00,231,0,187,0,0,3365,3783,22140
2022-01-18 05:00:00,2022-01-18 06:00:00,231,0,187,0,9,3322,3749,24112
2022-01-18 06:00:00,2022-01-18 07:00:00,232,0,214,0,126,3124,3696,24928
2022-01-18 07:00:00,2022-01-18 08:00:00,230,201,224,0,563,2480,3698,25160
2022-01-18 08:00:00,2022-01-18 09:00:00,232,453,225,0,956,2008,3874,25023
2022-01-18 09:00:00,2022-01-18 10:00:00,232,259,239,0,1186,1640,3556,25154
2022-01-18 10:00:00,2022-01-18 11:00:00,234,51,235,0,1250,1440,3210,25158
2022-01-18 11:00:00,2022-01-18 12:00:00,232,39,233,38,1142,1348,3032,25232
2022-01-18 12:00:00,2022-01-18 13:00:00,234,39,227,43,826,1377,2746,25053
2022-01-18 13:00:00,2022-01-18 14:00:00,233,39,231,47,345,1627,2522,25083
2022-01-18 14:00:00,2022-01-18 15:00:00,233,172,243,51,27,1963,2689,25592
2022-01-18 15:00:00,2022-01-18 16:00:00,232,161,258,44,0,2179,2874,25849
2022-01-18 16:00:00,2022-01-18 17:00:00,233,144,265,43,0,2370,3055,25539
2022-01-18 17:00:00,2022-01-18 18:00:00,231,78,256,43,0,2445,3053,25409
2022-01-18 18:00:00,2022-01-18 19:00:00,231,40,244,43,0,2649,3207,24818
2022-01-18 19:00:00,2022-01-18 20:00:00,232,5,211,5,0,2673,3126,23204
2022-01-18 20:00:00,2022-01-18 21:00:00,232,0,194,0,0,2765,3191,21821
2022-01-18 21:00:00,2022-01-18 22:00:00,231,0,192,0,0,3030,3453,20520
2022-01-18 22:00:00,2022-01-18 23:00:00,180,0,196,0,0,3166,3542,19533
2022-01-18 23:00:00,2022-01-19 00:00:00,181,0,196,0,0,3275,3652,18802
2022-01-19 00:00:00,2022-01-19 01:00:00,226,0,196,0,0,3403,3825,18390
2022-01-19 01:00:00,2022-01-19 02:00:00,228,0,196,0,0,3417,3841,18436
2022-01-19 02:00:00,2022-01-19 03:00:00,232,0,196,0,0,3393,3821,18862
2022-01-19 03:00:00,2022-01-19 04:00:00,231,0,197,0,0,3349,3777,19706
2022-01-19 04:00:00,2022-01-19 05:00:00,233,10,203,0,0,3236,3682,22209
2022-01-19 05:00:00,2022-01-19 06:00:00,235,6,210,0,4,3133,3588,24195
2022-01-19 06:00:00,2022-01-19 07:00:00,234,52,221,38,93,3060,3698,24954
2022-01-19 07:00:00,2022-01-19 08:00:00,230,347,243,43,417,2894,4174,25317
2022-01-19 08:00:00,2022-01-19 09:00:00,224,410,247,11,769,2612,4273,25069
2022-01-19 09:00:00,2022-01-19 10:00:00,235,406,249,8,1016,2358,4272,25018
2022-01-19 10:00:00,2022-01-19 11:00:00,233,322,240,5,1128,2276,4204,24873
2022-01-19 11:00:00,2022-01-19 12:00:00,234,459,238,13,1090,2183,4217,24838
2022-01-19 12:00:00,2022-01-19 13:00:00,235,636,233,14,855,2297,4270,24696
2022-01-19 13:00:00,2022-01-19 14:00:00,237,627,237,14,395,2809,4319,24753
2022-01-19 14:00:00,2022-01-19 15:00:00,235,571,247,14,49,3317,4433,25273
2022-01-19 15:00:00,2022-01-19 16:00:00,234,617,249,14,0,3916,5030,25440
2022-01-19 16:00:00,2022-01-19 17:00:00,233,566,238,14,0,4405,5456,25132
2022-01-19 17:00:00,2022-01-19 18:00:00,235,612,221,14,0,4964,6046,24966
2022-01-19 18:00:00,2022-01-19 19:00:00,235,352,216,14,0,5448,6265,24495
2022-01-19 19:00:00,2022-01-19 20:00:00,233,269,203,14,0,5715,6434,22947
2022-01-19 20:00:00,2022-01-19 21:00:00,229,9,200,14,0,6068,6520,21639
2022-01-19 21:00:00,2022-01-19 22:00:00,232,0,201,14,0,6090,6537,20237
2022-01-19 22:00:00,2022-01-19 23:00:00,225,0,191,14,0,6114,6544,19250
2022-01-19 23:00:00,2022-01-20 00:00:00,226,0,189,14,0,6237,6666,18524
2022-01-20 00:00:00,2022-01-20 01:00:00,227,0,189,14,0,6284,6714,18110
2022-01-20 01:00:00,2022-01-20 02:00:00,227,0,188,14,0,6277,6706,18142
2022-01-20 02:00:00,2022-01-20 03:00:00,232,0,183,14,0,6338,6767,18419
2022-01-20 03:00:00,2022-01-20 04:00:00,235,0,183,14,0,6249,6681,19283
2022-01-20 04:00:00,2022-01-20 05:00:00,235,0,183,14,0,6215,6647,21912
2022-01-20 05:00:00,2022-01-20 06:00:00,234,26,184,14,3,6285,6746,23814
2022-01-20 06:00:00,2022-01-20 07:00:00,234,253,199,14,94,6253,7047,24704
2022-01-20 07:00:00,2022-01-20 08:00:00,236,389,217,14,343,6192,7391,25017
2022-01-20 08:00:00,2022-01-20 09:00:00,236,190,218,14,748,6231,7637,24862
2022-01-20 09:00:00,2022-01-20 10:00:00,235,158,218,14,1175,6227,8027,25333
2022-01-20 10:00:00,2022-01-20 11:00:00,234,142,215,14,983,6198,7786,25413
2022-01-20 11:00:00,2022-01-20 12:00:00,233,149,197,14,837,6219,7649,25559
2022-01-20 12:00:00,2022-01-20 13:00:00,231,121,197,14,740,6195,7498,25444
2022-01-20 13:00:00,2022-01-20 14:00:00,231,56,196,14,305,6084,6886,25057
2022-01-20 14:00:00,2022-01-20 15:00:00,232,515,210,14,50,6038,7059,25456
2022-01-20 15:00:00,2022-01-20 16:00:00,231,951,211,14,0,6027,7434,25778
2022-01-20 16:00:00,2022-01-20 17:00:00,230,765,203,14,0,5954,7166,25462
2022-01-20 17:00:00,2022-01-20 18:00:00,228,471,203,14,0,5987,6903,25274
2022-01-20 18:00:00,2022-01-20 19:00:00,230,215,198,14,0,6055,6712,24719
2022-01-20 19:00:00,2022-01-20 20:00:00,231,156,197,14,0,6036,6634,23256
2022-01-20 20:00:00,2022-01-20 21:00:00,232,20,190,14,0,5945,6401,21681
2022-01-20 21:00:00,2022-01-20 22:00:00,231,0,185,14,0,5907,6337,20396
2022-01-20 22:00:00,2022-01-20 23:00:00,225,0,183,14,0,6013,6435,19487
2022-01-20 23:00:00,2022-01-21 00:00:00,224,0,183,14,0,6069,6490,18894
2022-01-21 00:00:00,2022-01-21 01:00:00,224,0,183,14,0,6087,6508,18551
2022-01-21 01:00:00,2022-01-21 02:00:00,223,0,183,14,0,6204,6624,18580
2022-01-21 02:00:00,2022-01-21 03:00:00,229,0,183,14,0,6216,6642,18852
2022-01-21 03:00:00,2022-01-21 04:00:00,230,0,183,14,0,6150,6577,19778
2022-01-21 04:00:00,2022-01-21 05:00:00,234,4,183,14,0,6163,6598,22312
2022-01-21 05:00:00,2022-01-21 06:00:00,235,20,179,14,9,6128,6585,24188
2022-01-21 06:00:00,2022-01-21 07:00:00,236,31,187,14,113,5994,6575,25037
2022-01-21 07:00:00,2022-01-21 08:00:00,237,69,205,14,467,5945,6937,25436
2022-01-21 08:00:00,2022-01-21 09:00:00,238,90,196,14,854,5883,7275,25440
2022-01-21 09:00:00,2022-01-21 10:00:00,240,145,195,14,1091,5916,7601,25662
2022-01-21 10:00:00,2022-01-21 11:00:00,241,55,187,14,1106,5828,7431,25706
2022-01-21 11:00:00,2022-01-21 12:00:00,239,6,186,14,866,5747,7058,25754
2022-01-21 12:00:00,2022-01-21 13:00:00,238,0,197,14,598,5617,6664,25300
2022-01-21 13:00:00,2022-01-21 14:00:00,232,0,199,14,300,5405,6150,25113
2022-01-21 14:00:00,2022-01-21 15:00:00,230,271,208,14,45,5064,5832,25516
2022-01-21 15:00:00,2022-01-21 16:00:00,230,483,229,14,0,5033,5989,25722
2022-01-21 16:00:00,2022-01-21 17:00:00,228,440,240,14,0,5206,6128,25234
2022-01-21 17:00:00,2022-01-21 18:00:00,229,381,241,14,0,5043,5908,25154
2022-01-21 18:00:00,2022-01-21 19:00:00,229,257,228,14,0,4582,5310,24531
2022-01-21 19:00:00,2022-01-21 20:00:00,229,64,198,14,0,4174,4679,22996
2022-01-21 20:00:00,2022-01-21 21:00:00,227,0,182,14,0,3964,4387,21680
2022-01-21 21:00:00,2022-01-21 22:00:00,229,23,180,14,0,3773,4219,20562
2022-01-21 22:00:00,2022-01-21 23:00:00,202,3,178,14,0,3668,4065,19510
2022-01-21 23:00:00,2022-01-22 00:00:00,160,0,175,14,0,3672,4021,18900
2022-01-22 00:00:00,2022-01-22 01:00:00,155,0,174,14,0,3666,4009,18367
2022-01-22 01:00:00,2022-01-22 02:00:00,154,0,174,14,0,3771,4113,18193
2022-01-22 02:00:00,2022-01-22 03:00:00,153,0,174,14,0,3902,4243,18349
2022-01-22 03:00:00,2022-01-22 04:00:00,150,0,174,14,0,3974,4312,18521
2022-01-22 04:00:00,2022-01-22 05:00:00,149,0,174,14,0,3923,4260,19510
2022-01-22 05:00:00,2022-01-22 06:00:00,150,0,182,14,8,3938,4292,20336
2022-01-22 06:00:00,2022-01-22 07:00:00,150,53,202,14,110,3750,4279,21613
2022-01-22 07:00:00,2022-01-22 08:00:00,150,310,215,14,432,3287,4408,22674
2022-01-22 08:00:00,2022-01-22 09:00:00,151,89,219,14,827,2945,4245,23285
2022-01-22 09:00:00,2022-01-22 10:00:00,149,623,221,14,1022,2503,4532,23314
2022-01-22 10:00:00,2022-01-22 11:00:00,150,134,222,14,1107,2484,4111,23142
2022-01-22 11:00:00,2022-01-22 12:00:00,152,45,232,2,1071,2201,3703,22959
2022-01-22 12:00:00,2022-01-22 13:00:00,150,36,232,0,706,2082,3206,22512
2022-01-22 13:00:00,2022-01-22 14:00:00,150,39,237,0,349,1918,2693,22047
2022-01-22 14:00:00,2022-01-22 15:00:00,150,127,247,0,60,1902,2486,22404
2022-01-22 15:00:00,2022-01-22 16:00:00,150,557,256,0,0,1970,2933,22817
2022-01-22 16:00:00,2022-01-22 17:00:00,148,481,251,0,0,2037,2917,22640
2022-01-22 17:00:00,2022-01-22 18:00:00,148,286,242,0,0,1891,2567,22430
2022-01-22 18:00:00,2022-01-22 19:00:00,149,46,236,0,0,1794,2225,21872
2022-01-22 19:00:00,2022-01-22 20:00:00,149,5,236,0,0,1812,2202,20706
2022-01-22 20:00:00,2022-01-22 21:00:00,149,0,232,0,0,1762,2143,19582
2022-01-22 21:00:00,2022-01-22 22:00:00,150,0,231,0,0,1709,2090,18499
2022-01-22 22:00:00,2022-01-22 23:00:00,156,0,206,0,0,1545,1907,17415
2022-01-22 23:00:00,2022-01-23 00:00:00,157,0,202,0,0,1432,1791,16899
2022-01-23 00:00:00,2022-01-23 01:00:00,157,0,202,0,0,1351,1710,16508
2022-01-23 01:00:00,2022-01-23 02:00:00,156,0,202,0,0,1316,1674,16307
2022-01-23 02:00:00,2022-01-23 03:00:00,152,0,202,0,0,1203,1557,16515
2022-01-23 03:00:00,2022-01-23 04:00:00,148,0,202,0,0,1039,1389,16619
2022-01-23 04:00:00,2022-01-23 05:00:00,150,0,201,0,0,835,1186,17016
2022-01-23 05:00:00,2022-01-23 06:00:00,150,0,202,0,9,700,1061,17262
2022-01-23 06:00:00,2022-01-23 07:00:00,150,12,201,0,92,568,1023,18160
2022-01-23 07:00:00,2022-01-23 08:00:00,153,2,204,0,336,441,1136,19182
2022-01-23 08:00:00,2022-01-23 09:00:00,154,0,200,0,701,326,1381,19876
2022-01-23 09:00:00,2022-01-23 10:00:00,154,0,200,0,1025,266,1645,20282
2022-01-23 10:00:00,2022-01-23 11:00:00,157,0,205,0,1051,240,1653,20499
2022-01-23 11:00:00,2022-01-23 12:00:00,155,0,205,0,946,177,1483,20564
2022-01-23 12:00:00,2022-01-23 13:00:00,152,0,200,0,667,149,1168,20322
2022-01-23 13:00:00,2022-01-23 14:00:00,151,0,202,0,323,160,836,19968
2022-01-23 14:00:00,2022-01-23 15:00:00,150,56,196,0,55,239,696,20383
2022-01-23 15:00:00,2022-01-23 16:00:00,151,319,203,38,0,254,965,21120
2022-01-23 16:00:00,2022-01-23 17:00:00,150,398,207,43,0,275,1073,21164
2022-01-23 17:00:00,2022-01-23 18:00:00,150,247,199,43,0,263,902,21196
2022-01-23 18:00:00,2022-01-23 19:00:00,152,340,192,5,0,208,897,20880
2022-01-23 19:00:00,2022-01-23 20:00:00,151,129,183,0,0,213,676,20033
2022-01-23 20:00:00,2022-01-23 21:00:00,152,41,181,0,0,307,681,19421
2022-01-23 21:00:00,2022-01-23 22:00:00,150,0,181,0,0,497,828,18444
2022-01-23 22:00:00,2022-01-23 23:00:00,159,0,169,0,0,594,922,17592
2022-01-23 23:00:00,2022-01-24 00:00:00,159,0,167,0,0,675,1001,17121
2022-01-24 00:00:00,2022-01-24 01:00:00,156,0,167,0,0,768,1091,16952
2022-01-24 01:00:00,2022-01-24 02:00:00,158,0,166,0,0,852,1176,16986
2022-01-24 02:00:00,2022-01-24 03:00:00,182,0,166,0,0,934,1282,17500
2022-01-24 03:00:00,2022-01-24 04:00:00,229,0,166,0,0,1037,1432,18618
2022-01-24 04:00:00,2022-01-24 05:00:00,233,0,160,0,0,1054,1447,21641
2022-01-24 05:00:00,2022-01-24 06:00:00,233,30,151,0,15,1092,1521,23850
2022-01-24 06:00:00,2022-01-24 07:00:00,231,331,170,0,151,1143,2026,24988
2022-01-24 07:00:00,2022-01-24 08:00:00,231,284,177,0,544,1110,2346,25607
2022-01-24 08:00:00,2022-01-24 09:00:00,234,51,164,38,935,1078,2500,25602
2022-01-24 09:00:00,2022-01-24 10:00:00,233,38,159,43,1218,1058,2749,25880
2022-01-24 10:00:00,2022-01-24 11:00:00,232,15,149,43,1179,1121,2739,25783
2022-01-24 11:00:00,2022-01-24 12:00:00,232,151,153,43,1004,1199,2782,25804
2022-01-24 12:00:00,2022-01-24 13:00:00,233,50,154,5,747,1336,2525,25514
2022-01-24 13:00:00,2022-01-24 14:00:00,234,124,173,0,388,1492,2411,25327
2022-01-24 14:00:00,2022-01-24 15:00:00,234,425,205,0,78,1597,2539,25568
2022-01-24 15:00:00,2022-01-24 16:00:00,235,599,221,0,0,1689,2744,25787
2022-01-24 16:00:00,2022-01-24 17:00:00,233,660,219,0,0,1755,2867,25420
2022-01-24 17:00:00,2022-01-24 18:00:00,232,549,211,0,0,1809,2801,25242
2022-01-24 18:00:00,2022-01-24 19:00:00,232,259,209,0,0,1840,2540,24589
2022-01-24 19:00:00,2022-01-24 20:00:00,231,140,202,0,0,1932,2505,23088
2022-01-24 20:00:00,2022-01-24 21:00:00,233,51,202,0,0,2125,2611,21629
2022-01-24 21:00:00,2022-01-24 22:00:00,231,0,203,0,0,2330,2764,20331
2022-01-24 22:00:00,2022-01-24 23:00:00,227,0,189,0,0,2459,2875,19306
2022-01-24 23:00:00,2022-01-25 00:00:00,228,0,185,0,0,2559,2972,18764
2022-01-25 00:00:00,2022-01-25 01:00:00,228,0,185,0,0,2515,2928,18395
2022-01-25 01:00:00,2022-01-25 02:00:00,228,0,185,0,0,2551,2964,18457
2022-01-25 02:00:00,2022-01-25 03:00:00,231,0,185,0,0,2621,3037,18790
2022-01-25 03:00:00,2022-01-25 04:00:00,232,0,176,0,0,2725,3133,19668
2022-01-25 04:00:00,2022-01-25 05:00:00,233,0,167,0,0,2767,3167,22133
2022-01-25 05:00:00,2022-01-25 06:00:00,233,0,157,0,4,2641,3035,23877
2022-01-25 06:00:00,2022-01-25 07:00:00,234,24,147,0,56,2702,3163,24939
2022-01-25 07:00:00,2022-01-25 08:00:00,234,101,137,0,218,2803,3493,25403
2022-01-25 08:00:00,2022-01-25 09:00:00,234,0,126,0,433,2709,3502,25396
2022-01-25 09:00:00,2022-01-25 10:00:00,234,11,126,0,569,2679,3619,25766
2022-01-25 10:00:00,2022-01-25 11:00:00,234,4,127,0,618,2705,3688,25844
2022-01-25 11:00:00,2022-01-25 12:00:00,198,36,127,0,572,2649,3582,25907
2022-01-25 12:00:00,2022-01-25 13:00:00,194,50,151,0,410,2410,3215,25480
2022-01-25 13:00:00,2022-01-25 14:00:00,220,54,171,0,197,2205,2847,25194
2022-01-25 14:00:00,2022-01-25 15:00:00,233,489,192,38,34,2128,3114,25402
2022-01-25 15:00:00,2022-01-25 16:00:00,230,673,212,43,0,2078,3236,25645
2022-01-25 16:00:00,2022-01-25 17:00:00,232,596,217,43,0,2121,3209,25304
2022-01-25 17:00:00,2022-01-25 18:00:00,231,504,215,43,0,2061,3054,25183
2022-01-25 18:00:00,2022-01-25 19:00:00,232,345,211,5,0,1929,2722,24556
2022-01-25 19:00:00,2022-01-25 20:00:00,231,19,215,0,0,1739,2204,23076
2022-01-25 20:00:00,2022-01-25 21:00:00,230,16,202,0,0,1631,2079,21626
2022-01-25 21:00:00,2022-01-25 22:00:00,231,0,200,0,0,1503,1934,20269
2022-01-25 22:00:00,2022-01-25 23:00:00,227,0,200,0,0,1484,1911,19186
2022-01-25 23:00:00,2022-01-26 00:00:00,226,0,201,0,0,1462,1889,18596
2022-01-26 00:00:00,2022-01-26 01:00:00,227,0,201,0,0,1533,1961,18227
2022-01-26 01:00:00,2022-01-26 02:00:00,227,0,196,0,0,1691,2114,18271
2022-01-26 02:00:00,2022-01-26 03:00:00,232,0,187,0,0,1798,2217,18756
2022-01-26 03:00:00,2022-01-26 04:00:00,231,2,177,0,0,1933,2343,19638
2022-01-26 04:00:00,2022-01-26 05:00:00,233,21,169,0,0,2092,2515,21842
2022-01-26 05:00:00,2022-01-26 06:00:00,233,77,161,0,6,2240,2717,23671
2022-01-26 06:00:00,2022-01-26 07:00:00,232,412,166,38,84,2373,3305,24773
2022-01-26 07:00:00,2022-01-26 08:00:00,232,439,180,43,211,2671,3776,25205
2022-01-26 08:00:00,2022-01-26 09:00:00,232,379,163,43,374,2954,4145,25194
2022-01-26 09:00:00,2022-01-26 10:00:00,233,297,162,5,516,3420,4633,25614
2022-01-26 10:00:00,2022-01-26 11:00:00,231,319,153,0,546,3856,5105,25772
2022-01-26 11:00:00,2022-01-26 12:00:00,233,420,145,0,453,4061,5312,25873
2022-01-26 12:00:00,2022-01-26 13:00:00,230,289,155,0,312,4243,5229,25478
2022-01-26 13:00:00,2022-01-26 14:00:00,233,108,166,0,141,4487,5135,25075
2022-01-26 14:00:00,2022-01-26 15:00:00,232,32,176,0,28,4732,5200,25248
2022-01-26 15:00:00,2022-01-26 16:00:00,233,66,186,0,0,5044,5529,25581
2022-01-26 16:00:00,2022-01-26 17:00:00,233,22,195,0,0,5264,5714,25185
2022-01-26 17:00:00,2022-01-26 18:00:00,230,183,205,0,0,5398,6016,25086
2022-01-26 18:00:00,2022-01-26 19:00:00,230,240,215,0,0,5549,6234,24415
2022-01-26 19:00:00,2022-01-26 20:00:00,229,287,221,0,0,5514,6251,22806
2022-01-26 20:00:00,2022-01-26 21:00:00,230,205,205,0,0,5417,6057,21355
2022-01-26 21:00:00,2022-01-26 22:00:00,231,16,203,0,0,5351,5801,19985
2022-01-26 22:00:00,2022-01-26 23:00:00,224,0,202,0,0,5281,5707,19081
2022-01-26 23:00:00,2022-01-27 00:00:00,224,0,202,0,0,5244,5670,18504
2022-01-27 00:00:00,2022-01-27 01:00:00,226,0,202,0,0,5171,5599,18105
2022-01-27 01:00:00,2022-01-27 02:00:00,225,0,198,0,0,5236,5659,18228
2022-01-27 02:00:00,2022-01-27 03:00:00,229,0,189,0,0,5230,5648,18518
2022-01-27 03:00:00,2022-01-27 04:00:00,230,0,179,0,0,5250,5659,19274
2022-01-27 04:00:00,2022-01-27 05:00:00,233,15,169,0,0,5418,5835,21732
2022-01-27 05:00:00,2022-01-27 06:00:00,232,6,158,0,7,5600,6003,23489
2022-01-27 06:00:00,2022-01-27 07:00:00,233,46,181,38,51,5734,6283,24560
2022-01-27 07:00:00,2022-01-27 08:00:00,231,161,196,43,248,5920,6799,25132
2022-01-27 08:00:00,2022-01-27 09:00:00,232,299,187,43,383,6081,7225,25210
2022-01-27 09:00:00,2022-01-27 10:00:00,232,328,178,43,377,6101,7259,25472
2022-01-27 10:00:00,2022-01-27 11:00:00,232,287,171,5,499,6116,7310,25762
2022-01-27 11:00:00,2022-01-27 12:00:00,231,369,166,0,456,6164,7386,25835
2022-01-27 12:00:00,2022-01-27 13:00:00,230,217,160,0,365,6213,7185,25472
2022-01-27 13:00:00,2022-01-27 14:00:00,230,301,159,0,253,6297,7240,25215
2022-01-27 14:00:00,2022-01-27 15:00:00,230,394,177,0,40,6367,7208,25221
2022-01-27 15:00:00,2022-01-27 16:00:00,232,406,188,0,0,6343,7169,25406
2022-01-27 16:00:00,2022-01-27 17:00:00,232,272,189,0,0,6435,7128,25147
2022-01-27 17:00:00,2022-01-27 18:00:00,231,362,194,0,0,6522,7309,24880
2022-01-27 18:00:00,2022-01-27 19:00:00,232,343,203,0,0,6548,7326,24136
2022-01-27 19:00:00,2022-01-27 20:00:00,231,323,208,0,0,6513,7275,22577
2022-01-27 20:00:00,2022-01-27 21:00:00,230,171,204,0,0,6427,7032,21208
2022-01-27 21:00:00,2022-01-27 22:00:00,229,19,204,0,0,6412,6864,19874
2022-01-27 22:00:00,2022-01-27 23:00:00,224,0,200,0,0,6396,6820,18786
2022-01-27 23:00:00,2022-01-28 00:00:00,225,0,200,0,0,6404,6829,18214
2022-01-28 00:00:00,2022-01-28 01:00:00,225,0,199,0,0,6377,6801,17851
2022-01-28 01:00:00,2022-01-28 02:00:00,222,0,195,0,0,6359,6776,17834
2022-01-28 02:00:00,2022-01-28 03:00:00,228,0,186,0,0,6370,6784,18260
2022-01-28 03:00:00,2022-01-28 04:00:00,229,0,176,0,0,6379,6784,19074
2022-01-28 04:00:00,2022-01-28 05:00:00,229,0,167,0,0,6433,6829,21521
2022-01-28 05:00:00,2022-01-28 06:00:00,230,0,158,0,8,6415,6811,23130
2022-01-28 06:00:00,2022-01-28 07:00:00,232,70,167,0,60,6365,6894,24292
2022-01-28 07:00:00,2022-01-28 08:00:00,231,49,166,0,197,6312,6955,24958
2022-01-28 08:00:00,2022-01-28 09:00:00,231,5,169,0,379,6326,7110,24986
2022-01-28 09:00:00,2022-01-28 10:00:00,230,0,172,0,512,6391,7305,25372
2022-01-28 10:00:00,2022-01-28 11:00:00,228,0,173,0,559,6425,7385,25505
2022-01-28 11:00:00,2022-01-28 12:00:00,228,0,167,0,535,6314,7244,25481
2022-01-28 12:00:00,2022-01-28 13:00:00,228,0,168,0,514,6275,7185,25185
2022-01-28 13:00:00,2022-01-28 14:00:00,229,65,175,0,334,6090,6893,24894
2022-01-28 14:00:00,2022-01-28 15:00:00,228,362,196,0,91,5673,6550,25033
2022-01-28 15:00:00,2022-01-28 16:00:00,229,540,228,43,0,5363,6403,25310
2022-01-28 16:00:00,2022-01-28 17:00:00,230,456,248,57,0,5326,6317,24959
2022-01-28 17:00:00,2022-01-28 18:00:00,231,391,254,57,0,5001,5934,24771
2022-01-28 18:00:00,2022-01-28 19:00:00,230,321,235,57,0,4660,5503,24172
2022-01-28 19:00:00,2022-01-28 20:00:00,229,83,234,7,0,4118,4671,22653
2022-01-28 20:00:00,2022-01-28 21:00:00,230,0,229,0,0,3764,4223,21201
2022-01-28 21:00:00,2022-01-28 22:00:00,229,0,214,0,0,3519,3962,20069
2022-01-28 22:00:00,2022-01-28 23:00:00,193,0,212,0,0,3259,3664,18897
2022-01-28 23:00:00,2022-01-29 00:00:00,147,0,212,0,0,3207,3566,18256
2022-01-29 00:00:00,2022-01-29 01:00:00,150,0,212,0,0,3237,3599,17818
2022-01-29 01:00:00,2022-01-29 02:00:00,150,0,212,0,0,3152,3514,17697
2022-01-29 02:00:00,2022-01-29 03:00:00,150,0,212,0,0,3120,3482,17777
2022-01-29 03:00:00,2022-01-29 04:00:00,149,0,212,0,0,3272,3633,17987
2022-01-29 04:00:00,2022-01-29 05:00:00,150,0,207,0,0,3494,3851,19052
2022-01-29 05:00:00,2022-01-29 06:00:00,151,50,200,0,27,3755,4183,19745
2022-01-29 06:00:00,2022-01-29 07:00:00,151,120,210,50,252,4140,4923,20756
2022-01-29 07:00:00,2022-01-29 08:00:00,151,250,208,57,743,4448,5857,21700
2022-01-29 08:00:00,2022-01-29 09:00:00,151,291,190,57,1051,4738,6478,21977
2022-01-29 09:00:00,2022-01-29 10:00:00,152,319,176,7,1032,5173,6859,22244
2022-01-29 10:00:00,2022-01-29 11:00:00,150,330,167,0,920,5566,7133,22376
2022-01-29 11:00:00,2022-01-29 12:00:00,151,326,161,0,786,5833,7257,22631
2022-01-29 12:00:00,2022-01-29 13:00:00,149,274,164,0,470,6093,7150,22100
2022-01-29 13:00:00,2022-01-29 14:00:00,151,178,180,0,224,6354,7087,21892
2022-01-29 14:00:00,2022-01-29 15:00:00,150,141,196,0,35,6530,7052,22158
2022-01-29 15:00:00,2022-01-29 16:00:00,149,376,227,0,0,6646,7398,22514
2022-01-29 16:00:00,2022-01-29 17:00:00,151,360,248,0,0,6574,7333,22180
2022-01-29 17:00:00,2022-01-29 18:00:00,152,376,249,0,0,6383,7160,21801
2022-01-29 18:00:00,2022-01-29 19:00:00,150,435,222,0,0,6187,6994,21069
2022-01-29 19:00:00,2022-01-29 20:00:00,150,361,213,0,0,5639,6363,19772
2022-01-29 20:00:00,2022-01-29 21:00:00,150,300,213,0,0,4974,5637,18713
2022-01-29 21:00:00,2022-01-29 22:00:00,151,4,204,0,0,4502,4861,17384
2022-01-29 22:00:00,2022-01-29 23:00:00,152,0,207,0,0,4195,4554,16521
2022-01-29 23:00:00,2022-01-30 00:00:00,151,0,207,0,0,4351,4709,15893
2022-01-30 00:00:00,2022-01-30 01:00:00,148,0,207,0,0,4436,4791,15543
2022-01-30 01:00:00,2022-01-30 02:00:00,150,0,205,0,0,4274,4629,15228
2022-01-30 02:00:00,2022-01-30 03:00:00,148,0,202,0,0,4175,4525,15264
2022-01-30 03:00:00,2022-01-30 04:00:00,147,0,205,0,0,4444,4796,15705
2022-01-30 04:00:00,2022-01-30 05:00:00,148,0,206,0,0,4571,4925,16109
2022-01-30 05:00:00,2022-01-30 06:00:00,148,0,206,0,22,4553,4929,16338
2022-01-30 06:00:00,2022-01-30 07:00:00,145,0,220,0,114,4563,5042,17222
2022-01-30 07:00:00,2022-01-30 08:00:00,149,35,229,25,307,4724,5469,18220
2022-01-30 08:00:00,2022-01-30 09:00:00,148,134,242,29,476,4859,5888,19173
2022-01-30 09:00:00,2022-01-30 10:00:00,148,23,243,29,570,5069,6082,19564
2022-01-30 10:00:00,2022-01-30 11:00:00,148,0,246,4,571,5345,6314,19846
2022-01-30 11:00:00,2022-01-30 12:00:00,147,0,247,0,535,5496,6425,20188
2022-01-30 12:00:00,2022-01-30 13:00:00,147,0,247,0,428,5580,6402,20010
2022-01-30 13:00:00,2022-01-30 14:00:00,147,83,234,0,218,5659,6341,19676
2022-01-30 14:00:00,2022-01-30 15:00:00,146,219,237,0,50,5612,6264,19883
2022-01-30 15:00:00,2022-01-30 16:00:00,147,629,267,25,0,5582,6650,20564
2022-01-30 16:00:00,2022-01-30 17:00:00,148,844,264,29,0,5701,6986,20702
2022-01-30 17:00:00,2022-01-30 18:00:00,147,701,249,29,0,5791,6917,20596
2022-01-30 18:00:00,2022-01-30 19:00:00,145,370,237,4,0,5816,6572,20022
2022-01-30 19:00:00,2022-01-30 20:00:00,147,115,231,0,0,5852,6345,19084
2022-01-30 20:00:00,2022-01-30 21:00:00,149,131,218,0,0,5712,6210,18530
2022-01-30 21:00:00,2022-01-30 22:00:00,149,49,221,0,0,5544,5963,17466
2022-01-30 22:00:00,2022-01-30 23:00:00,149,0,214,0,0,5374,5737,16753
2022-01-30 23:00:00,2022-01-31 00:00:00,149,0,208,0,0,5010,5367,16294
2022-01-31 00:00:00,2022-01-31 01:00:00,148,0,208,0,0,4548,4904,16118
2022-01-31 01:00:00,2022-01-31 02:00:00,169,0,207,0,0,4169,4545,16192
2022-01-31 02:00:00,2022-01-31 03:00:00,211,0,200,0,0,3764,4175,16603
2022-01-31 03:00:00,2022-01-31 04:00:00,226,0,191,0,0,3465,3882,17891
2022-01-31 04:00:00,2022-01-31 05:00:00,224,0,178,0,0,2934,3336,20888
2022-01-31 05:00:00,2022-01-31 06:00:00,226,0,170,0,27,2440,2863,22887
2022-01-31 06:00:00,2022-01-31 07:00:00,227,3,156,0,157,1996,2539,24196
2022-01-31 07:00:00,2022-01-31 08:00:00,203,48,146,0,455,1634,2486,24708
2022-01-31 08:00:00,2022-01-31 09:00:00,192,3,135,0,784,1255,2369,24721
2022-01-31 09:00:00,2022-01-31 10:00:00,190,2,132,0,1084,1074,2482,25084
2022-01-31 10:00:00,2022-01-31 11:00:00,207,10,144,0,1130,1006,2497,25271
2022-01-31 11:00:00,2022-01-31 12:00:00,219,19,145,0,1155,889,2427,25546
2022-01-31 12:00:00,2022-01-31 13:00:00,224,3,178,0,861,845,2111,25061
2022-01-31 13:00:00,2022-01-31 14:00:00,233,51,201,50,484,739,1758,24730
2022-01-31 14:00:00,2022-01-31 15:00:00,233,272,217,57,119,707,1605,24846
2022-01-31 15:00:00,2022-01-31 16:00:00,229,428,252,57,0,832,1798,25312
2022-01-31 16:00:00,2022-01-31 17:00:00,231,597,276,57,0,1006,2167,25137
2022-01-31 17:00:00,2022-01-31 18:00:00,229,418,266,58,0,1144,2115,24920
2022-01-31 18:00:00,2022-01-31 19:00:00,228,269,265,7,0,1187,1956,24349
2022-01-31 19:00:00,2022-01-31 20:00:00,228,274,254,0,0,1279,2035,22946
2022-01-31 20:00:00,2022-01-31 21:00:00,227,28,236,0,0,1268,1759,21515
2022-01-31 21:00:00,2022-01-31 22:00:00,227,0,230,0,0,1258,1715,20225
2022-01-31 22:00:00,2022-01-31 23:00:00,221,0,223,0,0,1221,1665,19212
2022-01-31 23:00:00,2022-02-01 00:00:00,223,0,221,0,0,1430,1874,18627
2022-02-01 00:00:00,2022-02-01 01:00:00,223,0,221,0,0,1564,2008,18355
2022-02-01 01:00:00,2022-02-01 02:00:00,222,0,221,0,0,1470,1913,18261
2022-02-01 02:00:00,2022-02-01 03:00:00,227,0,221,0,0,1422,1870,18552
2022-02-01 03:00:00,2022-02-01 04:00:00,230,0,208,0,0,1484,1922,19421
2022-02-01 04:00:00,2022-02-01 05:00:00,230,10,193,0,0,1648,2081,21900
2022-02-01 05:00:00,2022-02-01 06:00:00,230,248,178,0,39,1823,2518,23600
2022-02-01 06:00:00,2022-02-01 07:00:00,230,549,169,47,212,2156,3363,24558
2022-02-01 07:00:00,2022-02-01 08:00:00,228,486,192,58,458,2251,3673,24757
2022-02-01 08:00:00,2022-02-01 09:00:00,230,300,178,58,781,2352,3899,24894
2022-02-01 09:00:00,2022-02-01 10:00:00,229,336,176,7,1056,2579,4383,25517
2022-02-01 10:00:00,2022-02-01 11:00:00,227,319,174,0,1004,2775,4499,25671
2022-02-01 11:00:00,2022-02-01 12:00:00,228,426,173,0,908,2881,4616,25865
2022-02-01 12:00:00,2022-02-01 13:00:00,230,426,186,0,672,3117,4631,25457
2022-02-01 13:00:00,2022-02-01 14:00:00,229,170,204,0,382,3358,4343,25148
2022-02-01 14:00:00,2022-02-01 15:00:00,229,217,230,50,120,3895,4741,25145
2022-02-01 15:00:00,2022-02-01 16:00:00,227,202,246,58,3,4454,5190,25578
2022-02-01 16:00:00,2022-02-01 17:00:00,231,56,273,7,0,4693,5260,25241
2022-02-01 17:00:00,2022-02-01 18:00:00,228,40,285,0,0,4687,5240,24952
2022-02-01 18:00:00,2022-02-01 19:00:00,228,5,272,0,0,4782,5287,24276
2022-02-01 19:00:00,2022-02-01 20:00:00,230,0,285,0,0,5003,5518,22861
2022-02-01 20:00:00,2022-02-01 21:00:00,228,0,263,0,0,5113,5604,21484
2022-02-01 21:00:00,2022-02-01 22:00:00,226,0,255,0,0,5083,5564,20177
2022-02-01 22:00:00,2022-02-01 23:00:00,222,0,254,0,0,4709,5185,19209
2022-02-01 23:00:00,2022-02-02 00:00:00,222,0,254,0,0,4691,5167,18623
2022-02-02 00:00:00,2022-02-02 01:00:00,223,0,254,0,0,4858,5335,18268
2022-02-02 01:00:00,2022-02-02 02:00:00,221,0,239,0,0,4707,5167,18277
2022-02-02 02:00:00,2022-02-02 03:00:00,225,0,224,0,0,4582,5031,18660
2022-02-02 03:00:00,2022-02-02 04:00:00,229,0,209,0,0,4344,4782,19544
2022-02-02 04:00:00,2022-02-02 05:00:00,229,6,194,0,0,4219,4648,21894
2022-02-02 05:00:00,2022-02-02 06:00:00,227,11,178,0,16,3948,4380,23555
2022-02-02 06:00:00,2022-02-02 07:00:00,225,16,179,0,90,3635,4145,24519
2022-02-02 07:00:00,2022-02-02 08:00:00,216,56,190,0,305,3482,4249,24931
2022-02-02 08:00:00,2022-02-02 09:00:00,216,24,180,0,557,3383,4360,25011
2022-02-02 09:00:00,2022-02-02 10:00:00,216,231,178,0,744,3520,4889,25463
2022-02-02 10:00:00,2022-02-02 11:00:00,216,291,178,0,667,3729,5081,25451
2022-02-02 11:00:00,2022-02-02 12:00:00,216,290,176,0,681,3666,5029,25483
2022-02-02 12:00:00,2022-02-02 13:00:00,217,75,188,0,488,3640,4608,25074
2022-02-02 13:00:00,2022-02-02 14:00:00,217,0,216,0,277,3656,4366,24900
2022-02-02 14:00:00,2022-02-02 15:00:00,218,40,239,50,91,3690,4328,24935
2022-02-02 15:00:00,2022-02-02 16:00:00,218,213,255,58,3,3545,4292,25271
2022-02-02 16:00:00,2022-02-02 17:00:00,219,228,270,58,0,3298,4073,25044
2022-02-02 17:00:00,2022-02-02 18:00:00,218,192,285,58,0,2967,3720,25035
2022-02-02 18:00:00,2022-02-02 19:00:00,217,283,297,7,0,2768,3572,24434
2022-02-02 19:00:00,2022-02-02 20:00:00,218,163,285,0,0,2439,3105,23077
2022-02-02 20:00:00,2022-02-02 21:00:00,216,83,252,0,0,2184,2735,21776
2022-02-02 21:00:00,2022-02-02 22:00:00,217,160,247,0,0,2040,2664,20497
2022-02-02 22:00:00,2022-02-02 23:00:00,215,0,239,0,0,1917,2371,19527
2022-02-02 23:00:00,2022-02-03 00:00:00,214,0,239,0,0,1944,2397,18925
2022-02-03 00:00:00,2022-02-03 01:00:00,212,0,239,0,0,1748,2199,18550
2022-02-03 01:00:00,2022-02-03 02:00:00,213,0,239,0,0,1697,2149,18582
2022-02-03 02:00:00,2022-02-03 03:00:00,221,0,239,0,0,1672,2132,18999
2022-02-03 03:00:00,2022-02-03 04:00:00,222,0,239,0,0,1668,2129,19722
2022-02-03 04:00:00,2022-02-03 05:00:00,221,0,239,0,0,1756,2216,22008
2022-02-03 05:00:00,2022-02-03 06:00:00,219,2,239,0,25,1741,2226,23654
2022-02-03 06:00:00,2022-02-03 07:00:00,220,89,233,0,146,1665,2353,24668
2022-02-03 07:00:00,2022-02-03 08:00:00,213,113,246,50,573,1458,2653,24956
2022-02-03 08:00:00,2022-02-03 09:00:00,220,14,269,58,1053,1156,2770,24771
2022-02-03 09:00:00,2022-02-03 10:00:00,219,29,256,7,1476,1027,3014,25033
2022-02-03 10:00:00,2022-02-03 11:00:00,219,216,257,0,1481,976,3149,24937
2022-02-03 11:00:00,2022-02-03 12:00:00,221,287,258,0,1465,939,3170,25196
2022-02-03 12:00:00,2022-02-03 13:00:00,219,287,258,0,1138,913,2815,24886
2022-02-03 13:00:00,2022-02-03 14:00:00,219,287,273,50,612,1129,2570,24804
2022-02-03 14:00:00,2022-02-03 15:00:00,220,485,280,57,143,1428,2613,24777
2022-02-03 15:00:00,2022-02-03 16:00:00,219,583,282,57,3,1781,2925,25347
2022-02-03 16:00:00,2022-02-03 17:00:00,219,558,281,57,0,2126,3241,25133
2022-02-03 17:00:00,2022-02-03 18:00:00,217,414,284,7,0,2306,3228,24992
2022-02-03 18:00:00,2022-02-03 19:00:00,216,27,277,0,0,2256,2776,24287
2022-02-03 19:00:00,2022-02-03 20:00:00,215,99,257,0,0,2192,2763,22853
2022-02-03 20:00:00,2022-02-03 21:00:00,219,0,238,0,0,2067,2524,21387
2022-02-03 21:00:00,2022-02-03 22:00:00,218,0,229,0,0,2032,2479,20184
2022-02-03 22:00:00,2022-02-03 23:00:00,216,0,234,0,0,1993,2443,19138
2022-02-03 23:00:00,2022-02-04 00:00:00,216,0,233,0,0,1942,2391,18522
2022-02-04 00:00:00,2022-02-04 01:00:00,217,0,233,0,0,1884,2334,18236
2022-02-04 01:00:00,2022-02-04 02:00:00,210,0,242,0,0,1761,2213,18147
2022-02-04 02:00:00,2022-02-04 03:00:00,216,0,244,0,0,1794,2254,18550
2022-02-04 03:00:00,2022-02-04 04:00:00,217,0,244,0,0,1801,2262,19392
2022-02-04 04:00:00,2022-02-04 05:00:00,219,3,245,0,0,1808,2275,21790
2022-02-04 05:00:00,2022-02-04 06:00:00,218,24,246,0,20,1777,2285,23559
2022-02-04 06:00:00,2022-02-04 07:00:00,218,226,262,50,114,1828,2698,24577
2022-02-04 07:00:00,2022-02-04 08:00:00,218,407,285,58,288,1853,3109,25012
2022-02-04 08:00:00,2022-02-04 09:00:00,218,336,295,58,478,1891,3276,25063
2022-02-04 09:00:00,2022-02-04 10:00:00,218,288,289,58,611,1894,3358,25334
2022-02-04 10:00:00,2022-02-04 11:00:00,218,298,276,58,660,1920,3430,25387
2022-02-04 11:00:00,2022-02-04 12:00:00,217,263,274,7,631,1996,3388,25451
2022-02-04 12:00:00,2022-02-04 13:00:00,217,2,283,0,515,2160,3177,24979
2022-02-04 13:00:00,2022-02-04 14:00:00,217,20,284,0,296,2484,3301,24632
2022-02-04 14:00:00,2022-02-04 15:00:00,218,378,288,0,83,2989,3956,24561
2022-02-04 15:00:00,2022-02-04 16:00:00,216,686,290,0,2,3390,4584,25046
2022-02-04 16:00:00,2022-02-04 17:00:00,219,639,284,0,0,3772,4914,24701
2022-02-04 17:00:00,2022-02-04 18:00:00,218,590,277,0,0,4064,5149,24336
2022-02-04 18:00:00,2022-02-04 19:00:00,217,585,273,0,0,4524,5599,23527
2022-02-04 19:00:00,2022-02-04 20:00:00,216,475,244,0,0,4906,5841,22127
2022-02-04 20:00:00,2022-02-04 21:00:00,217,155,240,0,0,5015,5627,20790
2022-02-04 21:00:00,2022-02-04 22:00:00,216,0,239,0,0,5365,5820,19568
2022-02-04 22:00:00,2022-02-04 23:00:00,212,0,229,0,0,5553,5994,18519
2022-02-04 23:00:00,2022-02-05 00:00:00,210,0,228,0,0,5777,6215,17863
2022-02-05 00:00:00,2022-02-05 01:00:00,209,0,228,0,0,5814,6251,17424
2022-02-05 01:00:00,2022-02-05 02:00:00,206,0,228,0,0,5978,6412,17281
2022-02-05 02:00:00,2022-02-05 03:00:00,211,0,228,0,0,6106,6545,17333
2022-02-05 03:00:00,2022-02-05 04:00:00,212,0,227,0,0,6094,6533,17569
2022-02-05 04:00:00,2022-02-05 05:00:00,213,0,228,0,0,6070,6511,18432
2022-02-05 05:00:00,2022-02-05 06:00:00,212,58,229,0,30,5861,6390,19186
2022-02-05 06:00:00,2022-02-05 07:00:00,212,60,230,0,178,5909,6589,20376
2022-02-05 07:00:00,2022-02-05 08:00:00,213,59,230,0,414,6003,6919,21161
2022-02-05 08:00:00,2022-02-05 09:00:00,212,22,237,0,695,5960,7126,21645
2022-02-05 09:00:00,2022-02-05 10:00:00,211,3,238,0,1055,6048,7555,22005
2022-02-05 10:00:00,2022-02-05 11:00:00,211,118,238,0,1198,6020,7785,21985
2022-02-05 11:00:00,2022-02-05 12:00:00,211,363,251,0,1036,5887,7748,21489
2022-02-05 12:00:00,2022-02-05 13:00:00,212,279,266,0,933,5771,7461,20949
2022-02-05 13:00:00,2022-02-05 14:00:00,208,222,267,0,511,5474,6682,20775
2022-02-05 14:00:00,2022-02-05 15:00:00,207,511,278,0,153,5242,6391,21098
2022-02-05 15:00:00,2022-02-05 16:00:00,209,966,280,50,3,5115,6623,22011
2022-02-05 16:00:00,2022-02-05 17:00:00,209,878,280,58,0,5165,6590,21843
2022-02-05 17:00:00,2022-02-05 18:00:00,208,445,280,58,0,5305,6296,21606
2022-02-05 18:00:00,2022-02-05 19:00:00,209,164,278,7,0,5262,5920,20904
2022-02-05 19:00:00,2022-02-05 20:00:00,209,10,252,0,0,5183,5654,19682
2022-02-05 20:00:00,2022-02-05 21:00:00,211,26,239,0,0,5288,5764,18739
2022-02-05 21:00:00,2022-02-05 22:00:00,209,3,234,0,0,5324,5770,17616
2022-02-05 22:00:00,2022-02-05 23:00:00,176,0,230,0,0,5445,5851,16618
2022-02-05 23:00:00,2022-02-06 00:00:00,142,0,230,0,0,5455,5827,15966
2022-02-06 00:00:00,2022-02-06 01:00:00,144,0,230,0,0,5678,6052,15627
2022-02-06 01:00:00,2022-02-06 02:00:00,140,0,230,0,0,5863,6233,15433
2022-02-06 02:00:00,2022-02-06 03:00:00,144,1,230,0,0,6074,6449,15507
2022-02-06 03:00:00,2022-02-06 04:00:00,141,9,230,0,0,6174,6554,15661
2022-02-06 04:00:00,2022-02-06 05:00:00,142,0,231,0,0,6256,6629,15966
2022-02-06 05:00:00,2022-02-06 06:00:00,141,0,231,0,38,6263,6673,16145
2022-02-06 06:00:00,2022-02-06 07:00:00,142,23,243,0,172,6289,6869,16928
2022-02-06 07:00:00,2022-02-06 08:00:00,141,27,260,0,418,6331,7177,17826
2022-02-06 08:00:00,2022-02-06 09:00:00,141,141,270,0,646,6363,7561,18498
2022-02-06 09:00:00,2022-02-06 10:00:00,142,173,290,0,772,6326,7703,19191
2022-02-06 10:00:00,2022-02-06 11:00:00,142,179,297,0,729,6176,7523,19429
2022-02-06 11:00:00,2022-02-06 12:00:00,141,296,298,0,656,5960,7351,19638
2022-02-06 12:00:00,2022-02-06 13:00:00,142,308,293,0,512,5706,6961,19361
2022-02-06 13:00:00,2022-02-06 14:00:00,141,191,292,0,293,5487,6404,18928
2022-02-06 14:00:00,2022-02-06 15:00:00,141,318,291,0,107,5608,6465,18993
2022-02-06 15:00:00,2022-02-06 16:00:00,142,527,290,50,3,5908,6920,19829
2022-02-06 16:00:00,2022-02-06 17:00:00,142,669,291,58,0,5897,7057,20031
2022-02-06 17:00:00,2022-02-06 18:00:00,142,278,291,58,0,5926,6695,19993
2022-02-06 18:00:00,2022-02-06 19:00:00,143,52,286,7,0,5887,6375,19560
2022-02-06 19:00:00,2022-02-06 20:00:00,141,9,269,0,0,5875,6294,18620
2022-02-06 20:00:00,2022-02-06 21:00:00,142,0,268,0,0,5725,6135,18148
2022-02-06 21:00:00,2022-02-06 22:00:00,143,0,240,0,0,5191,5574,17109
2022-02-06 22:00:00,2022-02-06 23:00:00,144,0,231,0,0,4822,5197,16336
2022-02-06 23:00:00,2022-02-07 00:00:00,143,0,229,0,0,4527,4899,16141
2022-02-07 00:00:00,2022-02-07 01:00:00,141,0,230,0,0,4106,4477,16065
2022-02-07 01:00:00,2022-02-07 02:00:00,141,0,229,0,0,3683,4053,16077
2022-02-07 02:00:00,2022-02-07 03:00:00,149,0,230,0,0,3645,4024,16428
2022-02-07 03:00:00,2022-02-07 04:00:00,189,0,230,0,0,3929,4348,17558
2022-02-07 04:00:00,2022-02-07 05:00:00,210,3,229,0,0,4006,4448,20580
2022-02-07 05:00:00,2022-02-07 06:00:00,211,11,229,0,30,4235,4716,22653
2022-02-07 06:00:00,2022-02-07 07:00:00,214,390,247,0,135,4429,5415,23967
2022-02-07 07:00:00,2022-02-07 08:00:00,215,442,255,0,340,4464,5716,24305
2022-02-07 08:00:00,2022-02-07 09:00:00,215,284,256,0,633,4774,6162,24387
2022-02-07 09:00:00,2022-02-07 10:00:00,214,268,256,0,828,5178,6744,24818
2022-02-07 10:00:00,2022-02-07 11:00:00,217,267,256,0,857,5596,7193,24852
2022-02-07 11:00:00,2022-02-07 12:00:00,216,167,253,0,872,5638,7146,24765
2022-02-07 12:00:00,2022-02-07 13:00:00,219,0,255,0,628,5634,6736,24290
2022-02-07 13:00:00,2022-02-07 14:00:00,216,6,251,0,462,5620,6555,24178
2022-02-07 14:00:00,2022-02-07 15:00:00,215,269,253,50,181,5522,6490,24213
2022-02-07 15:00:00,2022-02-07 16:00:00,215,527,257,58,9,5483,6549,24903
2022-02-07 16:00:00,2022-02-07 17:00:00,213,810,258,58,0,5552,6891,24707
2022-02-07 17:00:00,2022-02-07 18:00:00,215,489,259,58,0,5529,6550,24518
2022-02-07 18:00:00,2022-02-07 19:00:00,212,273,264,7,0,5505,6261,23788
2022-02-07 19:00:00,2022-02-07 20:00:00,212,68,264,0,0,5513,6057,22343
2022-02-07 20:00:00,2022-02-07 21:00:00,213,7,252,0,0,5388,5860,20932
2022-02-07 21:00:00,2022-02-07 22:00:00,212,0,251,0,0,5258,5721,19596
2022-02-07 22:00:00,2022-02-07 23:00:00,207,0,250,0,0,4980,5437,18696
2022-02-07 23:00:00,2022-02-08 00:00:00,208,0,250,0,0,4479,4937,18092
2022-02-08 00:00:00,2022-02-08 01:00:00,208,0,250,0,0,4253,4711,17865
2022-02-08 01:00:00,2022-02-08 02:00:00,213,0,249,0,0,4268,4730,17761
2022-02-08 02:00:00,2022-02-08 03:00:00,214,0,250,0,0,4192,4656,18250
2022-02-08 03:00:00,2022-02-08 04:00:00,214,0,249,0,0,4095,4558,18813
2022-02-08 04:00:00,2022-02-08 05:00:00,223,61,248,0,0,3861,4393,21214
2022-02-08 05:00:00,2022-02-08 06:00:00,222,226,236,0,30,4025,4739,23148
2022-02-08 06:00:00,2022-02-08 07:00:00,222,350,277,50,165,4318,5382,24263
2022-02-08 07:00:00,2022-02-08 08:00:00,223,243,282,58,492,4725,6023,24593
2022-02-08 08:00:00,2022-02-08 09:00:00,221,175,278,58,828,5044,6604,24290
2022-02-08 09:00:00,2022-02-08 10:00:00,223,291,278,57,1075,5196,7120,24673
2022-02-08 10:00:00,2022-02-08 11:00:00,222,642,279,7,1075,5463,7688,25095
2022-02-08 11:00:00,2022-02-08 12:00:00,221,419,285,0,785,5769,7479,25134
2022-02-08 12:00:00,2022-02-08 13:00:00,222,54,286,0,531,6094,7187,24936
2022-02-08 13:00:00,2022-02-08 14:00:00,222,151,286,0,241,6261,7161,24666
2022-02-08 14:00:00,2022-02-08 15:00:00,222,68,290,0,77,6237,6894,24417
2022-02-08 15:00:00,2022-02-08 16:00:00,221,225,291,0,3,6239,6979,24936
2022-02-08 16:00:00,2022-02-08 17:00:00,223,337,290,0,0,6237,7087,24585
2022-02-08 17:00:00,2022-02-08 18:00:00,224,418,283,0,0,6231,7156,24452
2022-02-08 18:00:00,2022-02-08 19:00:00,224,391,284,0,0,6152,7051,23790
2022-02-08 19:00:00,2022-02-08 20:00:00,224,377,284,0,0,5937,6822,22273
2022-02-08 20:00:00,2022-02-08 21:00:00,223,101,256,0,0,5710,6290,20853
2022-02-08 21:00:00,2022-02-08 22:00:00,220,0,242,0,0,5592,6054,19709
2022-02-08 22:00:00,2022-02-08 23:00:00,221,0,250,0,0,5474,5945,18709
2022-02-08 23:00:00,2022-02-09 00:00:00,220,0,254,0,0,5047,5521,18178
2022-02-09 00:00:00,2022-02-09 01:00:00,220,0,255,0,0,4575,5050,17690
2022-02-09 01:00:00,2022-02-09 02:00:00,219,0,256,0,0,4298,4773,17836
2022-02-09 02:00:00,2022-02-09 03:00:00,223,12,258,0,0,4037,4530,18237
2022-02-09 03:00:00,2022-02-09 04:00:00,223,7,259,0,0,3727,4216,19109
2022-02-09 04:00:00,2022-02-09 05:00:00,225,10,257,0,0,3633,4125,21567
2022-02-09 05:00:00,2022-02-09 06:00:00,224,169,257,0,33,3548,4231,23034
2022-02-09 06:00:00,2022-02-09 07:00:00,223,536,263,0,209,3555,4786,23878
2022-02-09 07:00:00,2022-02-09 08:00:00,226,428,266,0,585,3935,5440,24353
2022-02-09 08:00:00,2022-02-09 09:00:00,226,60,265,0,772,4351,5674,24425
2022-02-09 09:00:00,2022-02-09 10:00:00,222,5,288,0,843,4672,6030,24648
2022-02-09 10:00:00,2022-02-09 11:00:00,226,263,283,0,891,5022,6685,24840
2022-02-09 11:00:00,2022-02-09 12:00:00,224,233,277,0,766,5101,6601,24988
2022-02-09 12:00:00,2022-02-09 13:00:00,224,11,270,0,512,5154,6171,24619
2022-02-09 13:00:00,2022-02-09 14:00:00,222,121,279,0,256,5130,6008,24252
2022-02-09 14:00:00,2022-02-09 15:00:00,224,175,284,50,107,5146,5986,24184
2022-02-09 15:00:00,2022-02-09 16:00:00,224,471,304,57,3,5219,6278,24774
2022-02-09 16:00:00,2022-02-09 17:00:00,226,818,310,57,0,5293,6704,24543
2022-02-09 17:00:00,2022-02-09 18:00:00,222,959,288,57,0,5264,6790,24407
2022-02-09 18:00:00,2022-02-09 19:00:00,222,808,269,7,0,5333,6639,23711
2022-02-09 19:00:00,2022-02-09 20:00:00,223,702,268,0,0,5098,6291,22273
2022-02-09 20:00:00,2022-02-09 21:00:00,223,392,255,0,0,4824,5694,20705
2022-02-09 21:00:00,2022-02-09 22:00:00,223,8,253,0,0,4588,5072,19356
2022-02-09 22:00:00,2022-02-09 23:00:00,220,0,258,0,0,4349,4827,18380
2022-02-09 23:00:00,2022-02-10 00:00:00,217,0,257,0,0,3912,4386,17846
2022-02-10 00:00:00,2022-02-10 01:00:00,216,0,257,0,0,3422,3895,17472
2022-02-10 01:00:00,2022-02-10 02:00:00,216,0,257,0,0,3038,3511,17611
2022-02-10 02:00:00,2022-02-10 03:00:00,222,0,257,0,0,2700,3179,17993
2022-02-10 03:00:00,2022-02-10 04:00:00,222,0,258,0,0,2457,2937,18723
2022-02-10 04:00:00,2022-02-10 05:00:00,224,6,260,0,0,2230,2720,21123
2022-02-10 05:00:00,2022-02-10 06:00:00,223,47,260,0,31,2165,2726,22609
2022-02-10 06:00:00,2022-02-10 07:00:00,221,173,282,50,215,2038,2979,23620
2022-02-10 07:00:00,2022-02-10 08:00:00,223,193,322,58,488,1810,3094,23939
2022-02-10 08:00:00,2022-02-10 09:00:00,224,216,322,58,757,1699,3276,23822
2022-02-10 09:00:00,2022-02-10 10:00:00,226,4,323,58,1176,1665,3452,24099
2022-02-10 10:00:00,2022-02-10 11:00:00,223,98,315,7,1381,1572,3596,24275
2022-02-10 11:00:00,2022-02-10 12:00:00,223,131,301,0,1298,1439,3392,24158
2022-02-10 12:00:00,2022-02-10 13:00:00,223,88,300,0,1115,1489,3215,24052
2022-02-10 13:00:00,2022-02-10 14:00:00,222,52,298,50,533,1598,2753,24042
2022-02-10 14:00:00,2022-02-10 15:00:00,221,405,298,58,167,1866,3015,24133
2022-02-10 15:00:00,2022-02-10 16:00:00,223,778,304,57,6,2152,3520,24624
2022-02-10 16:00:00,2022-02-10 17:00:00,223,605,322,7,0,2619,3776,24591
2022-02-10 17:00:00,2022-02-10 18:00:00,221,154,319,0,0,2867,3561,24515
2022-02-10 18:00:00,2022-02-10 19:00:00,223,21,316,0,0,2972,3532,23847
2022-02-10 19:00:00,2022-02-10 20:00:00,222,50,295,0,0,2738,3305,22387
2022-02-10 20:00:00,2022-02-10 21:00:00,224,50,281,0,0,2573,3128,21014
2022-02-10 21:00:00,2022-02-10 22:00:00,222,0,270,0,0,2507,2999,19741
2022-02-10 22:00:00,2022-02-10 23:00:00,216,0,257,0,0,2449,2922,18710
2022-02-10 23:00:00,2022-02-11 00:00:00,215,0,255,0,0,2426,2896,18046
2022-02-11 00:00:00,2022-02-11 01:00:00,214,0,255,0,0,2220,2689,17755
2022-02-11 01:00:00,2022-02-11 02:00:00,213,0,255,0,0,1872,2340,17822
2022-02-11 02:00:00,2022-02-11 03:00:00,219,0,255,0,0,1512,1986,18189
2022-02-11 03:00:00,2022-02-11 04:00:00,222,0,255,0,0,1350,1827,18960
2022-02-11 04:00:00,2022-02-11 05:00:00,223,31,260,0,0,1176,1690,21250
2022-02-11 05:00:00,2022-02-11 06:00:00,222,45,259,50,40,1100,1716,22983
2022-02-11 06:00:00,2022-02-11 07:00:00,222,148,276,58,162,918,1784,23960
2022-02-11 07:00:00,2022-02-11 08:00:00,221,271,313,57,468,752,2082,24549
2022-02-11 08:00:00,2022-02-11 09:00:00,224,169,317,57,751,778,2296,24644
2022-02-11 09:00:00,2022-02-11 10:00:00,226,149,319,57,689,1030,2470,24919
2022-02-11 10:00:00,2022-02-11 11:00:00,225,64,319,7,895,1357,2867,25269
2022-02-11 11:00:00,2022-02-11 12:00:00,223,235,320,0,698,1756,3232,25254
2022-02-11 12:00:00,2022-02-11 13:00:00,224,40,311,0,587,1972,3134,24823
2022-02-11 13:00:00,2022-02-11 14:00:00,220,0,305,0,326,2121,2972,24343
2022-02-11 14:00:00,2022-02-11 15:00:00,202,18,305,50,133,2509,3217,24216
2022-02-11 15:00:00,2022-02-11 16:00:00,158,378,303,58,10,3219,4126,24867
2022-02-11 16:00:00,2022-02-11 17:00:00,158,397,309,58,0,3278,4200,24540
2022-02-11 17:00:00,2022-02-11 18:00:00,158,367,305,7,0,3844,4681,24412
2022-02-11 18:00:00,2022-02-11 19:00:00,159,297,297,0,0,4065,4818,23678
2022-02-11 19:00:00,2022-02-11 20:00:00,160,227,293,0,0,3941,4621,22094
2022-02-11 20:00:00,2022-02-11 21:00:00,154,82,280,0,0,3881,4397,20575
2022-02-11 21:00:00,2022-02-11 22:00:00,176,0,280,0,0,3519,3975,19458
2022-02-11 22:00:00,2022-02-11 23:00:00,215,0,274,0,0,3354,3843,18600
2022-02-11 23:00:00,2022-02-12 00:00:00,215,0,273,0,0,3147,3635,17996
2022-02-12 00:00:00,2022-02-12 01:00:00,215,0,273,0,0,2848,3336,17568
2022-02-12 01:00:00,2022-02-12 02:00:00,216,0,274,0,0,2574,3064,17570
2022-02-12 02:00:00,2022-02-12 03:00:00,220,0,274,0,0,2252,2746,17710
2022-02-12 03:00:00,2022-02-12 04:00:00,223,0,273,0,0,2083,2579,17843
2022-02-12 04:00:00,2022-02-12 05:00:00,225,1,273,0,0,1937,2436,18778
2022-02-12 05:00:00,2022-02-12 06:00:00,222,19,274,0,82,1871,2468,19533
2022-02-12 06:00:00,2022-02-12 07:00:00,222,59,307,50,558,1657,2853,20393
2022-02-12 07:00:00,2022-02-12 08:00:00,224,87,324,58,1295,1264,3252,20672
2022-02-12 08:00:00,2022-02-12 09:00:00,224,17,324,57,1952,1187,3761,20268
2022-02-12 09:00:00,2022-02-12 10:00:00,223,165,324,57,2467,1582,4818,19937
2022-02-12 10:00:00,2022-02-12 11:00:00,223,0,307,58,2782,1793,5163,19724
2022-02-12 11:00:00,2022-02-12 12:00:00,222,1,297,7,2526,1853,4906,19565
2022-02-12 12:00:00,2022-02-12 13:00:00,223,10,293,0,2058,1879,4463,19380
2022-02-12 13:00:00,2022-02-12 14:00:00,223,20,293,0,1384,1901,3821,19972
2022-02-12 14:00:00,2022-02-12 15:00:00,224,244,313,50,501,1935,3267,20702
2022-02-12 15:00:00,2022-02-12 16:00:00,223,866,315,58,38,2384,3884,21653
2022-02-12 16:00:00,2022-02-12 17:00:00,224,1031,325,57,0,2916,4553,21695
2022-02-12 17:00:00,2022-02-12 18:00:00,223,1096,322,7,0,3445,5093,21524
2022-02-12 18:00:00,2022-02-12 19:00:00,224,1033,295,0,0,3651,5203,20791
2022-02-12 19:00:00,2022-02-12 20:00:00,224,664,289,0,0,3756,4933,19763
2022-02-12 20:00:00,2022-02-12 21:00:00,224,303,274,0,0,3834,4635,18770
2022-02-12 21:00:00,2022-02-12 22:00:00,224,155,274,0,0,3914,4567,17654
2022-02-12 22:00:00,2022-02-12 23:00:00,219,55,277,0,0,3976,4527,16655
2022-02-12 23:00:00,2022-02-13 00:00:00,215,7,278,0,0,3948,4448,16033
2022-02-13 00:00:00,2022-02-13 01:00:00,216,0,278,0,0,4038,4532,15734
2022-02-13 01:00:00,2022-02-13 02:00:00,214,0,278,0,0,4075,4567,15481
2022-02-13 02:00:00,2022-02-13 03:00:00,216,0,278,0,0,4117,4611,15487
2022-02-13 03:00:00,2022-02-13 04:00:00,221,0,278,0,0,4166,4665,15692
2022-02-13 04:00:00,2022-02-13 05:00:00,224,0,278,0,0,4308,4810,15999
2022-02-13 05:00:00,2022-02-13 06:00:00,222,0,278,0,83,4408,4991,16109
2022-02-13 06:00:00,2022-02-13 07:00:00,220,0,287,50,581,4134,5272,16191
2022-02-13 07:00:00,2022-02-13 08:00:00,221,18,294,58,1439,3528,5558,16271
2022-02-13 08:00:00,2022-02-13 09:00:00,225,53,306,57,2173,3031,5845,16344
2022-02-13 09:00:00,2022-02-13 10:00:00,224,20,307,7,2588,3082,6228,16274
2022-02-13 10:00:00,2022-02-13 11:00:00,184,0,303,0,2751,3300,6538,16423
2022-02-13 11:00:00,2022-02-13 12:00:00,143,0,297,0,2648,3522,6610,16773
2022-02-13 12:00:00,2022-02-13 13:00:00,147,9,301,0,2169,3446,6072,16870
2022-02-13 13:00:00,2022-02-13 14:00:00,209,202,301,0,1425,3364,5501,17367
2022-02-13 14:00:00,2022-02-13 15:00:00,223,693,301,50,503,3515,5285,18239
2022-02-13 15:00:00,2022-02-13 16:00:00,223,902,307,57,43,4252,5784,19422
2022-02-13 16:00:00,2022-02-13 17:00:00,222,1022,319,57,0,4912,6532,20009
2022-02-13 17:00:00,2022-02-13 18:00:00,221,965,321,57,0,5067,6631,20230
2022-02-13 18:00:00,2022-02-13 19:00:00,221,924,316,57,0,5170,6688,19721
2022-02-13 19:00:00,2022-02-13 20:00:00,224,615,300,7,0,5186,6332,18980
2022-02-13 20:00:00,2022-02-13 21:00:00,224,156,298,0,0,5130,5808,18333
2022-02-13 21:00:00,2022-02-13 22:00:00,223,0,296,0,0,5051,5570,17335
2022-02-13 22:00:00,2022-02-13 23:00:00,221,0,287,0,0,4966,5474,16547
2022-02-13 23:00:00,2022-02-14 00:00:00,218,0,288,0,0,4943,5449,16180
2022-02-14 00:00:00,2022-02-14 01:00:00,218,0,288,0,0,4950,5456,16079
2022-02-14 01:00:00,2022-02-14 02:00:00,216,0,288,0,0,4878,5382,16129
2022-02-14 02:00:00,2022-02-14 03:00:00,219,16,288,0,0,4888,5411,16503
2022-02-14 03:00:00,2022-02-14 04:00:00,221,17,288,0,0,5026,5552,17731
2022-02-14 04:00:00,2022-02-14 05:00:00,221,5,288,0,0,5163,5677,20631
2022-02-14 05:00:00,2022-02-14 06:00:00,222,104,288,0,93,5147,5854,22289
2022-02-14 06:00:00,2022-02-14 07:00:00,227,84,289,38,593,5008,6239,22601
2022-02-14 07:00:00,2022-02-14 08:00:00,228,93,293,43,1492,4686,6835,22279
2022-02-14 08:00:00,2022-02-14 09:00:00,231,10,295,43,2182,4391,7152,21567
2022-02-14 09:00:00,2022-02-14 10:00:00,232,0,297,5,2618,4311,7463,21541
2022-02-14 10:00:00,2022-02-14 11:00:00,227,0,295,0,2756,4372,7650,21509
2022-02-14 11:00:00,2022-02-14 12:00:00,231,0,294,0,2563,4332,7420,21737
2022-02-14 12:00:00,2022-02-14 13:00:00,232,8,295,0,2066,4363,6964,21818
2022-02-14 13:00:00,2022-02-14 14:00:00,231,66,294,0,1406,4375,6372,22580
2022-02-14 14:00:00,2022-02-14 15:00:00,230,355,299,0,537,4436,5857,23121
2022-02-14 15:00:00,2022-02-14 16:00:00,229,793,300,38,33,4702,6095,24086
2022-02-14 16:00:00,2022-02-14 17:00:00,231,798,300,43,0,4911,6283,24269
2022-02-14 17:00:00,2022-02-14 18:00:00,229,752,299,43,0,4908,6231,24144
2022-02-14 18:00:00,2022-02-14 19:00:00,229,621,299,43,0,4845,6037,23561
2022-02-14 19:00:00,2022-02-14 20:00:00,228,150,295,5,0,4555,5233,22115
2022-02-14 20:00:00,2022-02-14 21:00:00,230,69,288,0,0,4065,4652,20672
2022-02-14 21:00:00,2022-02-14 22:00:00,232,96,285,0,0,3933,4546,19449
2022-02-14 22:00:00,2022-02-14 23:00:00,222,2,279,0,0,3784,4287,18463
2022-02-14 23:00:00,2022-02-15 00:00:00,219,0,279,0,0,3550,4048,17889
2022-02-15 00:00:00,2022-02-15 01:00:00,220,0,279,0,0,3299,3798,17510
2022-02-15 01:00:00,2022-02-15 02:00:00,219,0,279,0,0,3195,3693,17535
2022-02-15 02:00:00,2022-02-15 03:00:00,222,0,279,0,0,3087,3588,17884
2022-02-15 03:00:00,2022-02-15 04:00:00,223,0,278,0,0,3042,3543,18704
2022-02-15 04:00:00,2022-02-15 05:00:00,225,5,277,0,0,3108,3615,21147
2022-02-15 05:00:00,2022-02-15 06:00:00,223,54,276,0,84,3203,3840,22661
2022-02-15 06:00:00,2022-02-15 07:00:00,224,87,279,38,430,2986,4044,23356
2022-02-15 07:00:00,2022-02-15 08:00:00,225,162,275,43,937,2577,4219,23216
2022-02-15 08:00:00,2022-02-15 09:00:00,228,22,309,43,1336,2243,4181,22679
2022-02-15 09:00:00,2022-02-15 10:00:00,228,122,312,5,1925,2037,4629,23070
2022-02-15 10:00:00,2022-02-15 11:00:00,227,17,309,0,2127,1992,4672,23175
2022-02-15 11:00:00,2022-02-15 12:00:00,226,33,306,0,1993,1936,4494,23529
2022-02-15 12:00:00,2022-02-15 13:00:00,227,37,305,0,1709,1834,4112,23525
2022-02-15 13:00:00,2022-02-15 14:00:00,226,107,304,0,917,1628,3182,23474
2022-02-15 14:00:00,2022-02-15 15:00:00,225,480,313,38,282,1519,2857,23603
2022-02-15 15:00:00,2022-02-15 16:00:00,226,895,321,43,31,1712,3228,24444
2022-02-15 16:00:00,2022-02-15 17:00:00,227,859,329,43,0,2119,3577,24538
2022-02-15 17:00:00,2022-02-15 18:00:00,227,1035,328,43,0,2491,4124,24322
2022-02-15 18:00:00,2022-02-15 19:00:00,227,970,316,43,0,2827,4383,23695
2022-02-15 19:00:00,2022-02-15 20:00:00,226,613,308,5,0,3098,4250,22154
2022-02-15 20:00:00,2022-02-15 21:00:00,226,238,271,0,0,3399,4134,20652
2022-02-15 21:00:00,2022-02-15 22:00:00,224,23,265,0,0,3753,4265,19287
2022-02-15 22:00:00,2022-02-15 23:00:00,220,19,261,0,0,4079,4579,18302
2022-02-15 23:00:00,2022-02-16 00:00:00,218,0,260,0,0,4418,4896,17752
2022-02-16 00:00:00,2022-02-16 01:00:00,218,0,260,0,0,4709,5187,17400
2022-02-16 01:00:00,2022-02-16 02:00:00,218,0,260,0,0,4953,5431,17490
2022-02-16 02:00:00,2022-02-16 03:00:00,224,0,260,0,0,5116,5600,17777
2022-02-16 03:00:00,2022-02-16 04:00:00,227,2,260,0,0,5307,5796,18654
2022-02-16 04:00:00,2022-02-16 05:00:00,226,52,260,0,0,5360,5898,20994
2022-02-16 05:00:00,2022-02-16 06:00:00,225,225,262,0,93,5211,6016,22554
2022-02-16 06:00:00,2022-02-16 07:00:00,231,270,275,38,407,5050,6271,23211
2022-02-16 07:00:00,2022-02-16 08:00:00,233,318,304,43,938,4922,6758,23036
2022-02-16 08:00:00,2022-02-16 09:00:00,235,241,316,43,1380,4840,7055,22457
2022-02-16 09:00:00,2022-02-16 10:00:00,234,141,312,5,1801,5003,7496,22656
2022-02-16 10:00:00,2022-02-16 11:00:00,235,160,304,0,1953,5319,7971,22933
2022-02-16 11:00:00,2022-02-16 12:00:00,234,47,309,0,1860,5777,8227,23146
2022-02-16 12:00:00,2022-02-16 13:00:00,236,0,315,0,1362,6104,8017,23028
2022-02-16 13:00:00,2022-02-16 14:00:00,234,0,315,0,778,6404,7731,23129
2022-02-16 14:00:00,2022-02-16 15:00:00,233,175,317,38,292,6623,7678,23332
2022-02-16 15:00:00,2022-02-16 16:00:00,234,500,318,43,14,6674,7783,23935
2022-02-16 16:00:00,2022-02-16 17:00:00,233,609,325,43,0,6718,7928,23955
2022-02-16 17:00:00,2022-02-16 18:00:00,232,549,341,5,0,6692,7819,23853
2022-02-16 18:00:00,2022-02-16 19:00:00,231,396,336,0,0,6669,7632,23213
2022-02-16 19:00:00,2022-02-16 20:00:00,233,110,322,0,0,6647,7312,21698
2022-02-16 20:00:00,2022-02-16 21:00:00,231,16,310,0,0,6596,7153,20133
2022-02-16 21:00:00,2022-02-16 22:00:00,229,23,273,0,0,6591,7116,18880
2022-02-16 22:00:00,2022-02-16 23:00:00,225,0,271,0,0,6585,7081,17824
2022-02-16 23:00:00,2022-02-17 00:00:00,224,0,269,0,0,6500,6993,17249
2022-02-17 00:00:00,2022-02-17 01:00:00,226,0,269,0,0,6156,6651,16758
2022-02-17 01:00:00,2022-02-17 02:00:00,220,0,269,0,0,6075,6564,16767
2022-02-17 02:00:00,2022-02-17 03:00:00,225,0,268,0,0,5928,6421,16908
2022-02-17 03:00:00,2022-02-17 04:00:00,221,0,265,0,0,5668,6154,17886
2022-02-17 04:00:00,2022-02-17 05:00:00,227,27,265,0,0,5681,6200,20111
2022-02-17 05:00:00,2022-02-17 06:00:00,229,70,264,0,64,5760,6387,21700
2022-02-17 06:00:00,2022-02-17 07:00:00,233,58,272,38,349,6020,6970,22770
2022-02-17 07:00:00,2022-02-17 08:00:00,233,50,295,43,717,6062,7400,23225
2022-02-17 08:00:00,2022-02-17 09:00:00,235,293,316,5,957,5816,7622,22984
2022-02-17 09:00:00,2022-02-17 10:00:00,232,280,318,0,1138,5784,7752,23237
2022-02-17 10:00:00,2022-02-17 11:00:00,234,239,313,0,1002,5822,7610,23156
2022-02-17 11:00:00,2022-02-17 12:00:00,233,121,316,0,1038,5987,7695,23273
2022-02-17 12:00:00,2022-02-17 13:00:00,232,28,316,0,808,6277,7661,23067
2022-02-17 13:00:00,2022-02-17 14:00:00,231,9,306,0,561,6314,7421,23033
2022-02-17 14:00:00,2022-02-17 15:00:00,232,199,315,38,257,6228,7269,23143
2022-02-17 15:00:00,2022-02-17 16:00:00,231,706,318,43,30,6292,7620,23877
2022-02-17 16:00:00,2022-02-17 17:00:00,233,891,323,43,0,6227,7717,23954
2022-02-17 17:00:00,2022-02-17 18:00:00,232,902,316,43,0,6153,7646,23809
2022-02-17 18:00:00,2022-02-17 19:00:00,231,557,305,43,0,6298,7434,23308
2022-02-17 19:00:00,2022-02-17 20:00:00,232,102,290,5,0,6377,7006,21695
2022-02-17 20:00:00,2022-02-17 21:00:00,231,11,289,0,0,6393,6924,20258
2022-02-17 21:00:00,2022-02-17 22:00:00,232,19,279,0,0,6370,6900,19076
2022-02-17 22:00:00,2022-02-17 23:00:00,226,3,278,0,0,6298,6805,18067
2022-02-17 23:00:00,2022-02-18 00:00:00,226,0,281,0,0,6309,6816,17414
2022-02-18 00:00:00,2022-02-18 01:00:00,226,0,282,0,0,6316,6824,17161
2022-02-18 01:00:00,2022-02-18 02:00:00,225,0,282,0,0,6293,6800,17277
2022-02-18 02:00:00,2022-02-18 03:00:00,230,0,282,0,0,6219,6731,17575
2022-02-18 03:00:00,2022-02-18 04:00:00,232,0,282,0,0,6154,6668,18398
2022-02-18 04:00:00,2022-02-18 05:00:00,234,35,282,0,0,6140,6691,20754
2022-02-18 05:00:00,2022-02-18 06:00:00,233,58,288,0,87,5985,6651,22263
2022-02-18 06:00:00,2022-02-18 07:00:00,235,44,283,38,421,5783,6804,22800
2022-02-18 07:00:00,2022-02-18 08:00:00,235,531,286,43,1144,5609,7848,22870
2022-02-18 08:00:00,2022-02-18 09:00:00,235,674,287,43,1791,5427,8457,22801
2022-02-18 09:00:00,2022-02-18 10:00:00,233,535,287,43,2169,5090,8357,23094
2022-02-18 10:00:00,2022-02-18 11:00:00,236,503,287,43,2575,4526,8170,23285
2022-02-18 11:00:00,2022-02-18 12:00:00,233,377,287,45,2327,4119,7388,23179
2022-02-18 12:00:00,2022-02-18 13:00:00,232,368,301,45,1839,3779,6564,23257
2022-02-18 13:00:00,2022-02-18 14:00:00,232,364,325,43,1043,3838,5845,23393
2022-02-18 14:00:00,2022-02-18 15:00:00,233,542,306,43,351,4258,5733,23364
2022-02-18 15:00:00,2022-02-18 16:00:00,233,729,305,43,23,4979,6312,23900
2022-02-18 16:00:00,2022-02-18 17:00:00,234,687,313,43,0,5781,7058,23987
2022-02-18 17:00:00,2022-02-18 18:00:00,233,370,329,43,0,6408,7383,23806
2022-02-18 18:00:00,2022-02-18 19:00:00,233,145,329,5,0,6540,7252,23094
2022-02-18 19:00:00,2022-02-18 20:00:00,232,78,312,0,0,6477,7099,21459
2022-02-18 20:00:00,2022-02-18 21:00:00,231,24,289,0,0,6339,6883,19937
2022-02-18 21:00:00,2022-02-18 22:00:00,210,0,288,0,0,6006,6504,18721
2022-02-18 22:00:00,2022-02-18 23:00:00,220,0,289,0,0,5251,5760,17458
2022-02-18 23:00:00,2022-02-19 00:00:00,223,0,288,0,0,4834,5345,16853
2022-02-19 00:00:00,2022-02-19 01:00:00,223,0,286,0,0,4787,5296,16561
2022-02-19 01:00:00,2022-02-19 02:00:00,222,0,286,0,0,4742,5250,16432
2022-02-19 02:00:00,2022-02-19 03:00:00,223,0,286,0,0,4455,4964,16356
2022-02-19 03:00:00,2022-02-19 04:00:00,230,0,287,50,0,4218,4785,16547
2022-02-19 04:00:00,2022-02-19 05:00:00,231,0,287,57,1,4047,4623,17091
2022-02-19 05:00:00,2022-02-19 06:00:00,225,0,289,57,105,3772,4448,17613
2022-02-19 06:00:00,2022-02-19 07:00:00,226,94,289,57,470,3433,4569,18454
2022-02-19 07:00:00,2022-02-19 08:00:00,231,290,289,57,1087,3172,5126,19226
2022-02-19 08:00:00,2022-02-19 09:00:00,232,144,289,57,1362,3239,5323,19580
2022-02-19 09:00:00,2022-02-19 10:00:00,230,51,289,57,1561,3410,5598,19818
2022-02-19 10:00:00,2022-02-19 11:00:00,232,40,300,7,1668,3551,5798,19883
2022-02-19 11:00:00,2022-02-19 12:00:00,232,32,318,0,1460,3901,5943,19647
2022-02-19 12:00:00,2022-02-19 13:00:00,233,82,317,0,1209,4291,6132,19400
2022-02-19 13:00:00,2022-02-19 14:00:00,230,37,314,25,846,4763,6215,19325
2022-02-19 14:00:00,2022-02-19 15:00:00,231,15,298,29,394,5183,6150,19288
2022-02-19 15:00:00,2022-02-19 16:00:00,232,415,295,47,64,5395,6448,20056
2022-02-19 16:00:00,2022-02-19 17:00:00,229,697,296,58,0,5422,6702,20462
2022-02-19 17:00:00,2022-02-19 18:00:00,203,686,298,57,0,5314,6558,20406
2022-02-19 18:00:00,2022-02-19 19:00:00,232,638,312,57,0,5328,6567,19972
2022-02-19 19:00:00,2022-02-19 20:00:00,231,414,312,57,0,5010,6024,18908
2022-02-19 20:00:00,2022-02-19 21:00:00,232,177,292,7,0,4934,5642,18055
2022-02-19 21:00:00,2022-02-19 22:00:00,231,20,289,0,0,4822,5362,16998
2022-02-19 22:00:00,2022-02-19 23:00:00,224,68,285,0,0,4722,5299,16083
2022-02-19 23:00:00,2022-02-20 00:00:00,222,9,286,0,0,4633,5150,15471
2022-02-20 00:00:00,2022-02-20 01:00:00,227,0,286,0,0,4413,4926,15175
2022-02-20 01:00:00,2022-02-20 02:00:00,226,0,286,0,0,4175,4687,14945
2022-02-20 02:00:00,2022-02-20 03:00:00,227,0,286,0,0,3887,4400,14977
2022-02-20 03:00:00,2022-02-20 04:00:00,232,0,285,0,0,3595,4112,15098
2022-02-20 04:00:00,2022-02-20 05:00:00,234,0,285,0,2,3399,3920,15183
2022-02-20 05:00:00,2022-02-20 06:00:00,232,8,285,0,96,3373,3994,15636
2022-02-20 06:00:00,2022-02-20 07:00:00,234,20,299,0,288,3552,4393,16568
2022-02-20 07:00:00,2022-02-20 08:00:00,234,8,319,0,630,3709,4900,17654
2022-02-20 08:00:00,2022-02-20 09:00:00,235,84,318,0,990,3802,5429,18561
2022-02-20 09:00:00,2022-02-20 10:00:00,233,16,319,0,1045,3750,5363,18920
2022-02-20 10:00:00,2022-02-20 11:00:00,233,11,319,50,1159,3834,5606,19103
2022-02-20 11:00:00,2022-02-20 12:00:00,233,0,309,57,1240,3710,5549,19168
2022-02-20 12:00:00,2022-02-20 13:00:00,233,0,295,57,967,3576,5128,18491
2022-02-20 13:00:00,2022-02-20 14:00:00,232,38,296,57,636,3474,4733,18314
2022-02-20 14:00:00,2022-02-20 15:00:00,232,298,297,57,273,3471,4628,18264
2022-02-20 15:00:00,2022-02-20 16:00:00,232,521,297,57,37,3994,5138,19189
2022-02-20 16:00:00,2022-02-20 17:00:00,233,662,297,57,0,4768,6017,19714
2022-02-20 17:00:00,2022-02-20 18:00:00,233,870,297,57,0,5352,6809,19702
2022-02-20 18:00:00,2022-02-20 19:00:00,233,733,296,58,0,5749,7069,19251
2022-02-20 19:00:00,2022-02-20 20:00:00,233,360,297,57,0,5995,6942,18330
2022-02-20 20:00:00,2022-02-20 21:00:00,233,0,288,7,0,6138,6666,17615
2022-02-20 21:00:00,2022-02-20 22:00:00,232,0,287,0,0,6220,6739,16768
2022-02-20 22:00:00,2022-02-20 23:00:00,224,0,281,0,0,6303,6808,16046
2022-02-20 23:00:00,2022-02-21 00:00:00,224,0,280,0,0,6336,6840,15623
2022-02-21 00:00:00,2022-02-21 01:00:00,225,0,280,0,0,6397,6902,15528
2022-02-21 01:00:00,2022-02-21 02:00:00,224,1,280,0,0,6448,6953,15551
2022-02-21 02:00:00,2022-02-21 03:00:00,225,19,280,0,0,6479,7003,16025
2022-02-21 03:00:00,2022-02-21 04:00:00,229,20,280,0,0,6482,7011,17249
2022-02-21 04:00:00,2022-02-21 05:00:00,231,25,280,0,0,6424,6960,19977
2022-02-21 05:00:00,2022-02-21 06:00:00,233,57,279,50,64,6323,7006,22007
2022-02-21 06:00:00,2022-02-21 07:00:00,233,306,284,58,186,6387,7454,23321
2022-02-21 07:00:00,2022-02-21 08:00:00,232,279,323,58,538,6368,7798,23892
2022-02-21 08:00:00,2022-02-21 09:00:00,232,16,323,7,882,6413,7873,23826
2022-02-21 09:00:00,2022-02-21 10:00:00,233,0,324,0,1176,6518,8251,24281
2022-02-21 10:00:00,2022-02-21 11:00:00,232,2,295,0,1136,6676,8341,24276
2022-02-21 11:00:00,2022-02-21 12:00:00,231,12,295,0,1298,6616,8452,24272
2022-02-21 12:00:00,2022-02-21 13:00:00,232,0,293,0,1163,6579,8267,23655
2022-02-21 13:00:00,2022-02-21 14:00:00,231,0,294,50,1002,6619,8196,23618
2022-02-21 14:00:00,2022-02-21 15:00:00,231,69,317,58,523,6505,7703,23727
2022-02-21 15:00:00,2022-02-21 16:00:00,231,273,322,57,61,6281,7225,24300
2022-02-21 16:00:00,2022-02-21 17:00:00,232,739,321,57,0,6142,7491,24628
2022-02-21 17:00:00,2022-02-21 18:00:00,230,848,309,57,0,6013,7457,24519
2022-02-21 18:00:00,2022-02-21 19:00:00,231,777,306,57,0,6131,7502,23882
2022-02-21 19:00:00,2022-02-21 20:00:00,231,385,301,57,0,6165,7139,22491
2022-02-21 20:00:00,2022-02-21 21:00:00,230,160,272,7,0,6276,6945,20912
2022-02-21 21:00:00,2022-02-21 22:00:00,230,3,269,0,0,6441,6943,19730
2022-02-21 22:00:00,2022-02-21 23:00:00,223,0,269,0,0,6421,6913,18665
2022-02-21 23:00:00,2022-02-22 00:00:00,222,0,270,0,0,6292,6784,17977
2022-02-22 00:00:00,2022-02-22 01:00:00,223,0,270,0,0,6181,6674,17617
2022-02-22 01:00:00,2022-02-22 02:00:00,220,0,270,0,0,6082,6572,17682
2022-02-22 02:00:00,2022-02-22 03:00:00,230,8,270,0,0,5917,6425,18053
2022-02-22 03:00:00,2022-02-22 04:00:00,232,19,270,0,0,5664,6185,19021
2022-02-22 04:00:00,2022-02-22 05:00:00,233,19,269,0,2,5333,5856,21354
2022-02-22 05:00:00,2022-02-22 06:00:00,233,20,271,0,92,5260,5876,23031
2022-02-22 06:00:00,2022-02-22 07:00:00,233,154,270,50,390,4847,5944,23806
2022-02-22 07:00:00,2022-02-22 08:00:00,222,164,299,57,872,4728,6342,24182
2022-02-22 08:00:00,2022-02-22 09:00:00,227,10,312,57,1317,4548,6471,24248
2022-02-22 09:00:00,2022-02-22 10:00:00,232,9,306,7,1613,4323,6490,24663
2022-02-22 10:00:00,2022-02-22 11:00:00,234,202,305,0,1706,4361,6808,24507
2022-02-22 11:00:00,2022-02-22 12:00:00,234,340,305,0,1709,4441,7029,24294
2022-02-22 12:00:00,2022-02-22 13:00:00,236,152,308,0,1346,4380,6422,23710
2022-02-22 13:00:00,2022-02-22 14:00:00,233,57,306,50,1004,3967,5617,23801
2022-02-22 14:00:00,2022-02-22 15:00:00,234,283,315,57,423,3242,4554,23853
2022-02-22 15:00:00,2022-02-22 16:00:00,230,397,326,57,53,2855,3918,24589
2022-02-22 16:00:00,2022-02-22 17:00:00,233,909,326,57,0,2607,4132,24940
2022-02-22 17:00:00,2022-02-22 18:00:00,231,1408,326,57,0,2608,4630,24777
2022-02-22 18:00:00,2022-02-22 19:00:00,230,1143,319,57,0,2728,4477,24051
2022-02-22 19:00:00,2022-02-22 20:00:00,229,400,303,57,0,3012,4001,22546
2022-02-22 20:00:00,2022-02-22 21:00:00,230,198,294,7,0,3280,4009,20967
2022-02-22 21:00:00,2022-02-22 22:00:00,229,7,289,0,0,3598,4123,19648
2022-02-22 22:00:00,2022-02-22 23:00:00,176,13,296,0,0,3918,4403,18567
2022-02-22 23:00:00,2022-02-23 00:00:00,149,1,297,0,0,4403,4850,17981
2022-02-23 00:00:00,2022-02-23 01:00:00,147,0,297,0,0,4766,5210,17702
2022-02-23 01:00:00,2022-02-23 02:00:00,148,0,296,0,0,5258,5702,17769
2022-02-23 02:00:00,2022-02-23 03:00:00,177,0,296,0,0,5634,6107,18113
2022-02-23 03:00:00,2022-02-23 04:00:00,215,0,302,0,0,5915,6432,18885
2022-02-23 04:00:00,2022-02-23 05:00:00,221,0,302,0,2,6152,6677,21168
2022-02-23 05:00:00,2022-02-23 06:00:00,222,49,302,0,74,6269,6916,22884
2022-02-23 06:00:00,2022-02-23 07:00:00,223,325,314,50,272,6183,7367,23786
2022-02-23 07:00:00,2022-02-23 08:00:00,223,106,333,57,724,6349,7792,24199
2022-02-23 08:00:00,2022-02-23 09:00:00,223,6,333,7,956,6294,7819,23700
2022-02-23 09:00:00,2022-02-23 10:00:00,224,0,329,0,1242,6367,8162,23940
2022-02-23 10:00:00,2022-02-23 11:00:00,224,0,329,0,1310,6353,8216,23813
2022-02-23 11:00:00,2022-02-23 12:00:00,221,0,329,0,1503,6358,8411,23926
2022-02-23 12:00:00,2022-02-23 13:00:00,224,0,329,0,1522,6152,8227,23626
2022-02-23 13:00:00,2022-02-23 14:00:00,221,0,329,0,1138,5790,7478,23685
2022-02-23 14:00:00,2022-02-23 15:00:00,221,9,330,50,711,5192,6513,23926
2022-02-23 15:00:00,2022-02-23 16:00:00,221,118,330,57,108,4295,5129,24486
2022-02-23 16:00:00,2022-02-23 17:00:00,223,497,332,57,0,3629,4738,24878
2022-02-23 17:00:00,2022-02-23 18:00:00,221,591,333,57,0,3266,4468,24848
2022-02-23 18:00:00,2022-02-23 19:00:00,223,464,332,57,0,2979,4055,24240
2022-02-23 19:00:00,2022-02-23 20:00:00,223,310,326,57,0,2732,3648,22680
2022-02-23 20:00:00,2022-02-23 21:00:00,222,156,321,7,0,2624,3330,21214
2022-02-23 21:00:00,2022-02-23 22:00:00,221,21,319,0,0,2658,3219,19943
2022-02-23 22:00:00,2022-02-23 23:00:00,219,17,308,0,0,2984,3528,18834
2022-02-23 23:00:00,2022-02-24 00:00:00,218,17,308,0,0,3263,3806,18193
2022-02-24 00:00:00,2022-02-24 01:00:00,219,17,308,0,0,3462,4006,17939
2022-02-24 01:00:00,2022-02-24 02:00:00,218,17,308,0,0,3690,4233,17955
2022-02-24 02:00:00,2022-02-24 03:00:00,220,17,308,0,0,4003,4548,18389
2022-02-24 03:00:00,2022-02-24 04:00:00,219,17,308,0,0,4168,4712,19236
2022-02-24 04:00:00,2022-02-24 05:00:00,221,17,309,44,3,4300,4894,21505
2022-02-24 05:00:00,2022-02-24 06:00:00,222,69,314,51,192,4488,5336,22737
2022-02-24 06:00:00,2022-02-24 07:00:00,222,77,339,57,998,4328,6021,22686
2022-02-24 07:00:00,2022-02-24 08:00:00,222,56,345,7,2057,3828,6515,22363
2022-02-24 08:00:00,2022-02-24 09:00:00,224,28,344,0,2846,3412,6854,21834
2022-02-24 09:00:00,2022-02-24 10:00:00,221,104,334,0,3243,3529,7431,22095
2022-02-24 10:00:00,2022-02-24 11:00:00,221,329,331,0,3214,3831,7926,22257
2022-02-24 11:00:00,2022-02-24 12:00:00,224,368,330,0,2849,3987,7758,22580
2022-02-24 12:00:00,2022-02-24 13:00:00,224,370,335,0,2193,4400,7522,22808
2022-02-24 13:00:00,2022-02-24 14:00:00,222,153,326,0,1634,4435,6770,23306
2022-02-24 14:00:00,2022-02-24 15:00:00,223,232,325,0,719,4848,6347,23461
2022-02-24 15:00:00,2022-02-24 16:00:00,221,712,325,50,97,5252,6657,24018
2022-02-24 16:00:00,2022-02-24 17:00:00,223,765,331,57,0,5446,6822,24199
2022-02-24 17:00:00,2022-02-24 18:00:00,224,759,335,57,0,5825,7200,24168
2022-02-24 18:00:00,2022-02-24 19:00:00,224,491,319,7,0,6059,7100,23637
2022-02-24 19:00:00,2022-02-24 20:00:00,222,370,308,0,0,6108,7008,22159
2022-02-24 20:00:00,2022-02-24 21:00:00,223,251,298,0,0,6226,6998,20688
2022-02-24 21:00:00,2022-02-24 22:00:00,223,24,298,0,0,6399,6944,19511
2022-02-24 22:00:00,2022-02-24 23:00:00,221,0,299,0,0,6453,6973,18406
2022-02-24 23:00:00,2022-02-25 00:00:00,222,0,300,0,0,6517,7039,17863
2022-02-25 00:00:00,2022-02-25 01:00:00,222,0,300,0,0,6401,6923,17564
2022-02-25 01:00:00,2022-02-25 02:00:00,221,0,300,0,0,6200,6721,17574
2022-02-25 02:00:00,2022-02-25 03:00:00,222,0,300,0,0,6004,6526,18041
2022-02-25 03:00:00,2022-02-25 04:00:00,225,14,300,0,0,5952,6491,18913
2022-02-25 04:00:00,2022-02-25 05:00:00,222,17,300,0,3,5813,6355,21020
2022-02-25 05:00:00,2022-02-25 06:00:00,222,81,300,0,126,5602,6331,22731
2022-02-25 06:00:00,2022-02-25 07:00:00,222,85,300,0,642,5320,6569,23473
2022-02-25 07:00:00,2022-02-25 08:00:00,221,22,303,0,1237,5532,7315,23644
2022-02-25 08:00:00,2022-02-25 09:00:00,221,81,302,0,1630,5641,7875,23505
2022-02-25 09:00:00,2022-02-25 10:00:00,221,131,302,0,1833,5508,7995,23491
2022-02-25 10:00:00,2022-02-25 11:00:00,222,131,306,0,1931,5474,8064,23385
2022-02-25 11:00:00,2022-02-25 12:00:00,222,82,320,0,1886,5300,7810,23410
2022-02-25 12:00:00,2022-02-25 13:00:00,221,1,322,0,1920,4967,7431,23464
2022-02-25 13:00:00,2022-02-25 14:00:00,219,25,322,0,1229,4306,6101,23434
2022-02-25 14:00:00,2022-02-25 15:00:00,221,276,324,50,580,3774,5225,23621
2022-02-25 15:00:00,2022-02-25 16:00:00,221,615,323,57,72,3284,4572,24267
2022-02-25 16:00:00,2022-02-25 17:00:00,221,650,325,57,0,3101,4354,24634
2022-02-25 17:00:00,2022-02-25 18:00:00,222,569,326,57,0,3015,4189,24394
2022-02-25 18:00:00,2022-02-25 19:00:00,220,545,316,57,0,2984,4122,23682
2022-02-25 19:00:00,2022-02-25 20:00:00,220,324,303,7,0,2761,3615,22157
2022-02-25 20:00:00,2022-02-25 21:00:00,222,127,299,0,0,2387,3035,20771
2022-02-25 21:00:00,2022-02-25 22:00:00,220,16,295,0,0,1964,2495,19568
2022-02-25 22:00:00,2022-02-25 23:00:00,215,5,293,0,0,1726,2239,18705
2022-02-25 23:00:00,2022-02-26 00:00:00,213,0,292,0,0,1602,2107,18043
2022-02-26 00:00:00,2022-02-26 01:00:00,212,0,292,0,0,1508,2012,17773
2022-02-26 01:00:00,2022-02-26 02:00:00,211,0,292,0,0,1231,1734,17738
2022-02-26 02:00:00,2022-02-26 03:00:00,220,0,292,0,0,980,1492,17819
2022-02-26 03:00:00,2022-02-26 04:00:00,222,0,292,0,0,793,1307,17974
2022-02-26 04:00:00,2022-02-26 05:00:00,223,0,292,0,15,619,1149,18615
2022-02-26 05:00:00,2022-02-26 06:00:00,221,38,292,0,122,551,1224,19481
2022-02-26 06:00:00,2022-02-26 07:00:00,221,97,296,50,614,439,1717,20517
2022-02-26 07:00:00,2022-02-26 08:00:00,222,253,317,57,1136,309,2294,21222
2022-02-26 08:00:00,2022-02-26 09:00:00,223,351,320,7,1599,260,2760,21646
2022-02-26 09:00:00,2022-02-26 10:00:00,224,303,320,0,1907,243,2997,21955
2022-02-26 10:00:00,2022-02-26 11:00:00,222,394,321,0,2009,288,3234,21963
2022-02-26 11:00:00,2022-02-26 12:00:00,221,205,308,0,1767,383,2884,21836
2022-02-26 12:00:00,2022-02-26 13:00:00,223,50,315,0,1411,556,2555,21395
2022-02-26 13:00:00,2022-02-26 14:00:00,220,2,327,0,944,633,2126,21032
2022-02-26 14:00:00,2022-02-26 15:00:00,221,78,341,0,445,644,1729,20933
2022-02-26 15:00:00,2022-02-26 16:00:00,221,612,343,50,81,725,2032,21483
2022-02-26 16:00:00,2022-02-26 17:00:00,221,690,316,57,0,717,2001,21867
2022-02-26 17:00:00,2022-02-26 18:00:00,221,544,311,57,0,758,1891,21561
2022-02-26 18:00:00,2022-02-26 19:00:00,221,236,310,57,0,883,1707,21009
2022-02-26 19:00:00,2022-02-26 20:00:00,219,42,310,7,0,1089,1667,19888
2022-02-26 20:00:00,2022-02-26 21:00:00,220,17,296,0,0,1113,1646,18790
2022-02-26 21:00:00,2022-02-26 22:00:00,219,2,290,0,0,1123,1634,17793
2022-02-26 22:00:00,2022-02-26 23:00:00,212,12,280,0,0,1039,1543,16799
2022-02-26 23:00:00,2022-02-27 00:00:00,212,2,279,0,0,1053,1546,16203
2022-02-27 00:00:00,2022-02-27 01:00:00,216,0,279,0,0,1069,1564,15920
2022-02-27 01:00:00,2022-02-27 02:00:00,213,0,279,0,0,1003,1495,15757
2022-02-27 02:00:00,2022-02-27 03:00:00,219,0,279,0,0,957,1455,15811
2022-02-27 03:00:00,2022-02-27 04:00:00,219,0,279,0,0,815,1313,16043
2022-02-27 04:00:00,2022-02-27 05:00:00,221,0,279,0,23,671,1194,16140
2022-02-27 05:00:00,2022-02-27 06:00:00,221,53,279,0,177,520,1250,16500
2022-02-27 06:00:00,2022-02-27 07:00:00,222,48,280,50,740,399,1739,17013
2022-02-27 07:00:00,2022-02-27 08:00:00,220,21,292,57,1477,241,2308,17611
2022-02-27 08:00:00,2022-02-27 09:00:00,221,13,294,7,2041,208,2784,17868
2022-02-27 09:00:00,2022-02-27 10:00:00,217,1,295,0,2294,217,3024,18138
2022-02-27 10:00:00,2022-02-27 11:00:00,219,117,296,0,2429,236,3297,18537
2022-02-27 11:00:00,2022-02-27 12:00:00,221,229,297,0,2516,315,3578,18976
2022-02-27 12:00:00,2022-02-27 13:00:00,221,22,311,0,1907,449,2910,18406
2022-02-27 13:00:00,2022-02-27 14:00:00,220,0,318,0,1374,585,2497,18377
2022-02-27 14:00:00,2022-02-27 15:00:00,220,5,325,0,767,659,1976,18717
2022-02-27 15:00:00,2022-02-27 16:00:00,219,221,331,50,139,809,1769,19502
2022-02-27 16:00:00,2022-02-27 17:00:00,219,598,333,57,0,1141,2348,20492
2022-02-27 17:00:00,2022-02-27 18:00:00,220,374,330,57,0,1473,2454,20695
2022-02-27 18:00:00,2022-02-27 19:00:00,219,67,328,57,0,1501,2172,20268
2022-02-27 19:00:00,2022-02-27 20:00:00,222,28,323,7,0,1610,2190,19488
2022-02-27 20:00:00,2022-02-27 21:00:00,220,8,308,0,0,1660,2196,18725
2022-02-27 21:00:00,2022-02-27 22:00:00,221,0,286,0,0,1479,1986,17748
2022-02-27 22:00:00,2022-02-27 23:00:00,217,0,265,0,0,1268,1750,16976
2022-02-27 23:00:00,2022-02-28 00:00:00,216,0,263,0,0,1068,1547,16711
2022-02-28 00:00:00,2022-02-28 01:00:00,215,0,263,0,0,915,1393,16517
2022-02-28 01:00:00,2022-02-28 02:00:00,215,0,263,0,0,855,1333,16600
2022-02-28 02:00:00,2022-02-28 03:00:00,220,0,263,0,0,803,1286,17109
2022-02-28 03:00:00,2022-02-28 04:00:00,221,0,263,0,0,768,1252,18475
2022-02-28 04:00:00,2022-02-28 05:00:00,223,36,264,0,14,731,1268,21263
2022-02-28 05:00:00,2022-02-28 06:00:00,223,43,269,0,292,637,1464,22961
2022-02-28 06:00:00,2022-02-28 07:00:00,224,138,271,50,1153,363,2199,23396
2022-02-28 07:00:00,2022-02-28 08:00:00,224,52,273,57,2134,228,2968,23274
2022-02-28 08:00:00,2022-02-28 09:00:00,225,11,274,7,2726,336,3579,22663
2022-02-28 09:00:00,2022-02-28 10:00:00,222,0,271,0,3400,464,4357,23278
2022-02-28 10:00:00,2022-02-28 11:00:00,225,0,269,0,3376,512,4382,23440
2022-02-28 11:00:00,2022-02-28 12:00:00,225,0,269,0,3164,507,4165,23536
2022-02-28 12:00:00,2022-02-28 13:00:00,225,0,269,0,2741,497,3732,23487
2022-02-28 13:00:00,2022-02-28 14:00:00,224,26,282,0,1861,503,2896,23492
2022-02-28 14:00:00,2022-02-28 15:00:00,225,171,293,0,930,499,2118,23802
2022-02-28 15:00:00,2022-02-28 16:00:00,225,865,328,50,162,537,2167,24359
2022-02-28 16:00:00,2022-02-28 17:00:00,223,1038,328,57,0,774,2420,25055
2022-02-28 17:00:00,2022-02-28 18:00:00,223,699,328,57,0,1011,2318,24942
2022-02-28 18:00:00,2022-02-28 19:00:00,222,121,320,57,0,1311,2031,24531
2022-02-28 19:00:00,2022-02-28 20:00:00,221,20,288,7,0,1453,1989,22985
2022-02-28 20:00:00,2022-02-28 21:00:00,218,18,263,0,0,1421,1920,21559
2022-02-28 21:00:00,2022-02-28 22:00:00,218,2,261,0,0,1359,1840,20319
2022-02-28 22:00:00,2022-02-28 23:00:00,215,0,265,0,0,1243,1723,19288
2022-02-28 23:00:00,2022-03-01 00:00:00,219,0,266,0,0,1256,1741,18700
2022-03-01 00:00:00,2022-03-01 01:00:00,220,0,266,0,0,1190,1676,18468
2022-03-01 01:00:00,2022-03-01 02:00:00,216,0,266,0,0,1143,1625,18562
2022-03-01 02:00:00,2022-03-01 03:00:00,221,0,266,0,0,1192,1679,19003
2022-03-01 03:00:00,2022-03-01 04:00:00,225,0,265,0,0,1176,1666,19919
2022-03-01 04:00:00,2022-03-01 05:00:00,225,0,264,0,42,1182,1713,22076
2022-03-01 05:00:00,2022-03-01 06:00:00,224,18,263,0,336,1102,1943,23443
2022-03-01 06:00:00,2022-03-01 07:00:00,225,20,293,0,1347,788,2673,23619
2022-03-01 07:00:00,2022-03-01 08:00:00,223,38,315,0,2333,353,3262,23186
2022-03-01 08:00:00,2022-03-01 09:00:00,225,40,318,0,3091,292,3966,22649
2022-03-01 09:00:00,2022-03-01 10:00:00,225,5,319,0,3548,358,4455,22683
2022-03-01 10:00:00,2022-03-01 11:00:00,224,0,291,0,3695,342,4552,22660
2022-03-01 11:00:00,2022-03-01 12:00:00,226,0,288,0,3510,344,4368,22783
2022-03-01 12:00:00,2022-03-01 13:00:00,226,0,284,0,2985,330,3825,22848
2022-03-01 13:00:00,2022-03-01 14:00:00,223,0,282,0,2200,280,2985,23387
2022-03-01 14:00:00,2022-03-01 15:00:00,223,20,299,50,1125,279,1996,23962
2022-03-01 15:00:00,2022-03-01 16:00:00,225,640,306,57,241,352,1821,24576
2022-03-01 16:00:00,2022-03-01 17:00:00,225,1040,307,57,1,535,2165,25160
2022-03-01 17:00:00,2022-03-01 18:00:00,223,1011,307,57,0,788,2386,25113
2022-03-01 18:00:00,2022-03-01 19:00:00,225,297,303,57,0,1028,1910,24557
2022-03-01 19:00:00,2022-03-01 20:00:00,227,111,287,7,0,1012,1644,23089
2022-03-01 20:00:00,2022-03-01 21:00:00,224,11,280,0,0,950,1465,21618
2022-03-01 21:00:00,2022-03-01 22:00:00,223,0,272,0,0,787,1282,20398
2022-03-01 22:00:00,2022-03-01 23:00:00,219,0,267,0,0,608,1094,19449
2022-03-01 23:00:00,2022-03-02 00:00:00,199,0,266,0,0,500,965,18834
2022-03-02 00:00:00,2022-03-02 01:00:00,216,0,266,0,0,440,922,18577
2022-03-02 01:00:00,2022-03-02 02:00:00,218,0,266,0,0,392,876,18691
2022-03-02 02:00:00,2022-03-02 03:00:00,218,0,266,0,0,341,825,19125
2022-03-02 03:00:00,2022-03-02 04:00:00,221,0,266,0,0,290,777,20035
2022-03-02 04:00:00,2022-03-02 05:00:00,224,13,266,50,25,292,870,22163
2022-03-02 05:00:00,2022-03-02 06:00:00,225,48,269,57,444,294,1337,23696
2022-03-02 06:00:00,2022-03-02 07:00:00,227,106,267,7,1425,207,2239,24070
2022-03-02 07:00:00,2022-03-02 08:00:00,223,79,270,0,2307,78,2957,23599
2022-03-02 08:00:00,2022-03-02 09:00:00,226,14,271,0,2955,33,3499,22796
2022-03-02 09:00:00,2022-03-02 10:00:00,226,2,270,0,3288,37,3823,22825
2022-03-02 10:00:00,2022-03-02 11:00:00,225,0,271,0,3320,57,3873,22846
2022-03-02 11:00:00,2022-03-02 12:00:00,224,0,271,0,3155,77,3727,23053
2022-03-02 12:00:00,2022-03-02 13:00:00,226,0,273,0,2701,115,3315,23149
2022-03-02 13:00:00,2022-03-02 14:00:00,226,0,271,0,1976,168,2641,23477
2022-03-02 14:00:00,2022-03-02 15:00:00,227,67,296,50,1080,166,1886,23996
2022-03-02 15:00:00,2022-03-02 16:00:00,227,545,313,57,213,196,1551,24441
2022-03-02 16:00:00,2022-03-02 17:00:00,227,948,333,57,1,306,1872,25205
2022-03-02 17:00:00,2022-03-02 18:00:00,223,1076,337,57,0,380,2073,25349
2022-03-02 18:00:00,2022-03-02 19:00:00,225,589,332,57,0,421,1624,24768
2022-03-02 19:00:00,2022-03-02 20:00:00,226,139,314,7,0,417,1103,23249
2022-03-02 20:00:00,2022-03-02 21:00:00,226,6,272,0,0,362,866,21621
2022-03-02 21:00:00,2022-03-02 22:00:00,225,0,264,0,0,355,844,20472
2022-03-02 22:00:00,2022-03-02 23:00:00,217,0,250,0,0,364,831,19455
2022-03-02 23:00:00,2022-03-03 00:00:00,218,0,248,0,0,379,845,18879
2022-03-03 00:00:00,2022-03-03 01:00:00,217,0,248,0,0,386,851,18619
2022-03-03 01:00:00,2022-03-03 02:00:00,216,0,248,0,0,463,927,18735
2022-03-03 02:00:00,2022-03-03 03:00:00,218,0,248,0,0,511,977,19022
2022-03-03 03:00:00,2022-03-03 04:00:00,225,0,248,0,0,528,1001,19864
2022-03-03 04:00:00,2022-03-03 05:00:00,226,25,249,0,33,528,1061,22138
2022-03-03 05:00:00,2022-03-03 06:00:00,224,112,270,0,238,541,1385,23810
2022-03-03 06:00:00,2022-03-03 07:00:00,232,209,274,0,864,464,2043,24288
2022-03-03 07:00:00,2022-03-03 08:00:00,234,200,278,0,1576,346,2634,24181
2022-03-03 08:00:00,2022-03-03 09:00:00,230,23,277,0,2014,406,2950,23698
2022-03-03 09:00:00,2022-03-03 10:00:00,223,0,277,0,2332,489,3321,23784
2022-03-03 10:00:00,2022-03-03 11:00:00,225,0,283,0,2612,599,3719,23881
2022-03-03 11:00:00,2022-03-03 12:00:00,225,0,269,0,2595,652,3741,24224
2022-03-03 12:00:00,2022-03-03 13:00:00,226,0,262,0,2244,796,3528,24175
2022-03-03 13:00:00,2022-03-03 14:00:00,225,0,263,0,1601,847,2936,24339
2022-03-03 14:00:00,2022-03-03 15:00:00,226,230,288,50,815,1072,2681,24459
2022-03-03 15:00:00,2022-03-03 16:00:00,224,868,315,57,208,1336,3008,24805
2022-03-03 16:00:00,2022-03-03 17:00:00,226,877,320,57,3,1482,2965,25324
2022-03-03 17:00:00,2022-03-03 18:00:00,226,798,320,57,0,1394,2795,25305
2022-03-03 18:00:00,2022-03-03 19:00:00,225,493,311,57,0,1241,2327,24737
2022-03-03 19:00:00,2022-03-03 20:00:00,225,125,295,7,0,1159,1811,23241
2022-03-03 20:00:00,2022-03-03 21:00:00,226,18,250,0,0,1056,1550,21663
2022-03-03 21:00:00,2022-03-03 22:00:00,224,2,244,0,0,1045,1515,20415
2022-03-03 22:00:00,2022-03-03 23:00:00,217,0,234,0,0,1197,1648,19370
2022-03-03 23:00:00,2022-03-04 00:00:00,217,0,229,0,0,1253,1699,18821
2022-03-04 00:00:00,2022-03-04 01:00:00,218,0,229,0,0,1285,1732,18552
2022-03-04 01:00:00,2022-03-04 02:00:00,219,0,229,0,0,1313,1761,18579
2022-03-04 02:00:00,2022-03-04 03:00:00,224,0,229,0,0,1336,1789,18913
2022-03-04 03:00:00,2022-03-04 04:00:00,225,0,228,0,0,1318,1771,19745
2022-03-04 04:00:00,2022-03-04 05:00:00,225,11,228,0,16,1303,1783,21889
2022-03-04 05:00:00,2022-03-04 06:00:00,224,23,228,0,92,1191,1758,23939
2022-03-04 06:00:00,2022-03-04 07:00:00,226,142,247,0,310,1042,1967,24947
2022-03-04 07:00:00,2022-03-04 08:00:00,225,207,265,0,715,1101,2513,25215
2022-03-04 08:00:00,2022-03-04 09:00:00,225,587,259,0,1034,1096,3201,25155
2022-03-04 09:00:00,2022-03-04 10:00:00,225,705,248,0,1237,1094,3509,25515
2022-03-04 10:00:00,2022-03-04 11:00:00,225,666,242,0,1293,1019,3445,25536
2022-03-04 11:00:00,2022-03-04 12:00:00,227,596,242,0,1313,894,3272,25508
2022-03-04 12:00:00,2022-03-04 13:00:00,228,248,243,0,1227,962,2908,25238
2022-03-04 13:00:00,2022-03-04 14:00:00,226,34,251,0,877,1234,2622,24885
2022-03-04 14:00:00,2022-03-04 15:00:00,227,3,260,50,405,1338,2283,24393
2022-03-04 15:00:00,2022-03-04 16:00:00,228,209,302,57,113,1317,2226,24713
2022-03-04 16:00:00,2022-03-04 17:00:00,225,590,309,57,2,1363,2546,25322
2022-03-04 17:00:00,2022-03-04 18:00:00,224,554,311,57,0,1539,2685,25113
2022-03-04 18:00:00,2022-03-04 19:00:00,225,210,288,57,0,1604,2384,24375
2022-03-04 19:00:00,2022-03-04 20:00:00,227,258,257,7,0,1526,2275,22925
2022-03-04 20:00:00,2022-03-04 21:00:00,226,119,239,0,0,1390,1974,21442
2022-03-04 21:00:00,2022-03-04 22:00:00,224,2,234,0,0,1176,1636,20252
2022-03-04 22:00:00,2022-03-04 23:00:00,169,0,237,0,0,1025,1431,19376
2022-03-04 23:00:00,2022-03-05 00:00:00,141,0,237,0,0,889,1267,18683
2022-03-05 00:00:00,2022-03-05 01:00:00,139,0,237,0,0,776,1152,18306
2022-03-05 01:00:00,2022-03-05 02:00:00,141,0,237,0,0,638,1016,18227
2022-03-05 02:00:00,2022-03-05 03:00:00,141,6,237,0,0,631,1015,18301
2022-03-05 03:00:00,2022-03-05 04:00:00,140,43,237,0,0,559,979,18474
2022-03-05 04:00:00,2022-03-05 05:00:00,141,6,237,0,2,492,878,18810
2022-03-05 05:00:00,2022-03-05 06:00:00,140,17,237,0,177,428,999,19938
2022-03-05 06:00:00,2022-03-05 07:00:00,142,7,250,0,738,285,1422,21030
2022-03-05 07:00:00,2022-03-05 08:00:00,141,11,255,0,1333,230,1970,21798
2022-03-05 08:00:00,2022-03-05 09:00:00,142,17,256,0,1782,231,2428,22186
2022-03-05 09:00:00,2022-03-05 10:00:00,141,97,256,0,2221,227,2942,22862
2022-03-05 10:00:00,2022-03-05 11:00:00,142,3,249,0,1915,210,2519,22588
2022-03-05 11:00:00,2022-03-05 12:00:00,142,15,248,0,1575,186,2166,22124
2022-03-05 12:00:00,2022-03-05 13:00:00,142,2,252,0,1598,207,2201,21893
2022-03-05 13:00:00,2022-03-05 14:00:00,143,13,256,0,1348,264,2024,21871
2022-03-05 14:00:00,2022-03-05 15:00:00,142,2,267,50,557,314,1332,21546
2022-03-05 15:00:00,2022-03-05 16:00:00,142,80,295,57,152,293,1019,21791
2022-03-05 16:00:00,2022-03-05 17:00:00,143,269,309,57,3,341,1122,22434
2022-03-05 17:00:00,2022-03-05 18:00:00,143,253,307,57,0,342,1102,22217
2022-03-05 18:00:00,2022-03-05 19:00:00,143,51,292,57,0,268,811,21633
2022-03-05 19:00:00,2022-03-05 20:00:00,142,133,275,7,0,162,719,20598
2022-03-05 20:00:00,2022-03-05 21:00:00,143,277,245,0,0,81,746,19481
2022-03-05 21:00:00,2022-03-05 22:00:00,144,41,232,0,0,45,462,18333
2022-03-05 22:00:00,2022-03-05 23:00:00,144,165,230,0,0,34,573,17421
2022-03-05 23:00:00,2022-03-06 00:00:00,145,45,228,0,0,41,459,16871
2022-03-06 00:00:00,2022-03-06 01:00:00,147,12,228,0,0,53,440,16342
2022-03-06 01:00:00,2022-03-06 02:00:00,145,2,228,0,0,80,455,16239
2022-03-06 02:00:00,2022-03-06 03:00:00,144,0,228,0,0,104,476,16331
2022-03-06 03:00:00,2022-03-06 04:00:00,142,0,228,0,0,86,456,16312
2022-03-06 04:00:00,2022-03-06 05:00:00,113,13,228,0,50,53,457,16355
2022-03-06 05:00:00,2022-03-06 06:00:00,114,31,228,0,192,56,621,16908
2022-03-06 06:00:00,2022-03-06 07:00:00,112,285,242,0,609,49,1297,17772
2022-03-06 07:00:00,2022-03-06 08:00:00,112,88,256,0,1113,41,1610,18758
2022-03-06 08:00:00,2022-03-06 09:00:00,113,0,256,0,1366,53,1788,19328
2022-03-06 09:00:00,2022-03-06 10:00:00,114,0,256,0,1557,89,2016,19817
2022-03-06 10:00:00,2022-03-06 11:00:00,114,40,259,0,1761,145,2319,20258
2022-03-06 11:00:00,2022-03-06 12:00:00,113,184,259,0,1488,201,2245,20271
2022-03-06 12:00:00,2022-03-06 13:00:00,112,0,259,0,1310,305,1986,20237
2022-03-06 13:00:00,2022-03-06 14:00:00,112,10,259,0,783,411,1575,19794
2022-03-06 14:00:00,2022-03-06 15:00:00,113,4,264,50,364,414,1209,19489
2022-03-06 15:00:00,2022-03-06 16:00:00,112,131,273,57,66,369,1008,19908
2022-03-06 16:00:00,2022-03-06 17:00:00,113,544,304,57,1,408,1427,20912
2022-03-06 17:00:00,2022-03-06 18:00:00,114,598,308,57,0,437,1514,21011
2022-03-06 18:00:00,2022-03-06 19:00:00,113,157,299,57,0,454,1080,20560
2022-03-06 19:00:00,2022-03-06 20:00:00,114,2,294,7,0,570,987,19651
2022-03-06 20:00:00,2022-03-06 21:00:00,113,0,237,0,0,759,1109,18956
2022-03-06 21:00:00,2022-03-06 22:00:00,127,0,228,0,0,759,1114,17933
2022-03-06 22:00:00,2022-03-06 23:00:00,145,0,222,0,0,833,1200,17142
2022-03-06 23:00:00,2022-03-07 00:00:00,147,0,221,0,0,916,1284,16736
2022-03-07 00:00:00,2022-03-07 01:00:00,147,0,221,0,0,833,1201,16572
2022-03-07 01:00:00,2022-03-07 02:00:00,146,0,221,0,0,923,1290,16742
2022-03-07 02:00:00,2022-03-07 03:00:00,145,0,221,0,0,1074,1440,17267
2022-03-07 03:00:00,2022-03-07 04:00:00,156,0,221,0,0,1237,1614,18427
2022-03-07 04:00:00,2022-03-07 05:00:00,214,0,221,0,47,1440,1922,21050
2022-03-07 05:00:00,2022-03-07 06:00:00,222,13,222,0,340,1508,2305,23273
2022-03-07 06:00:00,2022-03-07 07:00:00,224,59,253,0,948,1091,2575,24072
2022-03-07 07:00:00,2022-03-07 08:00:00,223,19,271,0,1924,1029,3466,24354
2022-03-07 08:00:00,2022-03-07 09:00:00,224,0,246,0,2391,1209,4070,23720
2022-03-07 09:00:00,2022-03-07 10:00:00,225,0,242,0,2792,1449,4708,23694
2022-03-07 10:00:00,2022-03-07 11:00:00,226,0,241,0,2946,1981,5394,23967
2022-03-07 11:00:00,2022-03-07 12:00:00,223,0,241,0,2612,2193,5269,24124
2022-03-07 12:00:00,2022-03-07 13:00:00,225,0,239,0,2130,2196,4790,23974
2022-03-07 13:00:00,2022-03-07 14:00:00,223,0,238,0,1630,2067,4158,24109
2022-03-07 14:00:00,2022-03-07 15:00:00,223,232,251,50,947,1782,3485,24227
2022-03-07 15:00:00,2022-03-07 16:00:00,223,455,276,57,252,1647,2910,24428
2022-03-07 16:00:00,2022-03-07 17:00:00,223,741,291,57,7,1578,2897,25110
2022-03-07 17:00:00,2022-03-07 18:00:00,223,709,293,57,0,1703,2985,25201
2022-03-07 18:00:00,2022-03-07 19:00:00,225,363,293,57,0,1763,2701,24594
2022-03-07 19:00:00,2022-03-07 20:00:00,224,49,261,7,0,1621,2162,23082
2022-03-07 20:00:00,2022-03-07 21:00:00,226,0,219,0,0,1484,1929,21635
2022-03-07 21:00:00,2022-03-07 22:00:00,226,0,215,0,0,1180,1621,20265
2022-03-07 22:00:00,2022-03-07 23:00:00,220,79,211,0,0,1006,1516,19460
2022-03-07 23:00:00,2022-03-08 00:00:00,217,0,210,0,0,801,1228,18945
2022-03-08 00:00:00,2022-03-08 01:00:00,219,0,210,0,0,760,1189,18648
2022-03-08 01:00:00,2022-03-08 02:00:00,218,0,210,0,0,745,1173,18708
2022-03-08 02:00:00,2022-03-08 03:00:00,223,0,210,0,0,763,1196,19162
2022-03-08 03:00:00,2022-03-08 04:00:00,226,0,210,0,0,727,1163,19844
2022-03-08 04:00:00,2022-03-08 05:00:00,225,1,210,0,50,610,1096,21921
2022-03-08 05:00:00,2022-03-08 06:00:00,224,217,210,0,299,455,1405,23664
2022-03-08 06:00:00,2022-03-08 07:00:00,245,223,246,0,884,291,1889,24508
2022-03-08 07:00:00,2022-03-08 08:00:00,259,8,267,0,1623,230,2387,24677
2022-03-08 08:00:00,2022-03-08 09:00:00,260,0,265,0,1959,267,2751,24048
2022-03-08 09:00:00,2022-03-08 10:00:00,270,0,264,0,2510,298,3342,23959
2022-03-08 10:00:00,2022-03-08 11:00:00,263,0,258,0,3000,381,3902,23998
2022-03-08 11:00:00,2022-03-08 12:00:00,254,0,224,0,3016,504,3998,23946
2022-03-08 12:00:00,2022-03-08 13:00:00,256,0,218,0,2533,518,3525,23755
2022-03-08 13:00:00,2022-03-08 14:00:00,257,0,218,0,1750,492,2717,23779
2022-03-08 14:00:00,2022-03-08 15:00:00,258,114,242,0,1072,439,2125,24149
2022-03-08 15:00:00,2022-03-08 16:00:00,255,406,288,50,288,430,1717,24419
2022-03-08 16:00:00,2022-03-08 17:00:00,259,667,290,57,9,592,1874,25128
2022-03-08 17:00:00,2022-03-08 18:00:00,257,535,291,57,0,673,1813,25212
2022-03-08 18:00:00,2022-03-08 19:00:00,258,239,282,57,0,771,1607,24590
2022-03-08 19:00:00,2022-03-08 20:00:00,254,9,251,7,0,885,1406,23036
2022-03-08 20:00:00,2022-03-08 21:00:00,253,0,230,0,0,851,1334,21592
2022-03-08 21:00:00,2022-03-08 22:00:00,252,0,230,0,0,840,1322,20450
2022-03-08 22:00:00,2022-03-08 23:00:00,225,0,218,0,0,835,1278,19475
2022-03-08 23:00:00,2022-03-09 00:00:00,212,0,213,0,0,720,1145,18853
2022-03-09 00:00:00,2022-03-09 01:00:00,215,0,213,0,0,758,1186,18551
2022-03-09 01:00:00,2022-03-09 02:00:00,218,0,213,0,0,809,1240,18615
2022-03-09 02:00:00,2022-03-09 03:00:00,218,0,213,0,0,876,1307,19015
2022-03-09 03:00:00,2022-03-09 04:00:00,214,0,212,0,0,940,1366,19774
2022-03-09 04:00:00,2022-03-09 05:00:00,216,0,212,0,34,913,1375,21729
2022-03-09 05:00:00,2022-03-09 06:00:00,224,38,212,0,269,772,1515,23510
2022-03-09 06:00:00,2022-03-09 07:00:00,227,121,212,0,891,403,1854,24215
2022-03-09 07:00:00,2022-03-09 08:00:00,232,181,214,0,1610,213,2450,24034
2022-03-09 08:00:00,2022-03-09 09:00:00,232,0,218,0,2328,268,3046,23583
2022-03-09 09:00:00,2022-03-09 10:00:00,226,0,218,0,2927,405,3776,23730
2022-03-09 10:00:00,2022-03-09 11:00:00,231,0,218,0,2987,573,4009,23962
2022-03-09 11:00:00,2022-03-09 12:00:00,228,0,218,0,2750,788,3984,23988
2022-03-09 12:00:00,2022-03-09 13:00:00,235,0,220,0,2297,1009,3761,23630
2022-03-09 13:00:00,2022-03-09 14:00:00,227,0,221,0,1777,1065,3290,23834
2022-03-09 14:00:00,2022-03-09 15:00:00,229,0,231,50,1119,1051,2680,24062
2022-03-09 15:00:00,2022-03-09 16:00:00,226,59,246,57,337,1067,1992,24293
2022-03-09 16:00:00,2022-03-09 17:00:00,227,278,287,57,13,1279,2141,24974
2022-03-09 17:00:00,2022-03-09 18:00:00,226,485,294,57,0,1550,2612,25089
2022-03-09 18:00:00,2022-03-09 19:00:00,225,142,287,57,0,1911,2622,24481
2022-03-09 19:00:00,2022-03-09 20:00:00,225,0,282,7,0,2211,2725,23014
2022-03-09 20:00:00,2022-03-09 21:00:00,222,0,248,0,0,2256,2726,21408
2022-03-09 21:00:00,2022-03-09 22:00:00,216,0,221,0,0,2223,2660,20154
2022-03-09 22:00:00,2022-03-09 23:00:00,216,7,221,0,0,2143,2587,19098
2022-03-09 23:00:00,2022-03-10 00:00:00,216,2,220,0,0,1979,2417,18505
2022-03-10 00:00:00,2022-03-10 01:00:00,217,0,220,0,0,1844,2281,18252
2022-03-10 01:00:00,2022-03-10 02:00:00,217,0,221,0,0,1828,2266,18385
2022-03-10 02:00:00,2022-03-10 03:00:00,216,0,221,0,0,1983,2420,18740
2022-03-10 03:00:00,2022-03-10 04:00:00,215,19,220,0,0,2104,2558,19382
2022-03-10 04:00:00,2022-03-10 05:00:00,216,20,220,0,70,2189,2715,21325
2022-03-10 05:00:00,2022-03-10 06:00:00,215,41,219,0,514,1859,2848,22615
2022-03-10 06:00:00,2022-03-10 07:00:00,216,46,231,0,1491,1415,3399,22833
2022-03-10 07:00:00,2022-03-10 08:00:00,217,2,245,0,2587,1375,4426,22729
2022-03-10 08:00:00,2022-03-10 09:00:00,218,0,246,0,3498,1426,5388,22524
2022-03-10 09:00:00,2022-03-10 10:00:00,216,0,249,0,4025,1228,5718,22684
2022-03-10 10:00:00,2022-03-10 11:00:00,216,0,246,0,4261,1106,5829,22811
2022-03-10 11:00:00,2022-03-10 12:00:00,216,0,245,0,4040,1129,5630,22869
2022-03-10 12:00:00,2022-03-10 13:00:00,218,0,217,0,3489,1176,5100,22842
2022-03-10 13:00:00,2022-03-10 14:00:00,217,0,213,0,2668,1240,4338,23328
2022-03-10 14:00:00,2022-03-10 15:00:00,225,281,213,0,1608,1375,3702,23991
2022-03-10 15:00:00,2022-03-10 16:00:00,225,879,218,50,488,1759,3619,24315
2022-03-10 16:00:00,2022-03-10 17:00:00,228,877,282,57,15,2511,3970,25143
2022-03-10 17:00:00,2022-03-10 18:00:00,227,320,291,57,0,3078,3973,25227
2022-03-10 18:00:00,2022-03-10 19:00:00,226,19,282,7,0,3245,3779,24700
2022-03-10 19:00:00,2022-03-10 20:00:00,226,0,267,0,0,3256,3749,23197
2022-03-10 20:00:00,2022-03-10 21:00:00,220,0,217,0,0,3098,3535,21546
2022-03-10 21:00:00,2022-03-10 22:00:00,216,0,214,0,0,2942,3372,20340
2022-03-10 22:00:00,2022-03-10 23:00:00,218,0,209,0,0,2807,3234,19262
2022-03-10 23:00:00,2022-03-11 00:00:00,222,0,208,0,0,2552,2982,18805
2022-03-11 00:00:00,2022-03-11 01:00:00,221,0,208,0,0,2441,2870,18506
2022-03-11 01:00:00,2022-03-11 02:00:00,217,0,208,0,0,2447,2872,18605
2022-03-11 02:00:00,2022-03-11 03:00:00,218,0,208,0,0,2519,2945,18857
2022-03-11 03:00:00,2022-03-11 04:00:00,217,0,208,0,0,2548,2973,19743
2022-03-11 04:00:00,2022-03-11 05:00:00,218,0,207,0,86,2674,3185,21587
2022-03-11 05:00:00,2022-03-11 06:00:00,225,129,208,0,687,2293,3542,22989
2022-03-11 06:00:00,2022-03-11 07:00:00,238,3,206,0,1886,1843,4176,23199
2022-03-11 07:00:00,2022-03-11 08:00:00,239,0,209,0,2969,1896,5313,22791
2022-03-11 08:00:00,2022-03-11 09:00:00,239,0,211,0,3810,1923,6183,22388
2022-03-11 09:00:00,2022-03-11 10:00:00,238,0,212,0,4264,2105,6819,22417
2022-03-11 10:00:00,2022-03-11 11:00:00,239,0,211,0,4416,2335,7201,22520
2022-03-11 11:00:00,2022-03-11 12:00:00,226,0,214,0,4212,2431,7083,22692
2022-03-11 12:00:00,2022-03-11 13:00:00,218,0,217,0,3600,2311,6346,22549
2022-03-11 13:00:00,2022-03-11 14:00:00,210,0,218,0,2754,2214,5396,23002
2022-03-11 14:00:00,2022-03-11 15:00:00,218,58,221,0,1679,2081,4257,23811
2022-03-11 15:00:00,2022-03-11 16:00:00,212,347,241,50,526,2085,3461,24143
2022-03-11 16:00:00,2022-03-11 17:00:00,192,874,286,57,17,2609,4035,25012
2022-03-11 17:00:00,2022-03-11 18:00:00,192,610,288,57,0,3039,4186,25049
2022-03-11 18:00:00,2022-03-11 19:00:00,192,184,277,7,0,3152,3812,24333
2022-03-11 19:00:00,2022-03-11 20:00:00,192,2,249,0,0,3277,3720,22714
2022-03-11 20:00:00,2022-03-11 21:00:00,192,0,211,0,0,3318,3721,21162
2022-03-11 21:00:00,2022-03-11 22:00:00,190,0,205,0,0,3175,3570,20026
2022-03-11 22:00:00,2022-03-11 23:00:00,190,0,200,0,0,3114,3504,19035
2022-03-11 23:00:00,2022-03-12 00:00:00,165,0,198,0,0,3058,3421,18514
2022-03-12 00:00:00,2022-03-12 01:00:00,154,0,199,0,0,3058,3411,18132
2022-03-12 01:00:00,2022-03-12 02:00:00,153,0,199,0,0,2978,3330,18012
2022-03-12 02:00:00,2022-03-12 03:00:00,154,0,198,0,0,2869,3221,18166
2022-03-12 03:00:00,2022-03-12 04:00:00,152,0,199,0,0,2813,3164,18189
2022-03-12 04:00:00,2022-03-12 05:00:00,153,0,199,0,97,2610,3059,18526
2022-03-12 05:00:00,2022-03-12 06:00:00,154,9,199,0,674,2182,3218,19321
2022-03-12 06:00:00,2022-03-12 07:00:00,148,1,219,0,1783,1098,3249,19817
2022-03-12 07:00:00,2022-03-12 08:00:00,146,0,235,0,2903,673,3957,20122
2022-03-12 08:00:00,2022-03-12 09:00:00,146,0,235,0,3705,564,4650,20201
2022-03-12 09:00:00,2022-03-12 10:00:00,146,0,235,0,4007,591,4979,20048
2022-03-12 10:00:00,2022-03-12 11:00:00,124,0,236,0,4120,680,5160,19849
2022-03-12 11:00:00,2022-03-12 12:00:00,121,0,214,0,3932,717,4984,19736
2022-03-12 12:00:00,2022-03-12 13:00:00,122,0,210,0,3260,713,4305,19367
2022-03-12 13:00:00,2022-03-12 14:00:00,123,0,209,0,2511,723,3566,19634
2022-03-12 14:00:00,2022-03-12 15:00:00,146,65,214,0,1514,887,2826,20437
2022-03-12 15:00:00,2022-03-12 16:00:00,146,459,246,50,366,1220,2487,20914
2022-03-12 16:00:00,2022-03-12 17:00:00,144,695,260,57,14,1754,2924,21905
2022-03-12 17:00:00,2022-03-12 18:00:00,147,674,264,57,0,2013,3155,21792
2022-03-12 18:00:00,2022-03-12 19:00:00,190,396,256,7,0,2169,3018,21264
2022-03-12 19:00:00,2022-03-12 20:00:00,192,33,223,0,0,2280,2728,20204
2022-03-12 20:00:00,2022-03-12 21:00:00,192,0,201,0,0,2255,2648,19159
2022-03-12 21:00:00,2022-03-12 22:00:00,193,0,198,0,0,2154,2545,17924
2022-03-12 22:00:00,2022-03-12 23:00:00,192,0,194,0,0,1904,2290,16896
2022-03-12 23:00:00,2022-03-13 00:00:00,192,0,194,0,0,1826,2212,16298
2022-03-13 00:00:00,2022-03-13 01:00:00,192,0,194,0,0,1648,2034,15948
2022-03-13 01:00:00,2022-03-13 02:00:00,192,0,194,0,0,1639,2025,15835
2022-03-13 02:00:00,2022-03-13 03:00:00,191,0,194,0,0,1722,2107,15969
2022-03-13 03:00:00,2022-03-13 04:00:00,191,0,194,0,0,1707,2092,15938
2022-03-13 04:00:00,2022-03-13 05:00:00,191,0,194,0,98,1790,2273,15810
2022-03-13 05:00:00,2022-03-13 06:00:00,192,0,194,0,624,1781,2791,16014
2022-03-13 06:00:00,2022-03-13 07:00:00,192,0,199,0,1711,1207,3309,16456
2022-03-13 07:00:00,2022-03-13 08:00:00,191,0,217,0,2689,905,4002,16656
2022-03-13 08:00:00,2022-03-13 09:00:00,193,0,218,0,3479,1043,4933,16790
2022-03-13 09:00:00,2022-03-13 10:00:00,193,0,212,0,4065,1078,5548,16866
2022-03-13 10:00:00,2022-03-13 11:00:00,191,0,205,0,4215,1188,5799,16947
2022-03-13 11:00:00,2022-03-13 12:00:00,190,0,203,0,4009,1338,5740,16902
2022-03-13 12:00:00,2022-03-13 13:00:00,192,0,205,0,3492,1508,5397,16807
2022-03-13 13:00:00,2022-03-13 14:00:00,194,0,205,0,2673,1676,4748,16973
2022-03-13 14:00:00,2022-03-13 15:00:00,193,0,221,0,1621,1784,3819,17951
2022-03-13 15:00:00,2022-03-13 16:00:00,192,172,234,0,532,2251,3381,18665
2022-03-13 16:00:00,2022-03-13 17:00:00,190,331,256,50,20,3151,3998,19952
2022-03-13 17:00:00,2022-03-13 18:00:00,192,97,259,57,0,3964,4569,20209
2022-03-13 18:00:00,2022-03-13 19:00:00,192,10,249,7,0,4290,4748,19800
2022-03-13 19:00:00,2022-03-13 20:00:00,190,13,216,0,0,4351,4770,18913
2022-03-13 20:00:00,2022-03-13 21:00:00,193,2,205,0,0,4189,4589,18105
2022-03-13 21:00:00,2022-03-13 22:00:00,193,0,202,0,0,4025,4420,17272
2022-03-13 22:00:00,2022-03-13 23:00:00,194,0,200,0,0,3842,4236,16537
2022-03-13 23:00:00,2022-03-14 00:00:00,190,0,199,0,0,3500,3889,16139
2022-03-14 00:00:00,2022-03-14 01:00:00,192,0,199,0,0,3277,3668,15981
2022-03-14 01:00:00,2022-03-14 02:00:00,192,0,199,0,0,3219,3610,16117
2022-03-14 02:00:00,2022-03-14 03:00:00,192,0,199,0,0,3208,3599,16715
2022-03-14 03:00:00,2022-03-14 04:00:00,191,0,191,0,0,3183,3565,17759
2022-03-14 04:00:00,2022-03-14 05:00:00,191,0,187,0,107,3127,3612,20364
2022-03-14 05:00:00,2022-03-14 06:00:00,190,16,188,0,734,2537,3665,21952
2022-03-14 06:00:00,2022-03-14 07:00:00,192,2,199,0,1896,1643,3932,22425
2022-03-14 07:00:00,2022-03-14 08:00:00,191,0,204,0,2947,1443,4785,22194
2022-03-14 08:00:00,2022-03-14 09:00:00,192,0,208,0,3724,1672,5796,21698
2022-03-14 09:00:00,2022-03-14 10:00:00,192,0,199,0,4272,1652,6315,21774
2022-03-14 10:00:00,2022-03-14 11:00:00,193,0,199,0,4481,1747,6620,21879
2022-03-14 11:00:00,2022-03-14 12:00:00,190,0,199,0,4260,1906,6555,22192
2022-03-14 12:00:00,2022-03-14 13:00:00,192,0,199,0,3665,2020,6076,22116
2022-03-14 13:00:00,2022-03-14 14:00:00,191,0,199,0,2793,2088,5271,22519
2022-03-14 14:00:00,2022-03-14 15:00:00,193,0,197,0,1634,1976,4000,23124
2022-03-14 15:00:00,2022-03-14 16:00:00,193,210,201,50,536,2078,3268,23415
2022-03-14 16:00:00,2022-03-14 17:00:00,194,723,220,57,21,2599,3814,24240
2022-03-14 17:00:00,2022-03-14 18:00:00,194,565,227,57,0,3020,4063,24353
2022-03-14 18:00:00,2022-03-14 19:00:00,195,246,236,7,0,3326,4010,23764
2022-03-14 19:00:00,2022-03-14 20:00:00,193,20,216,0,0,3552,3981,22273
2022-03-14 20:00:00,2022-03-14 21:00:00,192,0,193,0,0,3303,3688,20675
2022-03-14 21:00:00,2022-03-14 22:00:00,191,0,191,0,0,3005,3387,19452
2022-03-14 22:00:00,2022-03-14 23:00:00,191,0,191,0,0,2608,2990,18526
2022-03-14 23:00:00,2022-03-15 00:00:00,191,0,191,0,0,2460,2842,18084
2022-03-15 00:00:00,2022-03-15 01:00:00,193,0,191,0,0,2192,2576,17829
2022-03-15 01:00:00,2022-03-15 02:00:00,192,0,191,0,0,2023,2406,17886
2022-03-15 02:00:00,2022-03-15 03:00:00,193,0,191,0,0,1870,2254,18344
2022-03-15 03:00:00,2022-03-15 04:00:00,192,0,191,0,0,1734,2117,19073
2022-03-15 04:00:00,2022-03-15 05:00:00,191,0,191,0,100,1639,2121,21009
2022-03-15 05:00:00,2022-03-15 06:00:00,191,0,192,0,595,1401,2379,22497
2022-03-15 06:00:00,2022-03-15 07:00:00,191,0,197,0,1524,875,2787,22947
2022-03-15 07:00:00,2022-03-15 08:00:00,192,0,202,0,2369,386,3149,22773
2022-03-15 08:00:00,2022-03-15 09:00:00,191,0,204,0,3187,228,3810,22603
2022-03-15 09:00:00,2022-03-15 10:00:00,191,0,204,0,3380,214,3989,22645
2022-03-15 10:00:00,2022-03-15 11:00:00,192,0,204,0,3317,246,3959,22626
2022-03-15 11:00:00,2022-03-15 12:00:00,192,257,203,0,3047,239,3938,22970
2022-03-15 12:00:00,2022-03-15 13:00:00,194,194,205,0,2336,181,3110,22916
2022-03-15 13:00:00,2022-03-15 14:00:00,195,0,205,0,1633,110,2143,23187
2022-03-15 14:00:00,2022-03-15 15:00:00,195,158,204,0,977,146,1680,23475
2022-03-15 15:00:00,2022-03-15 16:00:00,194,604,211,50,334,288,1681,23627
2022-03-15 16:00:00,2022-03-15 17:00:00,195,463,246,57,10,495,1466,24305
2022-03-15 17:00:00,2022-03-15 18:00:00,195,450,250,57,0,749,1701,24325
2022-03-15 18:00:00,2022-03-15 19:00:00,195,292,235,57,0,1004,1783,23741
2022-03-15 19:00:00,2022-03-15 20:00:00,194,16,216,7,0,1099,1532,22303
2022-03-15 20:00:00,2022-03-15 21:00:00,191,0,197,0,0,1031,1419,20827
2022-03-15 21:00:00,2022-03-15 22:00:00,193,0,191,0,0,932,1316,19639
2022-03-15 22:00:00,2022-03-15 23:00:00,194,0,200,0,0,980,1374,18672
2022-03-15 23:00:00,2022-03-16 00:00:00,192,0,206,0,0,974,1372,18071
2022-03-16 00:00:00,2022-03-16 01:00:00,194,0,207,0,0,932,1333,17727
2022-03-16 01:00:00,2022-03-16 02:00:00,191,0,207,0,0,926,1324,17771
2022-03-16 02:00:00,2022-03-16 03:00:00,193,0,206,0,0,874,1273,18042
2022-03-16 03:00:00,2022-03-16 04:00:00,191,0,209,0,0,910,1310,18821
2022-03-16 04:00:00,2022-03-16 05:00:00,193,0,212,0,55,985,1445,20935
2022-03-16 05:00:00,2022-03-16 06:00:00,194,51,211,0,258,946,1660,22947
2022-03-16 06:00:00,2022-03-16 07:00:00,196,254,215,0,678,781,2124,23633
2022-03-16 07:00:00,2022-03-16 08:00:00,195,169,235,0,1219,616,2434,23448
2022-03-16 08:00:00,2022-03-16 09:00:00,195,9,223,0,1841,585,2853,22938
2022-03-16 09:00:00,2022-03-16 10:00:00,193,0,221,0,2507,727,3648,23018
2022-03-16 10:00:00,2022-03-16 11:00:00,195,0,223,0,2700,828,3946,22923
2022-03-16 11:00:00,2022-03-16 12:00:00,194,0,224,0,2582,813,3813,22923
2022-03-16 12:00:00,2022-03-16 13:00:00,194,0,222,0,2440,744,3600,22925
2022-03-16 13:00:00,2022-03-16 14:00:00,195,0,226,0,1874,789,3084,23193
2022-03-16 14:00:00,2022-03-16 15:00:00,196,0,228,0,1085,778,2287,23207
2022-03-16 15:00:00,2022-03-16 16:00:00,195,237,237,50,382,794,1895,23430
2022-03-16 16:00:00,2022-03-16 17:00:00,194,915,246,57,20,985,2417,24231
2022-03-16 17:00:00,2022-03-16 18:00:00,194,937,247,57,0,1299,2734,24412
2022-03-16 18:00:00,2022-03-16 19:00:00,195,177,242,57,0,1487,2158,23877
2022-03-16 19:00:00,2022-03-16 20:00:00,194,100,230,7,0,1443,1974,22418
2022-03-16 20:00:00,2022-03-16 21:00:00,193,1,217,0,0,1478,1889,20980
2022-03-16 21:00:00,2022-03-16 22:00:00,193,0,212,0,0,1526,1931,19757
2022-03-16 22:00:00,2022-03-16 23:00:00,196,0,208,0,0,1582,1986,18732
2022-03-16 23:00:00,2022-03-17 00:00:00,202,0,207,0,0,1660,2069,18080
2022-03-17 00:00:00,2022-03-17 01:00:00,212,0,208,0,0,1782,2202,17742
2022-03-17 01:00:00,2022-03-17 02:00:00,232,0,208,0,0,1962,2402,17933
2022-03-17 02:00:00,2022-03-17 03:00:00,240,0,208,0,0,2029,2477,18189
2022-03-17 03:00:00,2022-03-17 04:00:00,241,0,208,0,0,2239,2688,18758
2022-03-17 04:00:00,2022-03-17 05:00:00,241,0,207,0,123,2565,3136,20726
2022-03-17 05:00:00,2022-03-17 06:00:00,241,0,208,0,903,2349,3701,22297
2022-03-17 06:00:00,2022-03-17 07:00:00,243,340,218,0,1855,1739,4395,22636
2022-03-17 07:00:00,2022-03-17 08:00:00,242,238,232,0,2896,1446,5054,22493
2022-03-17 08:00:00,2022-03-17 09:00:00,242,17,231,0,3550,1826,5866,22110
2022-03-17 09:00:00,2022-03-17 10:00:00,242,0,222,0,3873,2247,6584,22379
2022-03-17 10:00:00,2022-03-17 11:00:00,243,0,222,0,3839,2447,6751,22698
2022-03-17 11:00:00,2022-03-17 12:00:00,243,186,222,0,3261,2424,6336,22969
2022-03-17 12:00:00,2022-03-17 13:00:00,243,27,221,0,2461,2459,5411,22807
2022-03-17 13:00:00,2022-03-17 14:00:00,243,81,225,0,1637,2321,4507,23111
2022-03-17 14:00:00,2022-03-17 15:00:00,243,280,226,0,981,2386,4116,23386
2022-03-17 15:00:00,2022-03-17 16:00:00,244,406,235,50,302,2620,3857,23400
2022-03-17 16:00:00,2022-03-17 17:00:00,243,461,236,57,11,3205,4213,24234
2022-03-17 17:00:00,2022-03-17 18:00:00,242,412,260,7,0,3526,4447,24504
2022-03-17 18:00:00,2022-03-17 19:00:00,243,328,248,0,0,3528,4347,23774
2022-03-17 19:00:00,2022-03-17 20:00:00,244,151,212,0,0,3482,4089,22383
2022-03-17 20:00:00,2022-03-17 21:00:00,231,116,203,0,0,3005,3555,20826
2022-03-17 21:00:00,2022-03-17 22:00:00,223,0,198,0,0,2705,3126,19614
2022-03-17 22:00:00,2022-03-17 23:00:00,222,0,190,0,0,2590,3002,18658
2022-03-17 23:00:00,2022-03-18 00:00:00,223,0,181,0,0,2491,2895,18097
2022-03-18 00:00:00,2022-03-18 01:00:00,224,0,171,0,0,2270,2665,17800
2022-03-18 01:00:00,2022-03-18 02:00:00,222,0,161,0,0,2060,2443,17921
2022-03-18 02:00:00,2022-03-18 03:00:00,224,0,152,0,0,1820,2196,18222
2022-03-18 03:00:00,2022-03-18 04:00:00,222,0,150,0,0,1758,2130,18900
2022-03-18 04:00:00,2022-03-18 05:00:00,225,67,151,0,133,1700,2276,20718
2022-03-18 05:00:00,2022-03-18 06:00:00,223,17,150,0,724,1330,2444,22293
2022-03-18 06:00:00,2022-03-18 07:00:00,223,85,167,0,1662,820,2957,22523
2022-03-18 07:00:00,2022-03-18 08:00:00,223,0,182,0,2721,695,3821,22317
2022-03-18 08:00:00,2022-03-18 09:00:00,222,0,161,0,3702,728,4813,21953
2022-03-18 09:00:00,2022-03-18 10:00:00,164,0,148,0,4270,584,5166,22011
2022-03-18 10:00:00,2022-03-18 11:00:00,65,0,158,0,4443,451,5117,22138
2022-03-18 11:00:00,2022-03-18 12:00:00,126,0,171,0,4284,415,4996,22230
2022-03-18 12:00:00,2022-03-18 13:00:00,196,0,181,0,3753,406,4536,22194
2022-03-18 13:00:00,2022-03-18 14:00:00,222,0,192,0,2852,349,3615,22640
2022-03-18 14:00:00,2022-03-18 15:00:00,222,1,206,0,1639,281,2349,22917
2022-03-18 15:00:00,2022-03-18 16:00:00,221,294,223,50,601,455,1844,23151
2022-03-18 16:00:00,2022-03-18 17:00:00,221,828,244,57,38,667,2055,23993
2022-03-18 17:00:00,2022-03-18 18:00:00,223,955,247,57,0,718,2200,24249
2022-03-18 18:00:00,2022-03-18 19:00:00,225,792,246,7,0,669,1939,23542
2022-03-18 19:00:00,2022-03-18 20:00:00,239,425,241,0,0,601,1506,22118
2022-03-18 20:00:00,2022-03-18 21:00:00,227,7,180,0,0,564,978,20623
2022-03-18 21:00:00,2022-03-18 22:00:00,227,0,172,0,0,567,966,19498
2022-03-18 22:00:00,2022-03-18 23:00:00,195,0,162,0,0,578,935,18531
2022-03-18 23:00:00,2022-03-19 00:00:00,181,0,161,0,0,557,899,17902
2022-03-19 00:00:00,2022-03-19 01:00:00,181,0,160,0,0,587,928,17537
2022-03-19 01:00:00,2022-03-19 02:00:00,181,0,161,0,0,728,1070,17613
2022-03-19 02:00:00,2022-03-19 03:00:00,182,0,161,0,0,861,1204,17689
2022-03-19 03:00:00,2022-03-19 04:00:00,182,0,161,0,1,1016,1360,17473
2022-03-19 04:00:00,2022-03-19 05:00:00,181,0,153,0,165,1203,1702,17972
2022-03-19 05:00:00,2022-03-19 06:00:00,188,0,143,0,913,1093,2337,18890
2022-03-19 06:00:00,2022-03-19 07:00:00,182,0,155,0,1860,775,2972,19621
2022-03-19 07:00:00,2022-03-19 08:00:00,182,0,167,0,2760,731,3840,19770
2022-03-19 08:00:00,2022-03-19 09:00:00,182,0,158,0,3557,930,4827,19391
2022-03-19 09:00:00,2022-03-19 10:00:00,182,0,151,0,4258,1083,5674,19375
2022-03-19 10:00:00,2022-03-19 11:00:00,181,0,159,0,4530,1201,6071,19255
2022-03-19 11:00:00,2022-03-19 12:00:00,187,0,168,0,4342,1401,6098,19135
2022-03-19 12:00:00,2022-03-19 13:00:00,192,0,177,0,3757,1759,5885,18936
2022-03-19 13:00:00,2022-03-19 14:00:00,190,0,179,0,2881,2035,5285,19171
2022-03-19 14:00:00,2022-03-19 15:00:00,185,20,188,0,1837,2181,4411,19736
2022-03-19 15:00:00,2022-03-19 16:00:00,185,278,200,50,702,2119,3534,20188
2022-03-19 16:00:00,2022-03-19 17:00:00,180,774,221,57,104,2261,3597,21023
2022-03-19 17:00:00,2022-03-19 18:00:00,179,745,224,57,12,2610,3827,21179
2022-03-19 18:00:00,2022-03-19 19:00:00,184,581,224,57,0,2832,3878,20558
2022-03-19 19:00:00,2022-03-19 20:00:00,196,591,198,7,0,2850,3842,19533
2022-03-19 20:00:00,2022-03-19 21:00:00,189,404,172,0,0,2782,3547,18376
2022-03-19 21:00:00,2022-03-19 22:00:00,189,288,180,0,0,2610,3267,17186
2022-03-19 22:00:00,2022-03-19 23:00:00,188,157,190,0,0,2455,2990,16346
2022-03-19 23:00:00,2022-03-20 00:00:00,188,157,190,0,0,2316,2851,15738
2022-03-20 00:00:00,2022-03-20 01:00:00,188,157,190,0,0,2210,2745,15473
2022-03-20 01:00:00,2022-03-20 02:00:00,190,157,190,0,0,2132,2669,15299
2022-03-20 02:00:00,2022-03-20 03:00:00,190,24,190,0,0,2143,2547,15356
2022-03-20 03:00:00,2022-03-20 04:00:00,189,34,190,0,4,2175,2592,15258
2022-03-20 04:00:00,2022-03-20 05:00:00,190,59,199,0,212,2185,2845,15012
2022-03-20 05:00:00,2022-03-20 06:00:00,194,89,204,0,1027,1887,3401,15339
2022-03-20 06:00:00,2022-03-20 07:00:00,190,0,216,0,2296,1285,3987,15841
2022-03-20 07:00:00,2022-03-20 08:00:00,189,0,224,0,3323,1197,4933,16078
2022-03-20 08:00:00,2022-03-20 09:00:00,188,0,223,0,4063,1784,6258,16172
2022-03-20 09:00:00,2022-03-20 10:00:00,189,0,222,0,4527,2106,7044,16268
2022-03-20 10:00:00,2022-03-20 11:00:00,190,0,215,0,4657,2003,7065,16585
2022-03-20 11:00:00,2022-03-20 12:00:00,190,0,210,0,4441,2046,6887,16732
2022-03-20 12:00:00,2022-03-20 13:00:00,189,0,209,0,3895,2157,6450,16540
2022-03-20 13:00:00,2022-03-20 14:00:00,188,0,208,0,2999,2247,5642,16839
2022-03-20 14:00:00,2022-03-20 15:00:00,183,0,208,0,1891,2233,4515,17606
2022-03-20 15:00:00,2022-03-20 16:00:00,181,34,234,0,723,2064,3236,18166
2022-03-20 16:00:00,2022-03-20 17:00:00,180,507,254,48,57,2338,3384,19425
2022-03-20 17:00:00,2022-03-20 18:00:00,179,637,258,57,0,2816,3947,19823
2022-03-20 18:00:00,2022-03-20 19:00:00,180,208,260,57,0,2954,3659,19438
2022-03-20 19:00:00,2022-03-20 20:00:00,181,172,250,7,0,3100,3710,18581
2022-03-20 20:00:00,2022-03-20 21:00:00,182,93,241,0,0,3046,3562,17973
2022-03-20 21:00:00,2022-03-20 22:00:00,181,0,237,0,0,2762,3180,16850
2022-03-20 22:00:00,2022-03-20 23:00:00,176,0,220,0,0,2670,3066,16286
2022-03-20 23:00:00,2022-03-21 00:00:00,176,0,188,0,0,2515,2879,15975
2022-03-21 00:00:00,2022-03-21 01:00:00,174,0,187,0,0,2228,2589,15882
2022-03-21 01:00:00,2022-03-21 02:00:00,173,0,179,0,0,2051,2403,15993
2022-03-21 02:00:00,2022-03-21 03:00:00,173,0,169,0,0,2033,2375,16513
2022-03-21 03:00:00,2022-03-21 04:00:00,174,0,159,0,5,2097,2435,17454
2022-03-21 04:00:00,2022-03-21 05:00:00,174,29,150,0,177,2142,2672,19819
2022-03-21 05:00:00,2022-03-21 06:00:00,174,138,140,0,1122,1793,3367,21573
2022-03-21 06:00:00,2022-03-21 07:00:00,174,120,127,0,2335,971,3727,22136
2022-03-21 07:00:00,2022-03-21 08:00:00,175,54,127,0,3397,799,4552,21905
2022-03-21 08:00:00,2022-03-21 09:00:00,174,0,128,0,4166,1330,5798,21323
2022-03-21 09:00:00,2022-03-21 10:00:00,173,0,129,0,4612,1525,6439,21430
2022-03-21 10:00:00,2022-03-21 11:00:00,174,0,142,0,4727,1469,6512,21571
2022-03-21 11:00:00,2022-03-21 12:00:00,174,0,152,0,4476,1394,6196,21633
2022-03-21 12:00:00,2022-03-21 13:00:00,174,0,162,0,3893,1267,5496,21560
2022-03-21 13:00:00,2022-03-21 14:00:00,175,0,172,0,3042,1155,4544,21960
2022-03-21 14:00:00,2022-03-21 15:00:00,201,0,195,50,1904,1122,3472,22532
2022-03-21 15:00:00,2022-03-21 16:00:00,216,31,210,57,659,1138,2311,22744
2022-03-21 16:00:00,2022-03-21 17:00:00,213,450,231,57,19,1485,2455,23619
2022-03-21 17:00:00,2022-03-21 18:00:00,214,715,239,57,0,1912,3137,24117
2022-03-21 18:00:00,2022-03-21 19:00:00,208,358,238,57,0,2131,2992,23398
2022-03-21 19:00:00,2022-03-21 20:00:00,187,31,226,7,0,2214,2665,21821
2022-03-21 20:00:00,2022-03-21 21:00:00,185,0,218,0,0,2195,2598,20295
2022-03-21 21:00:00,2022-03-21 22:00:00,219,0,215,0,0,2133,2567,18984
2022-03-21 22:00:00,2022-03-21 23:00:00,183,0,193,0,0,1994,2370,18041
2022-03-21 23:00:00,2022-03-22 00:00:00,171,0,187,0,0,1808,2166,17654
2022-03-22 00:00:00,2022-03-22 01:00:00,172,0,187,0,0,1536,1895,17373
2022-03-22 01:00:00,2022-03-22 02:00:00,173,0,178,0,0,1378,1729,17599
2022-03-22 02:00:00,2022-03-22 03:00:00,173,0,168,0,0,1246,1587,18116
2022-03-22 03:00:00,2022-03-22 04:00:00,172,0,159,0,3,1074,1408,18730
2022-03-22 04:00:00,2022-03-22 05:00:00,172,0,149,0,252,987,1560,20628
2022-03-22 05:00:00,2022-03-22 06:00:00,185,0,139,0,1308,963,2595,22089
2022-03-22 06:00:00,2022-03-22 07:00:00,195,38,144,0,2541,611,3529,22306
2022-03-22 07:00:00,2022-03-22 08:00:00,192,273,164,0,3520,231,4380,22037
2022-03-22 08:00:00,2022-03-22 09:00:00,193,85,147,0,4179,291,4895,21549
2022-03-22 09:00:00,2022-03-22 10:00:00,192,0,145,0,4554,451,5342,21673
2022-03-22 10:00:00,2022-03-22 11:00:00,192,0,155,0,4629,429,5405,21578
2022-03-22 11:00:00,2022-03-22 12:00:00,192,0,157,0,4378,400,5127,21653
2022-03-22 12:00:00,2022-03-22 13:00:00,193,0,160,0,3759,344,4456,21556
2022-03-22 13:00:00,2022-03-22 14:00:00,193,0,162,0,3013,311,3679,22054
2022-03-22 14:00:00,2022-03-22 15:00:00,194,0,166,0,1913,283,2556,22396
2022-03-22 15:00:00,2022-03-22 16:00:00,193,189,180,50,705,327,1644,22617
2022-03-22 16:00:00,2022-03-22 17:00:00,192,901,199,57,66,511,1926,23480
2022-03-22 17:00:00,2022-03-22 18:00:00,192,1025,201,57,0,673,2148,24014
2022-03-22 18:00:00,2022-03-22 19:00:00,192,536,202,57,0,960,1947,23465
2022-03-22 19:00:00,2022-03-22 20:00:00,192,36,196,7,0,1251,1682,21968
2022-03-22 20:00:00,2022-03-22 21:00:00,193,0,176,0,0,1401,1770,20421
2022-03-22 21:00:00,2022-03-22 22:00:00,192,0,170,0,0,1373,1735,19361
2022-03-22 22:00:00,2022-03-22 23:00:00,191,0,165,0,0,1215,1571,18363
2022-03-22 23:00:00,2022-03-23 00:00:00,185,0,164,0,0,939,1288,17857
2022-03-23 00:00:00,2022-03-23 01:00:00,173,0,164,0,0,770,1107,17536
2022-03-23 01:00:00,2022-03-23 02:00:00,173,0,164,0,0,643,980,17853
2022-03-23 02:00:00,2022-03-23 03:00:00,173,0,164,0,0,495,832,18188
2022-03-23 03:00:00,2022-03-23 04:00:00,172,0,164,0,4,398,738,18716
2022-03-23 04:00:00,2022-03-23 05:00:00,173,9,163,0,225,361,931,20589
2022-03-23 05:00:00,2022-03-23 06:00:00,176,16,163,0,1215,297,1867,21935
2022-03-23 06:00:00,2022-03-23 07:00:00,174,0,178,0,2370,158,2880,22072
2022-03-23 07:00:00,2022-03-23 08:00:00,175,0,201,0,3396,48,3820,21830
2022-03-23 08:00:00,2022-03-23 09:00:00,186,0,193,0,4125,64,4568,21363
2022-03-23 09:00:00,2022-03-23 10:00:00,182,0,198,0,4529,174,5083,21485
2022-03-23 10:00:00,2022-03-23 11:00:00,182,0,200,0,4611,370,5363,21590
2022-03-23 11:00:00,2022-03-23 12:00:00,181,0,201,0,4395,553,5330,21532
2022-03-23 12:00:00,2022-03-23 13:00:00,172,0,195,0,3815,771,4953,21478
2022-03-23 13:00:00,2022-03-23 14:00:00,173,0,185,0,3000,978,4336,21943
2022-03-23 14:00:00,2022-03-23 15:00:00,173,58,219,0,1965,1074,3489,22535
2022-03-23 15:00:00,2022-03-23 16:00:00,182,271,251,50,800,1117,2671,22743
2022-03-23 16:00:00,2022-03-23 17:00:00,182,815,255,57,73,1489,2871,23482
2022-03-23 17:00:00,2022-03-23 18:00:00,183,1050,257,57,0,1746,3293,23967
2022-03-23 18:00:00,2022-03-23 19:00:00,182,554,249,57,0,1809,2851,23319
2022-03-23 19:00:00,2022-03-23 20:00:00,175,51,239,7,0,1835,2307,21808
2022-03-23 20:00:00,2022-03-23 21:00:00,171,0,189,0,0,1753,2113,20284
2022-03-23 21:00:00,2022-03-23 22:00:00,172,0,177,0,0,1584,1933,19048
2022-03-23 22:00:00,2022-03-23 23:00:00,172,0,177,0,0,1359,1708,18244
2022-03-23 23:00:00,2022-03-24 00:00:00,171,0,177,0,0,1103,1451,17750
2022-03-24 00:00:00,2022-03-24 01:00:00,170,0,177,0,0,885,1232,17493
2022-03-24 01:00:00,2022-03-24 02:00:00,172,0,177,0,0,785,1134,17647
2022-03-24 02:00:00,2022-03-24 03:00:00,172,0,177,0,0,668,1017,17919
2022-03-24 03:00:00,2022-03-24 04:00:00,173,0,177,50,7,620,1027,18375
2022-03-24 04:00:00,2022-03-24 05:00:00,173,0,177,57,229,644,1280,20308
2022-03-24 05:00:00,2022-03-24 06:00:00,176,0,178,7,1204,535,2100,21700
2022-03-24 06:00:00,2022-03-24 07:00:00,182,0,209,0,2341,295,3027,21783
2022-03-24 07:00:00,2022-03-24 08:00:00,192,0,223,0,3378,258,4051,21538
2022-03-24 08:00:00,2022-03-24 09:00:00,192,0,216,0,4157,393,4958,21164
2022-03-24 09:00:00,2022-03-24 10:00:00,193,0,191,0,4557,577,5518,21276
2022-03-24 10:00:00,2022-03-24 11:00:00,192,0,186,0,4625,773,5776,21366
2022-03-24 11:00:00,2022-03-24 12:00:00,192,0,186,0,4454,845,5677,21661
2022-03-24 12:00:00,2022-03-24 13:00:00,177,0,185,0,3881,834,5077,21528
2022-03-24 13:00:00,2022-03-24 14:00:00,172,0,184,0,3050,840,4246,22074
2022-03-24 14:00:00,2022-03-24 15:00:00,173,0,203,0,1999,745,3120,22700
2022-03-24 15:00:00,2022-03-24 16:00:00,172,187,232,0,848,645,2084,22955
2022-03-24 16:00:00,2022-03-24 17:00:00,171,720,252,50,88,693,1974,23616
2022-03-24 17:00:00,2022-03-24 18:00:00,172,966,256,57,0,818,2269,24210
2022-03-24 18:00:00,2022-03-24 19:00:00,173,606,262,7,0,900,1948,23601
2022-03-24 19:00:00,2022-03-24 20:00:00,173,183,257,0,0,926,1539,21994
2022-03-24 20:00:00,2022-03-24 21:00:00,173,39,212,0,0,912,1336,20544
2022-03-24 21:00:00,2022-03-24 22:00:00,173,120,176,0,0,851,1320,19300
2022-03-24 22:00:00,2022-03-24 23:00:00,172,9,171,0,0,850,1202,18272
2022-03-24 23:00:00,2022-03-25 00:00:00,169,0,170,0,0,873,1212,17718
2022-03-25 00:00:00,2022-03-25 01:00:00,169,0,170,0,0,1033,1372,17506
2022-03-25 01:00:00,2022-03-25 02:00:00,172,0,170,0,0,1092,1434,17499
2022-03-25 02:00:00,2022-03-25 03:00:00,172,0,170,0,0,990,1332,17893
2022-03-25 03:00:00,2022-03-25 04:00:00,172,0,172,50,20,927,1341,18297
2022-03-25 04:00:00,2022-03-25 05:00:00,173,0,175,57,238,921,1564,20066
2022-03-25 05:00:00,2022-03-25 06:00:00,176,0,175,7,1189,735,2282,21400
2022-03-25 06:00:00,2022-03-25 07:00:00,175,0,189,0,2289,442,3095,21677
2022-03-25 07:00:00,2022-03-25 08:00:00,179,0,208,0,3267,328,3982,21353
2022-03-25 08:00:00,2022-03-25 09:00:00,192,0,187,0,3986,598,4963,20753
2022-03-25 09:00:00,2022-03-25 10:00:00,192,0,184,0,4410,850,5636,20887
2022-03-25 10:00:00,2022-03-25 11:00:00,193,0,173,0,4446,1121,5933,20996
2022-03-25 11:00:00,2022-03-25 12:00:00,190,0,172,0,4205,1301,5868,21078
2022-03-25 12:00:00,2022-03-25 13:00:00,173,0,172,0,3647,1300,5292,21103
2022-03-25 13:00:00,2022-03-25 14:00:00,173,0,176,0,2973,1386,4708,21706
2022-03-25 14:00:00,2022-03-25 15:00:00,173,0,212,0,1926,1343,3654,22195
2022-03-25 15:00:00,2022-03-25 16:00:00,173,200,217,50,779,1441,2860,22228
2022-03-25 16:00:00,2022-03-25 17:00:00,173,766,240,58,93,2033,3363,22993
2022-03-25 17:00:00,2022-03-25 18:00:00,173,695,244,58,0,2790,3960,23553
2022-03-25 18:00:00,2022-03-25 19:00:00,173,373,247,7,0,3422,4222,22813
2022-03-25 19:00:00,2022-03-25 20:00:00,151,264,223,0,0,3883,4521,21348
2022-03-25 20:00:00,2022-03-25 21:00:00,143,41,199,0,0,4223,4606,19930
2022-03-25 21:00:00,2022-03-25 22:00:00,144,24,172,0,0,4478,4818,18784
2022-03-25 22:00:00,2022-03-25 23:00:00,143,14,163,0,0,4676,4996,17701
2022-03-25 23:00:00,2022-03-26 00:00:00,143,0,163,0,0,4896,5202,17076
2022-03-26 00:00:00,2022-03-26 01:00:00,142,0,163,0,0,5282,5587,16787
2022-03-26 01:00:00,2022-03-26 02:00:00,143,0,162,0,0,5402,5707,16591
2022-03-26 02:00:00,2022-03-26 03:00:00,142,0,162,0,0,5550,5854,16705
2022-03-26 03:00:00,2022-03-26 04:00:00,142,0,162,0,24,5707,6035,16497
2022-03-26 04:00:00,2022-03-26 05:00:00,142,0,162,0,233,5694,6231,16986
2022-03-26 05:00:00,2022-03-26 06:00:00,147,0,166,0,997,5201,6511,17913
2022-03-26 06:00:00,2022-03-26 07:00:00,148,0,167,0,1996,4658,6969,18866
2022-03-26 07:00:00,2022-03-26 08:00:00,145,0,169,0,2710,4614,7638,19312
2022-03-26 08:00:00,2022-03-26 09:00:00,146,0,167,0,3179,4571,8063,19603
2022-03-26 09:00:00,2022-03-26 10:00:00,146,0,167,0,2954,4490,7757,19518
2022-03-26 10:00:00,2022-03-26 11:00:00,147,0,167,0,2923,4526,7763,19744
2022-03-26 11:00:00,2022-03-26 12:00:00,147,0,167,0,2337,4451,7102,19421
2022-03-26 12:00:00,2022-03-26 13:00:00,147,0,174,0,2084,4227,6632,19382
2022-03-26 13:00:00,2022-03-26 14:00:00,146,33,189,0,1676,4179,6223,19553
2022-03-26 14:00:00,2022-03-26 15:00:00,147,248,201,0,1057,3955,5608,19599
2022-03-26 15:00:00,2022-03-26 16:00:00,147,130,216,50,454,3475,4472,19716
2022-03-26 16:00:00,2022-03-26 17:00:00,147,321,220,57,45,3219,4009,20370
2022-03-26 17:00:00,2022-03-26 18:00:00,146,655,226,58,0,2933,4018,20707
2022-03-26 18:00:00,2022-03-26 19:00:00,146,613,222,58,0,2641,3680,20117
2022-03-26 19:00:00,2022-03-26 20:00:00,145,444,195,7,0,2458,3249,19017
2022-03-26 20:00:00,2022-03-26 21:00:00,146,353,184,0,0,2086,2769,17942
2022-03-26 21:00:00,2022-03-26 22:00:00,149,169,166,0,0,1817,2301,16811
2022-03-26 22:00:00,2022-03-26 23:00:00,147,96,165,0,0,1789,2197,15999
2022-03-26 23:00:00,2022-03-27 00:00:00,147,0,165,0,0,1752,2064,15657
2022-03-27 00:00:00,2022-03-27 01:00:00,145,0,165,0,0,1820,2130,15172
2022-03-27 01:00:00,2022-03-27 02:00:00,146,0,165,0,0,1888,2199,15141
2022-03-27 02:00:00,2022-03-27 03:00:00,144,0,164,0,1,1811,2120,15165
2022-03-27 03:00:00,2022-03-27 04:00:00,145,0,161,0,39,1811,2156,15121
2022-03-27 04:00:00,2022-03-27 05:00:00,149,0,161,0,309,1592,2211,15124
2022-03-27 05:00:00,2022-03-27 06:00:00,147,0,162,0,1313,1286,2908,15499
2022-03-27 06:00:00,2022-03-27 07:00:00,147,0,177,0,2433,911,3668,15875
2022-03-27 07:00:00,2022-03-27 08:00:00,146,0,183,0,3610,773,4712,16186
2022-03-27 08:00:00,2022-03-27 09:00:00,145,0,185,0,4257,757,5344,16259
2022-03-27 09:00:00,2022-03-27 10:00:00,145,0,190,0,4705,837,5877,16470
2022-03-27 10:00:00,2022-03-27 11:00:00,146,0,197,0,4757,952,6052,16600
2022-03-27 11:00:00,2022-03-27 12:00:00,145,0,193,0,4554,1211,6103,16465
2022-03-27 12:00:00,2022-03-27 13:00:00,146,0,193,0,3815,1373,5527,16195
2022-03-27 13:00:00,2022-03-27 14:00:00,147,0,193,50,3033,1603,5026,16660
2022-03-27 14:00:00,2022-03-27 15:00:00,147,407,193,58,1949,1659,4413,17252
2022-03-27 15:00:00,2022-03-27 16:00:00,146,559,216,57,869,1547,3394,17962
2022-03-27 16:00:00,2022-03-27 17:00:00,147,762,231,57,114,1939,3250,19154
2022-03-27 17:00:00,2022-03-27 18:00:00,145,545,231,57,0,2875,3853,19483
2022-03-27 18:00:00,2022-03-27 19:00:00,143,159,225,57,0,3675,4259,18758
2022-03-27 19:00:00,2022-03-27 20:00:00,142,0,203,7,0,4131,4483,17829
2022-03-27 20:00:00,2022-03-27 21:00:00,144,0,191,0,0,4422,4757,16711
2022-03-27 21:00:00,2022-03-27 22:00:00,143,0,165,0,0,4372,4680,15846
2022-03-27 22:00:00,2022-03-27 23:00:00,140,0,165,0,0,4307,4612,15560
2022-03-27 23:00:00,2022-03-28 00:00:00,144,0,165,0,0,4334,4643,15314
2022-03-28 00:00:00,2022-03-28 01:00:00,159,0,165,0,0,4279,4603,15403
2022-03-28 01:00:00,2022-03-28 02:00:00,178,0,165,0,0,4368,4711,15895
2022-03-28 02:00:00,2022-03-28 03:00:00,191,0,166,0,0,4597,4954,16996
2022-03-28 03:00:00,2022-03-28 04:00:00,184,0,171,50,29,4787,5221,19649
2022-03-28 04:00:00,2022-03-28 05:00:00,178,159,184,58,398,4770,5747,21608
2022-03-28 05:00:00,2022-03-28 06:00:00,176,359,211,57,1291,4322,6416,22079
2022-03-28 06:00:00,2022-03-28 07:00:00,174,238,234,7,2404,4110,7167,21741
2022-03-28 07:00:00,2022-03-28 08:00:00,173,0,224,0,3386,4340,8123,21014
2022-03-28 08:00:00,2022-03-28 09:00:00,174,0,218,0,4135,4542,9069,20862
2022-03-28 09:00:00,2022-03-28 10:00:00,173,0,217,0,4695,4647,9732,21093
2022-03-28 10:00:00,2022-03-28 11:00:00,174,0,210,0,4774,4810,9968,20937
2022-03-28 11:00:00,2022-03-28 12:00:00,178,0,205,0,4537,4967,9887,20703
2022-03-28 12:00:00,2022-03-28 13:00:00,179,0,203,0,3984,5181,9547,20883
2022-03-28 13:00:00,2022-03-28 14:00:00,178,0,203,0,3158,5368,8907,21260
2022-03-28 14:00:00,2022-03-28 15:00:00,177,0,203,50,2134,5441,8005,21861
2022-03-28 15:00:00,2022-03-28 16:00:00,174,0,207,58,960,5150,6549,22162
2022-03-28 16:00:00,2022-03-28 17:00:00,172,211,210,58,102,4973,5726,23324
2022-03-28 17:00:00,2022-03-28 18:00:00,174,478,210,58,0,4929,5849,23605
2022-03-28 18:00:00,2022-03-28 19:00:00,174,197,207,58,0,4726,5362,22012
2022-03-28 19:00:00,2022-03-28 20:00:00,173,0,190,57,0,4576,4996,20334
2022-03-28 20:00:00,2022-03-28 21:00:00,173,0,165,57,0,4191,4586,18967
2022-03-28 21:00:00,2022-03-28 22:00:00,173,0,166,7,0,3667,4013,17825
2022-03-28 22:00:00,2022-03-28 23:00:00,171,0,166,0,0,3129,3466,17221
2022-03-28 23:00:00,2022-03-29 00:00:00,172,0,166,0,0,2883,3221,17037
2022-03-29 00:00:00,2022-03-29 01:00:00,174,0,166,0,0,2749,3089,17165
2022-03-29 01:00:00,2022-03-29 02:00:00,173,0,167,0,0,2521,2861,17490
2022-03-29 02:00:00,2022-03-29 03:00:00,174,0,167,0,0,2142,2483,18291
2022-03-29 03:00:00,2022-03-29 04:00:00,174,2,169,50,33,1849,2277,20362
2022-03-29 04:00:00,2022-03-29 05:00:00,176,170,169,58,180,1562,2315,22070
2022-03-29 05:00:00,2022-03-29 06:00:00,175,381,218,58,646,1308,2786,22962
2022-03-29 06:00:00,2022-03-29 07:00:00,173,368,228,7,1286,1259,3321,23092
2022-03-29 07:00:00,2022-03-29 08:00:00,175,19,218,0,1855,1138,3405,22851
2022-03-29 08:00:00,2022-03-29 09:00:00,176,0,213,0,2187,1143,3719,22892
2022-03-29 09:00:00,2022-03-29 10:00:00,175,0,208,0,2370,1152,3905,22938
2022-03-29 10:00:00,2022-03-29 11:00:00,176,0,207,0,2430,1234,4047,22805
2022-03-29 11:00:00,2022-03-29 12:00:00,164,0,207,0,2427,1366,4164,22784
2022-03-29 12:00:00,2022-03-29 13:00:00,145,0,207,0,2281,1529,4162,22902
2022-03-29 13:00:00,2022-03-29 14:00:00,146,0,210,0,1742,1407,3505,22746
2022-03-29 14:00:00,2022-03-29 15:00:00,147,0,233,50,1116,1084,2630,22733
2022-03-29 15:00:00,2022-03-29 16:00:00,147,132,246,58,495,883,1961,22655
2022-03-29 16:00:00,2022-03-29 17:00:00,147,607,250,58,74,849,1985,23592
2022-03-29 17:00:00,2022-03-29 18:00:00,147,647,251,58,0,948,2051,23770
2022-03-29 18:00:00,2022-03-29 19:00:00,147,164,227,58,0,969,1565,22160
2022-03-29 19:00:00,2022-03-29 20:00:00,147,0,194,58,0,1065,1464,20708
2022-03-29 20:00:00,2022-03-29 21:00:00,144,0,183,58,0,1093,1478,19510
2022-03-29 21:00:00,2022-03-29 22:00:00,145,0,181,7,0,1100,1433,18386
2022-03-29 22:00:00,2022-03-29 23:00:00,148,0,182,0,0,1102,1432,17764
2022-03-29 23:00:00,2022-03-30 00:00:00,148,0,182,0,0,961,1291,17396
2022-03-30 00:00:00,2022-03-30 01:00:00,148,0,182,0,0,917,1247,17397
2022-03-30 01:00:00,2022-03-30 02:00:00,147,0,187,0,0,894,1228,17735
2022-03-30 02:00:00,2022-03-30 03:00:00,147,0,191,50,0,987,1375,18493
2022-03-30 03:00:00,2022-03-30 04:00:00,147,0,190,58,26,1092,1513,20624
2022-03-30 04:00:00,2022-03-30 05:00:00,150,103,192,58,209,1190,1902,22291
2022-03-30 05:00:00,2022-03-30 06:00:00,148,185,213,7,854,1234,2641,22803
2022-03-30 06:00:00,2022-03-30 07:00:00,146,185,225,0,1835,1194,3585,22500
2022-03-30 07:00:00,2022-03-30 08:00:00,145,23,214,0,2767,1170,4319,21981
2022-03-30 08:00:00,2022-03-30 09:00:00,145,0,213,0,3240,1203,4801,22417
2022-03-30 09:00:00,2022-03-30 10:00:00,146,0,216,0,3323,1172,4857,22578
2022-03-30 10:00:00,2022-03-30 11:00:00,147,0,215,0,3414,1070,4846,22717
2022-03-30 11:00:00,2022-03-30 12:00:00,145,85,215,0,3204,974,4623,22998
2022-03-30 12:00:00,2022-03-30 13:00:00,145,135,213,0,2460,1088,4041,22933
2022-03-30 13:00:00,2022-03-30 14:00:00,147,34,213,0,1691,1328,3413,22914
2022-03-30 14:00:00,2022-03-30 15:00:00,147,170,212,50,985,1652,3216,22874
2022-03-30 15:00:00,2022-03-30 16:00:00,146,338,214,58,429,1956,3141,22775
2022-03-30 16:00:00,2022-03-30 17:00:00,145,380,214,58,58,2159,3014,23504
2022-03-30 17:00:00,2022-03-30 18:00:00,145,359,239,58,0,2533,3334,23622
2022-03-30 18:00:00,2022-03-30 19:00:00,146,58,241,58,0,2824,3327,22274
2022-03-30 19:00:00,2022-03-30 20:00:00,146,0,218,58,0,2732,3154,20681
2022-03-30 20:00:00,2022-03-30 21:00:00,146,0,193,7,0,2644,2990,19496
2022-03-30 21:00:00,2022-03-30 22:00:00,147,0,190,0,0,2509,2846,18474
2022-03-30 22:00:00,2022-03-30 23:00:00,145,0,189,0,0,2469,2803,18022
2022-03-30 23:00:00,2022-03-31 00:00:00,145,0,189,0,0,2422,2756,17691
2022-03-31 00:00:00,2022-03-31 01:00:00,147,0,189,0,0,2457,2793,17713
2022-03-31 01:00:00,2022-03-31 02:00:00,148,0,189,0,0,2495,2832,17964
2022-03-31 02:00:00,2022-03-31 03:00:00,147,0,188,0,0,2560,2895,18675
2022-03-31 03:00:00,2022-03-31 04:00:00,148,8,187,50,19,2733,3145,20857
2022-03-31 04:00:00,2022-03-31 05:00:00,150,34,191,58,206,2553,3192,22791
2022-03-31 05:00:00,2022-03-31 06:00:00,149,322,219,58,696,2195,3639,23703
2022-03-31 06:00:00,2022-03-31 07:00:00,147,207,238,58,1354,2464,4468,23873
2022-03-31 07:00:00,2022-03-31 08:00:00,146,265,228,7,1872,2825,5343,23589
2022-03-31 08:00:00,2022-03-31 09:00:00,146,382,213,0,2332,2751,5824,23904
2022-03-31 09:00:00,2022-03-31 10:00:00,146,396,210,0,2569,2640,5961,24073
2022-03-31 10:00:00,2022-03-31 11:00:00,146,297,209,0,2551,2767,5970,24107
2022-03-31 11:00:00,2022-03-31 12:00:00,147,49,208,0,2366,3082,5852,23909
2022-03-31 12:00:00,2022-03-31 13:00:00,146,0,208,0,2100,3465,5919,23833
2022-03-31 13:00:00,2022-03-31 14:00:00,147,0,208,0,1495,4045,5895,23562
2022-03-31 14:00:00,2022-03-31 15:00:00,147,13,220,50,966,4444,5840,23497
2022-03-31 15:00:00,2022-03-31 16:00:00,168,6,244,58,435,4518,5429,23420
2022-03-31 16:00:00,2022-03-31 17:00:00,181,286,249,58,62,4381,5217,24036
2022-03-31 17:00:00,2022-03-31 18:00:00,186,382,251,58,0,4507,5384,24094
2022-03-31 18:00:00,2022-03-31 19:00:00,182,165,234,58,0,4816,5455,22634
2022-03-31 19:00:00,2022-03-31 20:00:00,177,0,205,58,0,4717,5157,21022
2022-03-31 20:00:00,2022-03-31 21:00:00,178,0,198,7,0,4629,5012,19619
2022-03-31 21:00:00,2022-03-31 22:00:00,178,0,197,0,0,4644,5019,18478
2022-03-31 22:00:00,2022-03-31 23:00:00,176,0,198,0,0,4721,5095,17926
2022-03-31 23:00:00,2022-04-01 00:00:00,178,0,197,0,0,4717,5092,17659
2022-04-01 00:00:00,2022-04-01 01:00:00,179,0,197,0,0,4764,5140,17782
2022-04-01 01:00:00,2022-04-01 02:00:00,178,0,197,0,0,4836,5211,18078
2022-04-01 02:00:00,2022-04-01 03:00:00,179,0,199,50,0,4865,5293,18884
2022-04-01 03:00:00,2022-04-01 04:00:00,182,0,201,58,23,5010,5474,20911
2022-04-01 04:00:00,2022-04-01 05:00:00,189,0,202,58,192,5069,5710,22872
2022-04-01 05:00:00,2022-04-01 06:00:00,196,71,202,58,642,5163,6332,24122
2022-04-01 06:00:00,2022-04-01 07:00:00,192,345,215,58,1111,5667,7588,24515
2022-04-01 07:00:00,2022-04-01 08:00:00,192,274,224,58,1682,6011,8441,24569
2022-04-01 08:00:00,2022-04-01 09:00:00,193,340,225,58,2210,5967,8993,24882
2022-04-01 09:00:00,2022-04-01 10:00:00,195,255,216,7,2292,5865,8830,24795
2022-04-01 10:00:00,2022-04-01 11:00:00,195,121,211,0,2332,5850,8709,24731
2022-04-01 11:00:00,2022-04-01 12:00:00,193,159,211,0,2167,5883,8613,24266
2022-04-01 12:00:00,2022-04-01 13:00:00,193,309,211,0,1828,5969,8510,24110
2022-04-01 13:00:00,2022-04-01 14:00:00,191,431,211,0,1460,5985,8278,23953
2022-04-01 14:00:00,2022-04-01 15:00:00,191,460,212,0,850,5992,7705,23619
2022-04-01 15:00:00,2022-04-01 16:00:00,185,243,244,50,399,5857,6978,23417
2022-04-01 16:00:00,2022-04-01 17:00:00,182,275,248,58,82,5575,6420,23975
2022-04-01 17:00:00,2022-04-01 18:00:00,183,234,249,58,0,5434,6158,23999
2022-04-01 18:00:00,2022-04-01 19:00:00,184,27,250,58,0,5217,5736,22363
2022-04-01 19:00:00,2022-04-01 20:00:00,175,0,206,58,0,5058,5497,20854
2022-04-01 20:00:00,2022-04-01 21:00:00,174,0,195,7,0,4854,5230,19574
2022-04-01 21:00:00,2022-04-01 22:00:00,174,0,175,0,0,4759,5108,18506
2022-04-01 22:00:00,2022-04-01 23:00:00,174,0,173,0,0,4725,5072,17975
2022-04-01 23:00:00,2022-04-02 00:00:00,174,0,173,0,0,4584,4931,17461
2022-04-02 00:00:00,2022-04-02 01:00:00,174,0,173,0,0,4580,4927,17426
2022-04-02 01:00:00,2022-04-02 02:00:00,173,0,173,0,0,4584,4930,17439
2022-04-02 02:00:00,2022-04-02 03:00:00,172,0,173,50,0,4633,5028,17429
2022-04-02 03:00:00,2022-04-02 04:00:00,173,0,172,58,28,4769,5200,17845
2022-04-02 04:00:00,2022-04-02 05:00:00,175,0,178,58,194,4715,5320,19011
2022-04-02 05:00:00,2022-04-02 06:00:00,174,115,178,58,670,5132,6327,20514
2022-04-02 06:00:00,2022-04-02 07:00:00,173,439,182,58,1349,5601,7802,21579
2022-04-02 07:00:00,2022-04-02 08:00:00,173,157,197,7,2066,5724,8324,22121
2022-04-02 08:00:00,2022-04-02 09:00:00,173,60,199,0,2572,5761,8765,22340
2022-04-02 09:00:00,2022-04-02 10:00:00,173,12,199,0,2910,5696,8990,22288
2022-04-02 10:00:00,2022-04-02 11:00:00,173,11,199,0,3040,5662,9085,21908
2022-04-02 11:00:00,2022-04-02 12:00:00,174,0,198,0,2873,5632,8877,21284
2022-04-02 12:00:00,2022-04-02 13:00:00,174,0,199,0,2494,5534,8401,20934
2022-04-02 13:00:00,2022-04-02 14:00:00,167,0,199,0,1838,5594,7798,20615
2022-04-02 14:00:00,2022-04-02 15:00:00,161,1,205,50,1316,5522,7255,20623
2022-04-02 15:00:00,2022-04-02 16:00:00,163,11,250,58,646,5245,6373,20559
2022-04-02 16:00:00,2022-04-02 17:00:00,170,519,255,58,146,4708,5856,21095
2022-04-02 17:00:00,2022-04-02 18:00:00,173,1089,254,58,1,4373,5948,21234
2022-04-02 18:00:00,2022-04-02 19:00:00,173,598,253,58,0,4032,5114,20159
2022-04-02 19:00:00,2022-04-02 20:00:00,173,143,196,58,0,3815,4385,19102
2022-04-02 20:00:00,2022-04-02 21:00:00,173,0,177,58,0,3484,3892,17871
2022-04-02 21:00:00,2022-04-02 22:00:00,173,0,183,7,0,3216,3579,16749
2022-04-02 22:00:00,2022-04-02 23:00:00,174,0,184,0,0,2955,3313,16166
2022-04-02 23:00:00,2022-04-03 00:00:00,174,0,184,0,0,2637,2995,15646
2022-04-03 00:00:00,2022-04-03 01:00:00,174,0,184,0,0,2514,2872,15562
2022-04-03 01:00:00,2022-04-03 02:00:00,174,0,184,0,0,2473,2831,15630
2022-04-03 02:00:00,2022-04-03 03:00:00,173,0,185,0,0,2396,2754,15636
2022-04-03 03:00:00,2022-04-03 04:00:00,173,0,185,50,56,2171,2635,15542
2022-04-03 04:00:00,2022-04-03 05:00:00,173,65,185,58,331,1810,2622,16231
2022-04-03 05:00:00,2022-04-03 06:00:00,172,492,198,58,1069,1364,3353,17229
2022-04-03 06:00:00,2022-04-03 07:00:00,172,111,218,58,2008,1534,4101,18164
2022-04-03 07:00:00,2022-04-03 08:00:00,173,149,207,58,2731,1904,5222,18775
2022-04-03 08:00:00,2022-04-03 09:00:00,173,60,202,7,3370,2065,5877,19274
2022-04-03 09:00:00,2022-04-03 10:00:00,173,7,194,0,3383,1954,5711,19066
2022-04-03 10:00:00,2022-04-03 11:00:00,174,0,206,0,3547,2027,5954,19245
2022-04-03 11:00:00,2022-04-03 12:00:00,172,0,211,0,3193,2023,5599,18831
2022-04-03 12:00:00,2022-04-03 13:00:00,173,0,211,0,2806,2203,5393,18415
2022-04-03 13:00:00,2022-04-03 14:00:00,173,0,216,0,2205,2435,5029,18303
2022-04-03 14:00:00,2022-04-03 15:00:00,173,0,216,50,1388,2347,4174,18465
2022-04-03 15:00:00,2022-04-03 16:00:00,173,30,251,58,776,1834,3122,19048
2022-04-03 16:00:00,2022-04-03 17:00:00,173,800,256,58,162,1590,3039,19949
2022-04-03 17:00:00,2022-04-03 18:00:00,174,1283,252,58,1,1929,3697,20288
2022-04-03 18:00:00,2022-04-03 19:00:00,174,690,246,58,0,2511,3679,19404
2022-04-03 19:00:00,2022-04-03 20:00:00,179,166,224,58,0,3286,3913,18527
2022-04-03 20:00:00,2022-04-03 21:00:00,227,0,198,58,0,3946,4429,17458
2022-04-03 21:00:00,2022-04-03 22:00:00,251,0,191,7,0,4123,4572,16595
2022-04-03 22:00:00,2022-04-03 23:00:00,249,0,190,0,0,4293,4732,16285
2022-04-03 23:00:00,2022-04-04 00:00:00,248,0,190,0,0,4391,4829,16120
2022-04-04 00:00:00,2022-04-04 01:00:00,250,0,190,0,0,4569,5009,16145
2022-04-04 01:00:00,2022-04-04 02:00:00,250,0,189,0,0,4801,5240,16592
2022-04-04 02:00:00,2022-04-04 03:00:00,249,0,189,50,0,4877,5365,17732
2022-04-04 03:00:00,2022-04-04 04:00:00,252,119,189,58,41,4994,5653,20379
2022-04-04 04:00:00,2022-04-04 05:00:00,259,507,189,58,328,5110,6451,22529
2022-04-04 05:00:00,2022-04-04 06:00:00,271,366,197,58,1134,5244,7270,23373
2022-04-04 06:00:00,2022-04-04 07:00:00,273,43,215,58,2406,5674,8669,23623
2022-04-04 07:00:00,2022-04-04 08:00:00,268,0,214,7,3505,6145,10139,23336
2022-04-04 08:00:00,2022-04-04 09:00:00,275,0,198,0,3811,6476,10760,23372
2022-04-04 09:00:00,2022-04-04 10:00:00,274,205,192,0,3920,6691,11282,23436
2022-04-04 10:00:00,2022-04-04 11:00:00,273,287,190,0,3679,6863,11292,23347
2022-04-04 11:00:00,2022-04-04 12:00:00,274,229,188,0,3319,6894,10904,23020
2022-04-04 12:00:00,2022-04-04 13:00:00,273,153,202,0,3020,7005,10653,23289
2022-04-04 13:00:00,2022-04-04 14:00:00,273,250,207,5,2143,7030,9908,23189
2022-04-04 14:00:00,2022-04-04 15:00:00,272,214,207,50,1457,6994,9194,23299
2022-04-04 15:00:00,2022-04-04 16:00:00,271,325,240,58,647,6884,8425,23288
2022-04-04 16:00:00,2022-04-04 17:00:00,263,602,253,58,89,6976,8241,24131
2022-04-04 17:00:00,2022-04-04 18:00:00,264,756,251,58,0,7071,8400,24289
2022-04-04 18:00:00,2022-04-04 19:00:00,263,293,244,58,0,7123,7981,22648
2022-04-04 19:00:00,2022-04-04 20:00:00,260,23,193,58,0,7123,7657,21007
2022-04-04 20:00:00,2022-04-04 21:00:00,260,0,182,58,0,7150,7650,19545
2022-04-04 21:00:00,2022-04-04 22:00:00,261,0,187,7,0,7185,7640,18497
2022-04-04 22:00:00,2022-04-04 23:00:00,261,0,187,0,0,7126,7574,18015
2022-04-04 23:00:00,2022-04-05 00:00:00,256,0,187,0,0,7067,7510,17723
2022-04-05 00:00:00,2022-04-05 01:00:00,257,0,187,0,0,7042,7486,17768
2022-04-05 01:00:00,2022-04-05 02:00:00,259,0,187,0,0,6969,7415,18153
2022-04-05 02:00:00,2022-04-05 03:00:00,261,0,186,0,0,6928,7375,18992
2022-04-05 03:00:00,2022-04-05 04:00:00,262,34,188,50,27,6901,7462,21156
2022-04-05 04:00:00,2022-04-05 05:00:00,266,108,188,58,170,6752,7542,23151
2022-04-05 05:00:00,2022-04-05 06:00:00,274,355,209,7,612,6539,7996,24134
2022-04-05 06:00:00,2022-04-05 07:00:00,274,430,222,0,1182,6329,8437,24399
2022-04-05 07:00:00,2022-04-05 08:00:00,273,189,210,0,1655,6146,8473,24050
2022-04-05 08:00:00,2022-04-05 09:00:00,272,23,204,0,2192,5953,8644,24212
2022-04-05 09:00:00,2022-04-05 10:00:00,273,97,195,0,2519,5898,8982,24103
2022-04-05 10:00:00,2022-04-05 11:00:00,263,131,193,0,2988,5870,9445,24240
2022-04-05 11:00:00,2022-04-05 12:00:00,264,82,193,0,2639,5807,8985,23702
2022-04-05 12:00:00,2022-04-05 13:00:00,264,0,193,0,2501,5579,8537,23838
2022-04-05 13:00:00,2022-04-05 14:00:00,263,0,198,0,1780,5060,7301,23487
2022-04-05 14:00:00,2022-04-05 15:00:00,263,17,220,0,1254,4208,5962,23419
2022-04-05 15:00:00,2022-04-05 16:00:00,265,305,235,50,695,3090,4640,23314
2022-04-05 16:00:00,2022-04-05 17:00:00,265,764,262,58,126,2363,3838,24004
2022-04-05 17:00:00,2022-04-05 18:00:00,265,929,262,58,0,1992,3506,24224
2022-04-05 18:00:00,2022-04-05 19:00:00,267,322,249,58,0,2489,3385,22760
2022-04-05 19:00:00,2022-04-05 20:00:00,271,63,211,58,0,2886,3489,21134
2022-04-05 20:00:00,2022-04-05 21:00:00,270,9,189,58,0,3109,3635,19690
2022-04-05 21:00:00,2022-04-05 22:00:00,261,0,195,7,0,3116,3579,18508
2022-04-05 22:00:00,2022-04-05 23:00:00,259,0,205,0,0,3031,3495,17922
2022-04-05 23:00:00,2022-04-06 00:00:00,259,0,206,0,0,2821,3286,17652
2022-04-06 00:00:00,2022-04-06 01:00:00,258,0,207,0,0,2542,3007,17686
2022-04-06 01:00:00,2022-04-06 02:00:00,254,0,206,0,0,2404,2864,18111
2022-04-06 02:00:00,2022-04-06 03:00:00,253,0,206,0,0,2126,2585,18860
2022-04-06 03:00:00,2022-04-06 04:00:00,249,93,206,50,21,2065,2684,20946
2022-04-06 04:00:00,2022-04-06 05:00:00,188,501,206,58,215,2043,3211,22956
2022-04-06 05:00:00,2022-04-06 06:00:00,191,832,221,58,592,2127,4021,23900
2022-04-06 06:00:00,2022-04-06 07:00:00,198,633,228,7,997,2353,4416,24067
2022-04-06 07:00:00,2022-04-06 08:00:00,247,357,259,0,1486,2516,4865,23814
2022-04-06 08:00:00,2022-04-06 09:00:00,275,279,240,0,1660,3064,5518,24177
2022-04-06 09:00:00,2022-04-06 10:00:00,276,287,231,0,1864,3675,6333,24184
2022-04-06 10:00:00,2022-04-06 11:00:00,275,212,232,0,1811,3998,6528,23971
2022-04-06 11:00:00,2022-04-06 12:00:00,275,0,246,0,1640,4177,6338,23507
2022-04-06 12:00:00,2022-04-06 13:00:00,272,0,251,0,1633,4437,6593,23481
2022-04-06 13:00:00,2022-04-06 14:00:00,269,0,252,0,1382,4493,6396,22862
2022-04-06 14:00:00,2022-04-06 15:00:00,257,0,253,0,1045,4552,6107,23140
2022-04-06 15:00:00,2022-04-06 16:00:00,255,391,254,50,529,4305,5784,23107
2022-04-06 16:00:00,2022-04-06 17:00:00,257,770,266,58,114,4259,5724,23725
2022-04-06 17:00:00,2022-04-06 18:00:00,257,693,269,58,1,4607,5885,24058
2022-04-06 18:00:00,2022-04-06 19:00:00,256,452,268,58,0,4875,5909,22589
2022-04-06 19:00:00,2022-04-06 20:00:00,255,174,258,7,0,4962,5656,20865
2022-04-06 20:00:00,2022-04-06 21:00:00,255,0,258,0,0,4926,5439,19404
2022-04-06 21:00:00,2022-04-06 22:00:00,253,0,256,0,0,4950,5459,18298
2022-04-06 22:00:00,2022-04-06 23:00:00,250,0,256,0,0,4999,5505,17600
2022-04-06 23:00:00,2022-04-07 00:00:00,249,0,256,0,0,5093,5598,17384
2022-04-07 00:00:00,2022-04-07 01:00:00,247,0,256,0,0,5115,5618,17435
2022-04-07 01:00:00,2022-04-07 02:00:00,254,0,256,0,0,5195,5705,17730
2022-04-07 02:00:00,2022-04-07 03:00:00,254,0,256,0,0,5218,5728,18267
2022-04-07 03:00:00,2022-04-07 04:00:00,256,39,264,50,73,5253,5935,20338
2022-04-07 04:00:00,2022-04-07 05:00:00,237,190,275,58,524,5128,6412,22164
2022-04-07 05:00:00,2022-04-07 06:00:00,255,325,284,58,1240,4743,6905,22524
2022-04-07 06:00:00,2022-04-07 07:00:00,254,142,285,7,2348,4785,7821,22288
2022-04-07 07:00:00,2022-04-07 08:00:00,254,0,282,0,3003,5353,8892,21680
2022-04-07 08:00:00,2022-04-07 09:00:00,250,0,285,0,3154,5957,9646,21660
2022-04-07 09:00:00,2022-04-07 10:00:00,245,0,283,0,3492,6290,10310,22093
2022-04-07 10:00:00,2022-04-07 11:00:00,244,0,272,0,3173,6608,10297,21905
2022-04-07 11:00:00,2022-04-07 12:00:00,243,0,262,0,3050,6728,10283,21793
2022-04-07 12:00:00,2022-04-07 13:00:00,243,53,256,0,2629,6818,9999,21828
2022-04-07 13:00:00,2022-04-07 14:00:00,244,396,256,0,1997,6795,9688,22075
2022-04-07 14:00:00,2022-04-07 15:00:00,243,588,257,0,1331,6608,9027,22448
2022-04-07 15:00:00,2022-04-07 16:00:00,252,689,284,38,451,6315,8029,22326
2022-04-07 16:00:00,2022-04-07 17:00:00,253,932,288,43,106,5919,7541,23109
2022-04-07 17:00:00,2022-04-07 18:00:00,255,930,293,43,7,5855,7383,23529
2022-04-07 18:00:00,2022-04-07 19:00:00,250,274,283,5,0,6222,7034,22190
2022-04-07 19:00:00,2022-04-07 20:00:00,226,19,254,0,0,6331,6830,20443
2022-04-07 20:00:00,2022-04-07 21:00:00,215,0,247,0,0,6451,6913,19204
2022-04-07 21:00:00,2022-04-07 22:00:00,213,0,226,0,0,6471,6910,18011
2022-04-07 22:00:00,2022-04-07 23:00:00,212,0,222,0,0,6645,7079,17501
2022-04-07 23:00:00,2022-04-08 00:00:00,213,0,222,0,0,6643,7078,17254
2022-04-08 00:00:00,2022-04-08 01:00:00,209,0,222,0,0,6608,7039,17236
2022-04-08 01:00:00,2022-04-08 02:00:00,212,0,222,0,0,6762,7196,17576
2022-04-08 02:00:00,2022-04-08 03:00:00,215,0,222,0,6,6827,7270,18135
2022-04-08 03:00:00,2022-04-08 04:00:00,217,53,224,0,67,6867,7428,20172
2022-04-08 04:00:00,2022-04-08 05:00:00,216,61,242,0,407,6828,7754,22078
2022-04-08 05:00:00,2022-04-08 06:00:00,218,104,252,0,1039,6836,8449,22650
2022-04-08 06:00:00,2022-04-08 07:00:00,216,78,257,0,1826,6869,9246,22886
2022-04-08 07:00:00,2022-04-08 08:00:00,217,11,271,0,2557,6894,9950,23043
2022-04-08 08:00:00,2022-04-08 09:00:00,218,0,273,0,2730,6718,9939,22857
2022-04-08 09:00:00,2022-04-08 10:00:00,216,0,267,0,3407,6856,10746,23234
2022-04-08 10:00:00,2022-04-08 11:00:00,215,0,265,0,3504,6707,10691,22532
2022-04-08 11:00:00,2022-04-08 12:00:00,218,2,257,0,3494,6498,10469,22112
2022-04-08 12:00:00,2022-04-08 13:00:00,217,13,253,0,2918,6063,9464,22018
2022-04-08 13:00:00,2022-04-08 14:00:00,217,14,270,0,2152,5519,8172,22250
2022-04-08 14:00:00,2022-04-08 15:00:00,216,44,272,0,1333,4850,6715,22566
2022-04-08 15:00:00,2022-04-08 16:00:00,216,338,272,50,493,4104,5473,22434
2022-04-08 16:00:00,2022-04-08 17:00:00,216,574,272,58,99,3547,4766,23191
2022-04-08 17:00:00,2022-04-08 18:00:00,217,727,289,58,8,3220,4519,23519
2022-04-08 18:00:00,2022-04-08 19:00:00,215,613,284,58,0,3003,4173,21981
2022-04-08 19:00:00,2022-04-08 20:00:00,217,476,257,58,0,2670,3678,20465
2022-04-08 20:00:00,2022-04-08 21:00:00,218,354,235,58,0,2456,3321,19214
2022-04-08 21:00:00,2022-04-08 22:00:00,216,176,222,7,0,2391,3012,18175
2022-04-08 22:00:00,2022-04-08 23:00:00,214,157,222,0,0,2262,2855,17511
2022-04-08 23:00:00,2022-04-09 00:00:00,215,157,222,0,0,2236,2830,16892
2022-04-09 00:00:00,2022-04-09 01:00:00,213,157,222,0,0,2467,3059,16819
2022-04-09 01:00:00,2022-04-09 02:00:00,215,157,221,0,0,2616,3209,16857
2022-04-09 02:00:00,2022-04-09 03:00:00,216,121,225,0,8,2853,3423,16848
2022-04-09 03:00:00,2022-04-09 04:00:00,218,73,249,0,62,3304,3906,17423
2022-04-09 04:00:00,2022-04-09 05:00:00,217,126,251,50,323,3436,4403,18663
2022-04-09 05:00:00,2022-04-09 06:00:00,217,97,276,58,853,3699,5200,19920
2022-04-09 06:00:00,2022-04-09 07:00:00,217,92,299,58,1572,4623,6861,20751
2022-04-09 07:00:00,2022-04-09 08:00:00,216,39,295,58,2022,5512,8142,20803
2022-04-09 08:00:00,2022-04-09 09:00:00,215,60,292,7,2441,5855,8870,20726
2022-04-09 09:00:00,2022-04-09 10:00:00,215,50,268,0,2626,6044,9203,20474
2022-04-09 10:00:00,2022-04-09 11:00:00,213,31,267,0,2578,6004,9093,20055
2022-04-09 11:00:00,2022-04-09 12:00:00,215,31,268,0,2645,5853,9012,19602
2022-04-09 12:00:00,2022-04-09 13:00:00,214,31,267,0,2544,5575,8631,19216
2022-04-09 13:00:00,2022-04-09 14:00:00,214,31,269,0,1993,5306,7813,19034
2022-04-09 14:00:00,2022-04-09 15:00:00,215,83,276,50,1553,4974,7151,19324
2022-04-09 15:00:00,2022-04-09 16:00:00,213,278,291,58,820,4754,6414,19785
2022-04-09 16:00:00,2022-04-09 17:00:00,213,545,307,58,190,4511,5824,20280
2022-04-09 17:00:00,2022-04-09 18:00:00,213,837,305,58,8,4511,5932,20757
2022-04-09 18:00:00,2022-04-09 19:00:00,213,712,297,58,0,4869,6149,19736
2022-04-09 19:00:00,2022-04-09 20:00:00,214,455,289,58,0,5031,6047,18605
2022-04-09 20:00:00,2022-04-09 21:00:00,214,96,288,7,0,5277,5882,17385
2022-04-09 21:00:00,2022-04-09 22:00:00,209,73,257,0,0,5489,6028,16303
2022-04-09 22:00:00,2022-04-09 23:00:00,213,63,241,0,0,5548,6065,15616
2022-04-09 23:00:00,2022-04-10 00:00:00,214,62,241,0,0,5530,6047,15342
2022-04-10 00:00:00,2022-04-10 01:00:00,212,62,241,0,0,5371,5886,15172
2022-04-10 01:00:00,2022-04-10 02:00:00,213,62,241,0,0,5277,5793,15131
2022-04-10 02:00:00,2022-04-10 03:00:00,215,62,241,0,9,5109,5636,15121
2022-04-10 03:00:00,2022-04-10 04:00:00,217,79,254,0,99,5094,5743,15155
2022-04-10 04:00:00,2022-04-10 05:00:00,218,66,266,50,511,4928,6039,15737
2022-04-10 05:00:00,2022-04-10 06:00:00,216,125,284,58,1295,5029,7007,16709
2022-04-10 06:00:00,2022-04-10 07:00:00,217,124,282,7,1847,5056,7533,17315
2022-04-10 07:00:00,2022-04-10 08:00:00,218,69,277,0,2352,5234,8150,18160
2022-04-10 08:00:00,2022-04-10 09:00:00,216,62,258,0,2328,5230,8094,18225
2022-04-10 09:00:00,2022-04-10 10:00:00,217,92,252,0,2508,5020,8089,18258
2022-04-10 10:00:00,2022-04-10 11:00:00,217,87,252,0,2758,4745,8059,18300
2022-04-10 11:00:00,2022-04-10 12:00:00,217,62,252,0,2490,4826,7847,17566
2022-04-10 12:00:00,2022-04-10 13:00:00,216,62,252,0,2721,4590,7841,17593
2022-04-10 13:00:00,2022-04-10 14:00:00,215,62,255,0,2193,4517,7242,17525
2022-04-10 14:00:00,2022-04-10 15:00:00,214,62,264,0,1481,3984,6005,17902
2022-04-10 15:00:00,2022-04-10 16:00:00,217,124,289,50,759,3302,4741,18516
2022-04-10 16:00:00,2022-04-10 17:00:00,214,663,292,58,189,2835,4251,19341
2022-04-10 17:00:00,2022-04-10 18:00:00,218,1040,310,58,9,2682,4317,20045
2022-04-10 18:00:00,2022-04-10 19:00:00,217,655,313,58,0,2855,4098,19408
2022-04-10 19:00:00,2022-04-10 20:00:00,217,124,251,58,0,3054,3704,18663
2022-04-10 20:00:00,2022-04-10 21:00:00,217,80,241,57,0,3140,3735,17530
2022-04-10 21:00:00,2022-04-10 22:00:00,218,64,232,57,0,3143,3714,16562
2022-04-10 22:00:00,2022-04-10 23:00:00,223,62,231,57,0,3306,3879,16124
2022-04-10 23:00:00,2022-04-11 00:00:00,241,62,231,7,0,3128,3669,15950
2022-04-11 00:00:00,2022-04-11 01:00:00,247,62,232,0,0,2847,3388,15990
2022-04-11 01:00:00,2022-04-11 02:00:00,248,62,231,0,0,2496,3037,16406
2022-04-11 02:00:00,2022-04-11 03:00:00,246,62,231,0,13,2315,2867,17468
2022-04-11 03:00:00,2022-04-11 04:00:00,219,62,240,0,111,2052,2684,20146
2022-04-11 04:00:00,2022-04-11 05:00:00,248,179,255,50,626,1597,2955,22254
2022-04-11 05:00:00,2022-04-11 06:00:00,245,352,281,58,1519,1259,3714,23184
2022-04-11 06:00:00,2022-04-11 07:00:00,246,190,282,58,2387,1364,4527,23129
2022-04-11 07:00:00,2022-04-11 08:00:00,246,115,283,7,2784,1619,5054,22922
2022-04-11 08:00:00,2022-04-11 09:00:00,243,69,280,0,3003,1909,5504,23370
2022-04-11 09:00:00,2022-04-11 10:00:00,246,99,275,0,3124,1942,5686,23416
2022-04-11 10:00:00,2022-04-11 11:00:00,246,67,276,0,2824,1966,5379,22903
2022-04-11 11:00:00,2022-04-11 12:00:00,247,62,269,0,2890,2011,5479,22608
2022-04-11 12:00:00,2022-04-11 13:00:00,245,62,262,0,2933,1809,5311,22858
2022-04-11 13:00:00,2022-04-11 14:00:00,246,62,264,50,2085,1713,4420,22628
2022-04-11 14:00:00,2022-04-11 15:00:00,245,73,268,58,1554,1350,3548,22940
2022-04-11 15:00:00,2022-04-11 16:00:00,245,182,309,58,821,878,2493,23026
2022-04-11 16:00:00,2022-04-11 17:00:00,246,838,313,58,190,493,2138,23568
2022-04-11 17:00:00,2022-04-11 18:00:00,248,911,314,58,9,444,1984,24183
2022-04-11 18:00:00,2022-04-11 19:00:00,247,774,320,58,0,436,1835,22849
2022-04-11 19:00:00,2022-04-11 20:00:00,245,334,294,58,0,459,1390,21225
2022-04-11 20:00:00,2022-04-11 21:00:00,243,64,248,7,0,438,1000,19828
2022-04-11 21:00:00,2022-04-11 22:00:00,219,31,234,0,0,427,911,18869
2022-04-11 22:00:00,2022-04-11 23:00:00,212,31,232,0,0,420,895,18243
2022-04-11 23:00:00,2022-04-12 00:00:00,212,31,232,0,0,400,875,17845
2022-04-12 00:00:00,2022-04-12 01:00:00,212,31,232,0,0,357,832,18026
2022-04-12 01:00:00,2022-04-12 02:00:00,213,31,232,0,0,353,829,18365
2022-04-12 02:00:00,2022-04-12 03:00:00,212,31,232,0,9,330,814,18952
2022-04-12 03:00:00,2022-04-12 04:00:00,212,83,232,50,137,284,998,20944
2022-04-12 04:00:00,2022-04-12 05:00:00,212,343,233,58,929,235,2010,22641
2022-04-12 05:00:00,2022-04-12 06:00:00,212,72,257,58,2216,157,2972,23049
2022-04-12 06:00:00,2022-04-12 07:00:00,212,31,277,58,3388,90,4056,22540
2022-04-12 07:00:00,2022-04-12 08:00:00,214,31,259,7,4351,111,4973,22078
2022-04-12 08:00:00,2022-04-12 09:00:00,208,31,262,0,4910,125,5536,22364
2022-04-12 09:00:00,2022-04-12 10:00:00,208,31,256,0,5161,124,5780,22231
2022-04-12 10:00:00,2022-04-12 11:00:00,205,31,253,0,5202,131,5822,21905
2022-04-12 11:00:00,2022-04-12 12:00:00,213,31,253,0,5139,174,5810,21520
2022-04-12 12:00:00,2022-04-12 13:00:00,217,31,253,0,4562,254,5317,21629
2022-04-12 13:00:00,2022-04-12 14:00:00,217,31,263,50,3585,351,4497,21819
2022-04-12 14:00:00,2022-04-12 15:00:00,213,31,288,58,2365,428,3383,22292
2022-04-12 15:00:00,2022-04-12 16:00:00,214,292,318,58,1207,538,2627,22692
2022-04-12 16:00:00,2022-04-12 17:00:00,213,669,320,58,236,886,2382,23222
2022-04-12 17:00:00,2022-04-12 18:00:00,214,649,319,58,12,1595,2847,23877
2022-04-12 18:00:00,2022-04-12 19:00:00,214,146,314,58,0,2115,2847,22525
2022-04-12 19:00:00,2022-04-12 20:00:00,190,40,278,58,0,2495,3061,20902
2022-04-12 20:00:00,2022-04-12 21:00:00,181,31,263,7,0,2696,3178,19537
2022-04-12 21:00:00,2022-04-12 22:00:00,151,31,235,0,0,3019,3436,18471
2022-04-12 22:00:00,2022-04-12 23:00:00,139,31,230,0,0,2897,3297,17758
2022-04-12 23:00:00,2022-04-13 00:00:00,139,31,229,0,0,2831,3230,17481
2022-04-13 00:00:00,2022-04-13 01:00:00,139,31,229,0,0,2757,3156,17492
2022-04-13 01:00:00,2022-04-13 02:00:00,138,31,229,0,0,2886,3284,17903
2022-04-13 02:00:00,2022-04-13 03:00:00,138,31,229,0,12,2813,3223,18482
2022-04-13 03:00:00,2022-04-13 04:00:00,139,31,229,50,172,2820,3441,20538
2022-04-13 04:00:00,2022-04-13 05:00:00,139,133,229,58,1043,2533,4135,22281
2022-04-13 05:00:00,2022-04-13 06:00:00,139,316,237,58,2323,1614,4687,22607
2022-04-13 06:00:00,2022-04-13 07:00:00,139,239,267,7,3455,1174,5281,22315
2022-04-13 07:00:00,2022-04-13 08:00:00,137,31,272,0,4345,1504,6289,21689
2022-04-13 08:00:00,2022-04-13 09:00:00,89,31,272,0,4894,1887,7173,21750
2022-04-13 09:00:00,2022-04-13 10:00:00,27,31,242,0,5117,1886,7303,21745
2022-04-13 10:00:00,2022-04-13 11:00:00,27,31,242,0,4859,1771,6930,21520
2022-04-13 11:00:00,2022-04-13 12:00:00,117,4,245,0,4465,1531,6362,21348
2022-04-13 12:00:00,2022-04-13 13:00:00,141,0,245,0,3792,1323,5501,21646
2022-04-13 13:00:00,2022-04-13 14:00:00,140,0,255,0,2795,1246,4436,21828
2022-04-13 14:00:00,2022-04-13 15:00:00,139,90,275,50,1810,1198,3562,22137
2022-04-13 15:00:00,2022-04-13 16:00:00,179,777,286,58,952,1243,3495,22326
2022-04-13 16:00:00,2022-04-13 17:00:00,183,949,285,58,244,1671,3390,22840
2022-04-13 17:00:00,2022-04-13 18:00:00,182,936,294,58,12,2583,4065,23442
2022-04-13 18:00:00,2022-04-13 19:00:00,183,183,269,58,0,3436,4129,22216
2022-04-13 19:00:00,2022-04-13 20:00:00,184,0,242,7,0,3967,4400,20620
2022-04-13 20:00:00,2022-04-13 21:00:00,183,0,232,0,0,4071,4486,19155
2022-04-13 21:00:00,2022-04-13 22:00:00,183,0,228,0,0,3977,4388,18077
2022-04-13 22:00:00,2022-04-13 23:00:00,183,0,228,0,0,3884,4295,17533
2022-04-13 23:00:00,2022-04-14 00:00:00,183,0,228,0,0,3680,4091,17168
2022-04-14 00:00:00,2022-04-14 01:00:00,183,0,228,0,0,3492,3903,17214
2022-04-14 01:00:00,2022-04-14 02:00:00,184,0,227,0,0,3303,3714,17418
2022-04-14 02:00:00,2022-04-14 03:00:00,185,0,227,0,11,2963,3386,17865
2022-04-14 03:00:00,2022-04-14 04:00:00,185,26,228,0,147,2502,3088,19754
2022-04-14 04:00:00,2022-04-14 05:00:00,184,229,228,50,776,2034,3501,21520
2022-04-14 05:00:00,2022-04-14 06:00:00,183,230,232,58,1956,1224,3883,22206
2022-04-14 06:00:00,2022-04-14 07:00:00,190,268,242,7,2935,549,4191,21979
2022-04-14 07:00:00,2022-04-14 08:00:00,204,0,242,0,3746,363,4555,21719
2022-04-14 08:00:00,2022-04-14 09:00:00,204,0,241,0,4389,371,5205,21905
2022-04-14 09:00:00,2022-04-14 10:00:00,204,0,234,0,4623,427,5488,21955
2022-04-14 10:00:00,2022-04-14 11:00:00,194,0,233,0,4513,489,5429,22028
2022-04-14 11:00:00,2022-04-14 12:00:00,184,0,233,0,4301,484,5202,21878
2022-04-14 12:00:00,2022-04-14 13:00:00,184,0,234,0,3595,515,4528,21931
2022-04-14 13:00:00,2022-04-14 14:00:00,184,0,235,0,2792,512,3723,21976
2022-04-14 14:00:00,2022-04-14 15:00:00,185,124,255,50,1820,508,2942,21959
2022-04-14 15:00:00,2022-04-14 16:00:00,185,762,289,58,862,811,2967,21936
2022-04-14 16:00:00,2022-04-14 17:00:00,183,616,297,58,183,1166,2503,22426
2022-04-14 17:00:00,2022-04-14 18:00:00,184,659,299,58,12,1326,2538,23168
2022-04-14 18:00:00,2022-04-14 19:00:00,183,664,294,57,0,1486,2684,21947
2022-04-14 19:00:00,2022-04-14 20:00:00,183,30,277,57,0,1477,2024,20395
2022-04-14 20:00:00,2022-04-14 21:00:00,184,0,254,7,0,1436,1881,19009
2022-04-14 21:00:00,2022-04-14 22:00:00,185,33,236,0,0,1261,1715,17787
2022-04-14 22:00:00,2022-04-14 23:00:00,184,0,238,0,0,1238,1660,17045
2022-04-14 23:00:00,2022-04-15 00:00:00,184,0,238,0,0,1207,1629,16763
2022-04-15 00:00:00,2022-04-15 01:00:00,183,0,238,0,0,1087,1508,16687
2022-04-15 01:00:00,2022-04-15 02:00:00,184,0,238,0,0,908,1330,16886
2022-04-15 02:00:00,2022-04-15 03:00:00,183,0,238,0,9,795,1225,17151
2022-04-15 03:00:00,2022-04-15 04:00:00,184,0,237,50,75,833,1379,18655
2022-04-15 04:00:00,2022-04-15 05:00:00,175,63,236,57,295,785,1611,20466
2022-04-15 05:00:00,2022-04-15 06:00:00,183,183,272,57,522,692,1909,21731
2022-04-15 06:00:00,2022-04-15 07:00:00,185,83,287,57,996,834,2442,22632
2022-04-15 07:00:00,2022-04-15 08:00:00,185,0,259,7,1105,1177,2733,22700
2022-04-15 08:00:00,2022-04-15 09:00:00,183,0,257,0,1237,1648,3325,22925
2022-04-15 09:00:00,2022-04-15 10:00:00,184,0,251,0,1452,2279,4166,22864
2022-04-15 10:00:00,2022-04-15 11:00:00,185,0,250,0,1916,2869,5220,22982
2022-04-15 11:00:00,2022-04-15 12:00:00,207,0,251,0,1549,3507,5514,22229
2022-04-15 12:00:00,2022-04-15 13:00:00,214,309,250,0,1562,3887,6222,22514
2022-04-15 13:00:00,2022-04-15 14:00:00,218,364,251,0,915,4364,6112,22197
2022-04-15 14:00:00,2022-04-15 15:00:00,218,423,255,0,582,4596,6074,22072
2022-04-15 15:00:00,2022-04-15 16:00:00,219,720,274,50,262,4670,6195,21784
2022-04-15 16:00:00,2022-04-15 17:00:00,219,902,282,57,78,4501,6039,21839
2022-04-15 17:00:00,2022-04-15 18:00:00,218,1035,308,57,9,4549,6176,22196
2022-04-15 18:00:00,2022-04-15 19:00:00,217,662,309,57,0,4674,5919,21043
2022-04-15 19:00:00,2022-04-15 20:00:00,219,263,289,7,0,4619,5397,19458
2022-04-15 20:00:00,2022-04-15 21:00:00,218,115,279,0,0,4568,5180,17838
2022-04-15 21:00:00,2022-04-15 22:00:00,220,1,260,0,0,4525,5006,16506
2022-04-15 22:00:00,2022-04-15 23:00:00,198,0,243,0,0,4302,4743,15677
2022-04-15 23:00:00,2022-04-16 00:00:00,193,0,243,0,0,4133,4569,15368
2022-04-16 00:00:00,2022-04-16 01:00:00,192,0,243,0,0,3863,4298,15176
2022-04-16 01:00:00,2022-04-16 02:00:00,191,0,243,0,0,3803,4237,15180
2022-04-16 02:00:00,2022-04-16 03:00:00,192,0,243,0,11,3731,4177,14855
2022-04-16 03:00:00,2022-04-16 04:00:00,193,0,243,0,129,3490,4055,15331
2022-04-16 04:00:00,2022-04-16 05:00:00,192,49,243,0,686,3044,4214,16468
2022-04-16 05:00:00,2022-04-16 06:00:00,194,77,267,47,1602,3162,5349,17962
2022-04-16 06:00:00,2022-04-16 07:00:00,191,203,273,57,2284,3655,6663,18610
2022-04-16 07:00:00,2022-04-16 08:00:00,195,366,266,7,3078,3761,7673,18825
2022-04-16 08:00:00,2022-04-16 09:00:00,193,280,261,0,3361,3598,7693,18417
2022-04-16 09:00:00,2022-04-16 10:00:00,193,7,253,0,3613,3492,7558,18051
2022-04-16 10:00:00,2022-04-16 11:00:00,192,0,253,0,3627,3436,7508,17580
2022-04-16 11:00:00,2022-04-16 12:00:00,194,0,251,0,3502,3547,7494,17107
2022-04-16 12:00:00,2022-04-16 13:00:00,192,0,250,0,3372,3530,7344,17286
2022-04-16 13:00:00,2022-04-16 14:00:00,192,0,256,0,2557,3492,6497,17323
2022-04-16 14:00:00,2022-04-16 15:00:00,193,74,270,0,1743,3127,5407,17615
2022-04-16 15:00:00,2022-04-16 16:00:00,195,689,304,50,879,2666,4783,17821
2022-04-16 16:00:00,2022-04-16 17:00:00,197,1162,309,58,285,2025,4036,17998
2022-04-16 17:00:00,2022-04-16 18:00:00,200,1227,310,58,19,1809,3623,18506
2022-04-16 18:00:00,2022-04-16 19:00:00,199,1174,310,58,0,1830,3571,17842
2022-04-16 19:00:00,2022-04-16 20:00:00,198,694,298,7,0,1854,3051,17043
2022-04-16 20:00:00,2022-04-16 21:00:00,196,219,256,0,0,1782,2453,15928
2022-04-16 21:00:00,2022-04-16 22:00:00,193,0,239,0,0,1623,2055,14746
2022-04-16 22:00:00,2022-04-16 23:00:00,192,0,238,0,0,1644,2074,13960
2022-04-16 23:00:00,2022-04-17 00:00:00,194,0,238,0,0,1484,1916,13610
2022-04-17 00:00:00,2022-04-17 01:00:00,192,0,238,0,0,1219,1649,13495
2022-04-17 01:00:00,2022-04-17 02:00:00,194,0,238,0,0,1037,1469,13555
2022-04-17 02:00:00,2022-04-17 03:00:00,193,80,238,0,16,974,1501,13402
2022-04-17 03:00:00,2022-04-17 04:00:00,193,92,237,50,194,896,1662,13293
2022-04-17 04:00:00,2022-04-17 05:00:00,193,92,238,58,1041,590,2212,14190
2022-04-17 05:00:00,2022-04-17 06:00:00,192,28,251,58,2268,285,3082,14843
2022-04-17 06:00:00,2022-04-17 07:00:00,192,4,267,57,3480,206,4206,14580
2022-04-17 07:00:00,2022-04-17 08:00:00,193,0,267,7,4368,330,5165,14705
2022-04-17 08:00:00,2022-04-17 09:00:00,192,0,267,0,4364,450,5273,14142
2022-04-17 09:00:00,2022-04-17 10:00:00,194,0,255,0,4594,428,5471,14134
2022-04-17 10:00:00,2022-04-17 11:00:00,193,0,247,0,4583,516,5539,14154
2022-04-17 11:00:00,2022-04-17 12:00:00,192,0,261,0,4216,718,5387,13830
2022-04-17 12:00:00,2022-04-17 13:00:00,192,0,267,0,3849,908,5216,13963
2022-04-17 13:00:00,2022-04-17 14:00:00,193,9,267,0,2976,1107,4552,14046
2022-04-17 14:00:00,2022-04-17 15:00:00,193,236,267,0,2039,1290,4025,14342
2022-04-17 15:00:00,2022-04-17 16:00:00,194,712,274,50,995,1132,3357,14924
2022-04-17 16:00:00,2022-04-17 17:00:00,194,1035,276,58,304,1031,2898,15472
2022-04-17 17:00:00,2022-04-17 18:00:00,192,1270,280,58,19,1192,3011,16464
2022-04-17 18:00:00,2022-04-17 19:00:00,192,1067,302,58,0,1321,2940,16285
2022-04-17 19:00:00,2022-04-17 20:00:00,195,815,280,58,0,1354,2702,15675
2022-04-17 20:00:00,2022-04-17 21:00:00,193,353,252,57,0,1332,2187,14778
2022-04-17 21:00:00,2022-04-17 22:00:00,193,59,234,7,0,1229,1722,14015
2022-04-17 22:00:00,2022-04-17 23:00:00,193,0,220,0,0,1052,1465,13338
2022-04-17 23:00:00,2022-04-18 00:00:00,193,0,219,0,0,1046,1458,13078
2022-04-18 00:00:00,2022-04-18 01:00:00,193,0,219,0,0,1105,1517,13085
2022-04-18 01:00:00,2022-04-18 02:00:00,192,0,219,0,0,1093,1504,13214
2022-04-18 02:00:00,2022-04-18 03:00:00,191,22,219,0,17,1104,1553,13093
2022-04-18 03:00:00,2022-04-18 04:00:00,194,29,219,0,219,1035,1696,13005
2022-04-18 04:00:00,2022-04-18 05:00:00,194,113,219,0,998,638,2162,13414
2022-04-18 05:00:00,2022-04-18 06:00:00,191,173,231,0,2160,225,2980,13861
2022-04-18 06:00:00,2022-04-18 07:00:00,192,321,238,0,3413,331,4495,14258
2022-04-18 07:00:00,2022-04-18 08:00:00,193,230,238,0,4394,688,5743,14894
2022-04-18 08:00:00,2022-04-18 09:00:00,192,52,238,0,4743,935,6160,15046
2022-04-18 09:00:00,2022-04-18 10:00:00,192,0,235,0,4642,949,6018,14796
2022-04-18 10:00:00,2022-04-18 11:00:00,192,0,231,0,5023,1131,6577,15123
2022-04-18 11:00:00,2022-04-18 12:00:00,192,0,227,0,4541,1454,6414,14720
2022-04-18 12:00:00,2022-04-18 13:00:00,193,0,227,0,3936,1760,6116,14633
2022-04-18 13:00:00,2022-04-18 14:00:00,193,0,228,0,2904,1969,5294,14732
2022-04-18 14:00:00,2022-04-18 15:00:00,193,154,242,50,1845,2095,4579,15345
2022-04-18 15:00:00,2022-04-18 16:00:00,194,483,249,58,993,2040,4017,16044
2022-04-18 16:00:00,2022-04-18 17:00:00,195,787,252,58,255,1964,3511,16546
2022-04-18 17:00:00,2022-04-18 18:00:00,194,1071,253,58,22,1879,3477,17356
2022-04-18 18:00:00,2022-04-18 19:00:00,195,855,253,58,0,1788,3149,16951
2022-04-18 19:00:00,2022-04-18 20:00:00,195,358,244,58,0,1759,2614,16191
2022-04-18 20:00:00,2022-04-18 21:00:00,193,17,225,57,0,1829,2321,15244
2022-04-18 21:00:00,2022-04-18 22:00:00,193,0,223,7,0,1786,2209,14459
2022-04-18 22:00:00,2022-04-18 23:00:00,194,0,223,0,0,1674,2091,14115
2022-04-18 23:00:00,2022-04-19 00:00:00,192,0,223,0,0,1670,2085,13903
2022-04-19 00:00:00,2022-04-19 01:00:00,193,0,223,0,0,1572,1988,13959
2022-04-19 01:00:00,2022-04-19 02:00:00,193,0,223,0,0,1708,2124,14372
2022-04-19 02:00:00,2022-04-19 03:00:00,193,0,223,0,13,1952,2381,15271
2022-04-19 03:00:00,2022-04-19 04:00:00,193,0,224,0,130,2128,2675,18070
2022-04-19 04:00:00,2022-04-19 05:00:00,194,0,232,50,561,1889,2926,20390
2022-04-19 05:00:00,2022-04-19 06:00:00,194,81,268,58,1232,1644,3477,21622
2022-04-19 06:00:00,2022-04-19 07:00:00,194,12,276,57,2023,1684,4246,22335
2022-04-19 07:00:00,2022-04-19 08:00:00,194,0,276,7,2674,1730,4881,22492
2022-04-19 08:00:00,2022-04-19 09:00:00,195,0,263,0,2718,1883,5059,22499
2022-04-19 09:00:00,2022-04-19 10:00:00,194,0,240,0,2774,1905,5113,22327
2022-04-19 10:00:00,2022-04-19 11:00:00,193,0,239,0,3023,1756,5211,22211
2022-04-19 11:00:00,2022-04-19 12:00:00,194,0,236,0,2771,1568,4769,21567
2022-04-19 12:00:00,2022-04-19 13:00:00,194,0,236,0,2937,1420,4787,22051
2022-04-19 13:00:00,2022-04-19 14:00:00,196,0,248,0,2500,1396,4340,22069
2022-04-19 14:00:00,2022-04-19 15:00:00,194,2,253,0,1794,1268,3511,22104
2022-04-19 15:00:00,2022-04-19 16:00:00,194,213,274,50,989,1259,2979,22235
2022-04-19 16:00:00,2022-04-19 17:00:00,193,647,296,57,286,1140,2619,22538
2022-04-19 17:00:00,2022-04-19 18:00:00,195,892,295,57,22,1076,2537,23148
2022-04-19 18:00:00,2022-04-19 19:00:00,195,647,288,57,0,892,2079,21895
2022-04-19 19:00:00,2022-04-19 20:00:00,194,87,273,57,0,803,1414,20449
2022-04-19 20:00:00,2022-04-19 21:00:00,193,0,236,7,0,636,1072,19112
2022-04-19 21:00:00,2022-04-19 22:00:00,191,0,217,0,0,680,1088,18097
2022-04-19 22:00:00,2022-04-19 23:00:00,193,0,215,0,0,804,1212,17394
2022-04-19 23:00:00,2022-04-20 00:00:00,193,0,216,0,0,1093,1502,17133
2022-04-20 00:00:00,2022-04-20 01:00:00,192,0,214,0,0,1328,1734,17250
2022-04-20 01:00:00,2022-04-20 02:00:00,192,0,214,0,0,1544,1950,17625
2022-04-20 02:00:00,2022-04-20 03:00:00,192,0,213,0,17,1754,2176,18115
2022-04-20 03:00:00,2022-04-20 04:00:00,192,0,213,0,81,2077,2563,20396
2022-04-20 04:00:00,2022-04-20 05:00:00,194,36,212,0,358,2098,2898,22451
2022-04-20 05:00:00,2022-04-20 06:00:00,194,118,226,38,819,1871,3266,23645
2022-04-20 06:00:00,2022-04-20 07:00:00,194,288,245,43,1054,1793,3617,23758
2022-04-20 07:00:00,2022-04-20 08:00:00,197,58,250,5,1292,2103,3905,23628
2022-04-20 08:00:00,2022-04-20 09:00:00,196,0,252,0,1462,2366,4276,23890
2022-04-20 09:00:00,2022-04-20 10:00:00,196,5,238,0,1549,2513,4501,23869
2022-04-20 10:00:00,2022-04-20 11:00:00,195,8,231,0,1488,2548,4470,23764
2022-04-20 11:00:00,2022-04-20 12:00:00,194,0,229,0,1291,2395,4109,23544
2022-04-20 12:00:00,2022-04-20 13:00:00,194,0,229,0,1025,2240,3688,23418
2022-04-20 13:00:00,2022-04-20 14:00:00,193,5,229,0,884,2100,3411,23413
2022-04-20 14:00:00,2022-04-20 15:00:00,163,13,229,0,505,1903,2813,23149
2022-04-20 15:00:00,2022-04-20 16:00:00,159,484,278,50,251,1663,2885,22985
2022-04-20 16:00:00,2022-04-20 17:00:00,159,816,290,57,81,1425,2828,23408
2022-04-20 17:00:00,2022-04-20 18:00:00,157,1046,288,58,10,1274,2833,23714
2022-04-20 18:00:00,2022-04-20 19:00:00,157,586,278,57,0,1002,2080,22339
2022-04-20 19:00:00,2022-04-20 20:00:00,159,74,249,7,0,893,1382,20753
2022-04-20 20:00:00,2022-04-20 21:00:00,171,0,224,0,0,929,1324,19490
2022-04-20 21:00:00,2022-04-20 22:00:00,190,78,209,0,0,956,1433,18500
2022-04-20 22:00:00,2022-04-20 23:00:00,193,0,207,0,0,915,1315,17897
2022-04-20 23:00:00,2022-04-21 00:00:00,192,0,207,0,0,796,1195,17598
2022-04-21 00:00:00,2022-04-21 01:00:00,193,0,207,0,0,736,1136,17625
2022-04-21 01:00:00,2022-04-21 02:00:00,193,0,207,0,0,761,1161,17793
2022-04-21 02:00:00,2022-04-21 03:00:00,192,0,207,0,14,744,1157,18158
2022-04-21 03:00:00,2022-04-21 04:00:00,193,9,208,0,84,820,1314,20549
2022-04-21 04:00:00,2022-04-21 05:00:00,194,306,208,38,471,717,1934,22580
2022-04-21 05:00:00,2022-04-21 06:00:00,194,602,218,43,954,619,2630,23458
2022-04-21 06:00:00,2022-04-21 07:00:00,193,278,220,5,1279,570,2545,23547
2022-04-21 07:00:00,2022-04-21 08:00:00,195,49,221,0,1736,689,2890,23319
2022-04-21 08:00:00,2022-04-21 09:00:00,193,24,222,0,2375,907,3721,23497
2022-04-21 09:00:00,2022-04-21 10:00:00,197,0,220,0,2915,1086,4418,23639
2022-04-21 10:00:00,2022-04-21 11:00:00,195,0,220,0,2871,1315,4601,23409
2022-04-21 11:00:00,2022-04-21 12:00:00,194,0,221,0,2371,1503,4289,22851
2022-04-21 12:00:00,2022-04-21 13:00:00,195,0,220,0,2085,1738,4238,22948
2022-04-21 13:00:00,2022-04-21 14:00:00,194,0,220,0,1722,1705,3841,23069
2022-04-21 14:00:00,2022-04-21 15:00:00,194,0,222,0,1101,1572,3089,22927
2022-04-21 15:00:00,2022-04-21 16:00:00,196,0,249,50,640,1352,2487,22852
2022-04-21 16:00:00,2022-04-21 17:00:00,194,345,280,58,185,1165,2227,23118
2022-04-21 17:00:00,2022-04-21 18:00:00,195,834,288,58,14,1206,2595,23496
2022-04-21 18:00:00,2022-04-21 19:00:00,195,240,286,57,0,1088,1866,22273
2022-04-21 19:00:00,2022-04-21 20:00:00,193,19,268,7,0,1071,1558,20706
2022-04-21 20:00:00,2022-04-21 21:00:00,192,0,247,0,0,955,1394,19362
2022-04-21 21:00:00,2022-04-21 22:00:00,192,0,218,0,0,888,1298,18222
2022-04-21 22:00:00,2022-04-21 23:00:00,193,0,217,0,0,879,1289,17519
2022-04-21 23:00:00,2022-04-22 00:00:00,195,0,217,0,0,1036,1448,17266
2022-04-22 00:00:00,2022-04-22 01:00:00,194,0,217,0,0,1335,1746,17306
2022-04-22 01:00:00,2022-04-22 02:00:00,193,0,217,0,0,1466,1876,17518
2022-04-22 02:00:00,2022-04-22 03:00:00,192,0,217,0,15,1825,2249,17962
2022-04-22 03:00:00,2022-04-22 04:00:00,192,0,217,0,129,2014,2552,20215
2022-04-22 04:00:00,2022-04-22 05:00:00,193,155,217,50,613,2146,3374,22239
2022-04-22 05:00:00,2022-04-22 06:00:00,194,75,243,58,1301,2081,3952,23185
2022-04-22 06:00:00,2022-04-22 07:00:00,195,5,271,57,1979,2171,4678,23395
2022-04-22 07:00:00,2022-04-22 08:00:00,196,0,274,7,2396,2515,5388,23090
2022-04-22 08:00:00,2022-04-22 09:00:00,194,0,250,0,2822,2643,5909,23296
2022-04-22 09:00:00,2022-04-22 10:00:00,195,0,243,0,2826,2689,5953,23130
2022-04-22 10:00:00,2022-04-22 11:00:00,195,0,241,0,3108,2740,6284,23048
2022-04-22 11:00:00,2022-04-22 12:00:00,195,0,232,0,2748,2832,6007,22429
2022-04-22 12:00:00,2022-04-22 13:00:00,194,0,232,0,2589,2823,5838,22495
2022-04-22 13:00:00,2022-04-22 14:00:00,192,0,232,0,2281,2896,5601,22572
2022-04-22 14:00:00,2022-04-22 15:00:00,195,0,231,0,1605,2832,4863,22447
2022-04-22 15:00:00,2022-04-22 16:00:00,195,169,232,0,898,2554,4048,22379
2022-04-22 16:00:00,2022-04-22 17:00:00,194,581,247,50,498,2247,3817,22838
2022-04-22 17:00:00,2022-04-22 18:00:00,194,866,290,58,174,2213,3795,23215
2022-04-22 18:00:00,2022-04-22 19:00:00,194,616,296,57,0,2194,3357,22074
2022-04-22 19:00:00,2022-04-22 20:00:00,193,45,252,7,0,2152,2649,20517
2022-04-22 20:00:00,2022-04-22 21:00:00,193,3,228,0,0,1859,2283,19363
2022-04-22 21:00:00,2022-04-22 22:00:00,194,6,218,0,0,1658,2076,18264
2022-04-22 22:00:00,2022-04-22 23:00:00,191,4,217,0,0,1508,1920,17445
2022-04-22 23:00:00,2022-04-23 00:00:00,194,0,217,0,0,1421,1832,17158
2022-04-23 00:00:00,2022-04-23 01:00:00,194,0,217,0,0,1427,1838,17137
2022-04-23 01:00:00,2022-04-23 02:00:00,192,0,217,0,0,1387,1796,17280
2022-04-23 02:00:00,2022-04-23 03:00:00,192,0,217,0,227,1438,2074,17037
2022-04-23 03:00:00,2022-04-23 04:00:00,192,0,218,0,433,1295,2138,17661
2022-04-23 04:00:00,2022-04-23 05:00:00,192,58,218,50,1088,820,2426,18629
2022-04-23 05:00:00,2022-04-23 06:00:00,192,95,246,58,2192,439,3222,19604
2022-04-23 06:00:00,2022-04-23 07:00:00,191,49,260,57,3163,494,4214,19977
2022-04-23 07:00:00,2022-04-23 08:00:00,190,0,240,7,3787,925,5149,19986
2022-04-23 08:00:00,2022-04-23 09:00:00,192,0,240,0,4045,1441,5918,20210
2022-04-23 09:00:00,2022-04-23 10:00:00,194,0,231,0,4077,1652,6154,20296
2022-04-23 10:00:00,2022-04-23 11:00:00,194,0,228,0,3675,1637,5734,19782
2022-04-23 11:00:00,2022-04-23 12:00:00,194,0,225,0,3815,1647,5881,19481
2022-04-23 12:00:00,2022-04-23 13:00:00,192,0,225,0,3141,1937,5495,19039
2022-04-23 13:00:00,2022-04-23 14:00:00,192,0,224,0,2524,1861,4801,18754
2022-04-23 14:00:00,2022-04-23 15:00:00,192,118,228,0,1774,1767,4079,18880
2022-04-23 15:00:00,2022-04-23 16:00:00,193,381,237,50,1236,1641,3738,19518
2022-04-23 16:00:00,2022-04-23 17:00:00,193,780,272,57,568,1468,3338,19802
2022-04-23 17:00:00,2022-04-23 18:00:00,192,952,280,57,175,1492,3148,20476
2022-04-23 18:00:00,2022-04-23 19:00:00,193,949,273,57,0,1416,2888,19487
2022-04-23 19:00:00,2022-04-23 20:00:00,193,769,257,57,0,1327,2603,18416
2022-04-23 20:00:00,2022-04-23 21:00:00,191,157,219,7,0,1366,1940,17123
2022-04-23 21:00:00,2022-04-23 22:00:00,193,0,212,0,0,1418,1823,16160
2022-04-23 22:00:00,2022-04-23 23:00:00,192,0,209,0,0,1402,1803,15560
2022-04-23 23:00:00,2022-04-24 00:00:00,194,0,209,0,0,1345,1748,15226
2022-04-24 00:00:00,2022-04-24 01:00:00,193,0,209,0,0,1259,1661,14879
2022-04-24 01:00:00,2022-04-24 02:00:00,193,0,209,0,0,1228,1630,14940
2022-04-24 02:00:00,2022-04-24 03:00:00,192,0,209,0,231,1181,1813,14757
2022-04-24 03:00:00,2022-04-24 04:00:00,192,0,209,0,446,1085,1932,15036
2022-04-24 04:00:00,2022-04-24 05:00:00,192,62,208,0,1109,885,2456,15675
2022-04-24 05:00:00,2022-04-24 06:00:00,193,55,218,0,1997,518,2981,16575
2022-04-24 06:00:00,2022-04-24 07:00:00,192,65,224,2,2862,523,3868,17234
2022-04-24 07:00:00,2022-04-24 08:00:00,192,8,225,5,3230,858,4518,17400
2022-04-24 08:00:00,2022-04-24 09:00:00,194,21,217,8,3381,1211,5032,17498
2022-04-24 09:00:00,2022-04-24 10:00:00,194,3,215,3,3480,1729,5624,17453
2022-04-24 10:00:00,2022-04-24 11:00:00,193,0,215,0,3594,2119,6121,17597
2022-04-24 11:00:00,2022-04-24 12:00:00,193,0,215,1,3095,2510,6014,17380
2022-04-24 12:00:00,2022-04-24 13:00:00,193,0,214,1,2605,3057,6070,17525
2022-04-24 13:00:00,2022-04-24 14:00:00,193,0,214,0,1934,3506,5847,17692
2022-04-24 14:00:00,2022-04-24 15:00:00,192,87,219,0,1265,3772,5535,18099
2022-04-24 15:00:00,2022-04-24 16:00:00,193,184,221,0,653,3717,4968,18430
2022-04-24 16:00:00,2022-04-24 17:00:00,190,457,230,0,390,3463,4730,19046
2022-04-24 17:00:00,2022-04-24 18:00:00,193,454,231,0,161,3566,4605,19513
2022-04-24 18:00:00,2022-04-24 19:00:00,193,224,231,0,0,3484,4132,18768
2022-04-24 19:00:00,2022-04-24 20:00:00,193,5,229,0,0,3195,3622,17946
2022-04-24 20:00:00,2022-04-24 21:00:00,195,0,215,0,0,3053,3463,16736
2022-04-24 21:00:00,2022-04-24 22:00:00,193,0,210,0,0,2588,2991,15778
2022-04-24 22:00:00,2022-04-24 23:00:00,193,0,210,0,0,2271,2674,15489
2022-04-24 23:00:00,2022-04-25 00:00:00,193,0,209,0,0,2199,2601,15332
2022-04-25 00:00:00,2022-04-25 01:00:00,191,0,209,0,0,1940,2340,15359
2022-04-25 01:00:00,2022-04-25 02:00:00,193,0,209,0,0,1756,2158,15718
2022-04-25 02:00:00,2022-04-25 03:00:00,193,0,209,0,163,1563,2128,16618
2022-04-25 03:00:00,2022-04-25 04:00:00,190,0,209,0,375,1410,2184,19548
2022-04-25 04:00:00,2022-04-25 05:00:00,196,9,211,50,704,1215,2385,21688
2022-04-25 05:00:00,2022-04-25 06:00:00,193,89,234,58,1066,1040,2680,22652
2022-04-25 06:00:00,2022-04-25 07:00:00,193,92,251,7,1468,964,2975,22946
2022-04-25 07:00:00,2022-04-25 08:00:00,196,90,235,0,1679,945,3145,22705
2022-04-25 08:00:00,2022-04-25 09:00:00,196,12,235,0,1778,971,3192,23088
2022-04-25 09:00:00,2022-04-25 10:00:00,195,0,225,0,1722,1019,3161,23092
2022-04-25 10:00:00,2022-04-25 11:00:00,194,0,220,0,1563,993,2970,23047
2022-04-25 11:00:00,2022-04-25 12:00:00,193,0,220,0,1346,1019,2778,22610
2022-04-25 12:00:00,2022-04-25 13:00:00,193,0,220,0,1188,1015,2616,22718
2022-04-25 13:00:00,2022-04-25 14:00:00,195,0,218,0,972,1027,2412,22633
2022-04-25 14:00:00,2022-04-25 15:00:00,195,0,224,0,724,958,2101,22676
2022-04-25 15:00:00,2022-04-25 16:00:00,194,124,239,50,354,866,1827,22536
2022-04-25 16:00:00,2022-04-25 17:00:00,195,543,268,58,186,846,2096,23028
2022-04-25 17:00:00,2022-04-25 18:00:00,195,681,271,58,62,839,2106,23437
2022-04-25 18:00:00,2022-04-25 19:00:00,193,462,271,58,0,778,1762,22155
2022-04-25 19:00:00,2022-04-25 20:00:00,194,105,235,58,0,716,1308,20500
2022-04-25 20:00:00,2022-04-25 21:00:00,194,0,222,7,0,664,1087,19179
2022-04-25 21:00:00,2022-04-25 22:00:00,193,135,217,0,0,628,1173,18202
2022-04-25 22:00:00,2022-04-25 23:00:00,194,0,219,0,0,605,1018,17590
2022-04-25 23:00:00,2022-04-26 00:00:00,193,0,219,0,0,612,1024,17332
2022-04-26 00:00:00,2022-04-26 01:00:00,193,0,219,0,0,610,1022,17432
2022-04-26 01:00:00,2022-04-26 02:00:00,192,0,219,0,0,589,1000,17680
2022-04-26 02:00:00,2022-04-26 03:00:00,193,0,219,0,85,565,1062,18070
2022-04-26 03:00:00,2022-04-26 04:00:00,193,0,219,0,200,487,1099,20399
2022-04-26 04:00:00,2022-04-26 05:00:00,194,328,220,50,496,331,1619,22297
2022-04-26 05:00:00,2022-04-26 06:00:00,194,408,237,58,1094,213,2204,23099
2022-04-26 06:00:00,2022-04-26 07:00:00,195,121,258,58,1876,152,2660,23163
2022-04-26 07:00:00,2022-04-26 08:00:00,195,0,236,7,2591,132,3161,22534
2022-04-26 08:00:00,2022-04-26 09:00:00,194,0,236,0,3096,185,3711,22737
2022-04-26 09:00:00,2022-04-26 10:00:00,194,0,244,0,3377,259,4074,22740
2022-04-26 10:00:00,2022-04-26 11:00:00,195,0,245,0,3288,324,4052,22754
2022-04-26 11:00:00,2022-04-26 12:00:00,196,116,242,0,3125,361,4040,22844
2022-04-26 12:00:00,2022-04-26 13:00:00,194,188,238,0,2420,375,3415,22621
2022-04-26 13:00:00,2022-04-26 14:00:00,194,70,238,0,1943,355,2800,22561
2022-04-26 14:00:00,2022-04-26 15:00:00,193,0,238,50,1254,304,2039,22346
2022-04-26 15:00:00,2022-04-26 16:00:00,195,178,253,58,675,334,1693,22312
2022-04-26 16:00:00,2022-04-26 17:00:00,195,599,258,58,278,373,1761,22767
2022-04-26 17:00:00,2022-04-26 18:00:00,195,837,277,58,29,389,1785,23365
2022-04-26 18:00:00,2022-04-26 19:00:00,195,542,277,58,0,431,1503,22232
2022-04-26 19:00:00,2022-04-26 20:00:00,194,22,273,7,0,454,950,20693
2022-04-26 20:00:00,2022-04-26 21:00:00,192,0,237,0,0,540,969,19388
2022-04-26 21:00:00,2022-04-26 22:00:00,192,168,214,0,0,470,1044,18328
2022-04-26 22:00:00,2022-04-26 23:00:00,193,54,210,0,0,455,912,17705
2022-04-26 23:00:00,2022-04-27 00:00:00,194,0,210,0,0,444,848,17431
2022-04-27 00:00:00,2022-04-27 01:00:00,192,0,210,0,0,425,827,17474
2022-04-27 01:00:00,2022-04-27 02:00:00,193,12,210,0,0,461,876,17665
2022-04-27 02:00:00,2022-04-27 03:00:00,192,125,211,0,32,544,1104,17903
2022-04-27 03:00:00,2022-04-27 04:00:00,193,126,220,50,270,549,1408,20012
2022-04-27 04:00:00,2022-04-27 05:00:00,194,187,226,58,939,428,2032,21729
2022-04-27 05:00:00,2022-04-27 06:00:00,195,118,242,58,1922,241,2776,22170
2022-04-27 06:00:00,2022-04-27 07:00:00,195,264,264,58,2905,217,3903,21925
2022-04-27 07:00:00,2022-04-27 08:00:00,195,370,260,7,3692,197,4721,21486
2022-04-27 08:00:00,2022-04-27 09:00:00,194,288,231,0,4043,234,4990,22154
2022-04-27 09:00:00,2022-04-27 10:00:00,195,104,229,0,3716,337,4581,22361
2022-04-27 10:00:00,2022-04-27 11:00:00,200,136,234,0,3202,446,4218,22470
2022-04-27 11:00:00,2022-04-27 12:00:00,221,17,239,0,3022,587,4086,22327
2022-04-27 12:00:00,2022-04-27 13:00:00,224,0,240,0,3241,762,4467,22705
2022-04-27 13:00:00,2022-04-27 14:00:00,226,5,236,0,2432,917,3816,22216
2022-04-27 14:00:00,2022-04-27 15:00:00,222,23,244,0,1310,1049,2848,21798
2022-04-27 15:00:00,2022-04-27 16:00:00,221,303,282,50,937,1045,2838,22178
2022-04-27 16:00:00,2022-04-27 17:00:00,223,857,284,58,348,1128,2898,22569
2022-04-27 17:00:00,2022-04-27 18:00:00,222,909,285,57,23,1192,2688,23077
2022-04-27 18:00:00,2022-04-27 19:00:00,221,597,283,57,0,1163,2321,22098
2022-04-27 19:00:00,2022-04-27 20:00:00,221,433,275,7,0,989,1925,20478
2022-04-27 20:00:00,2022-04-27 21:00:00,219,122,234,0,0,949,1524,19159
2022-04-27 21:00:00,2022-04-27 22:00:00,219,1,222,0,0,908,1350,18132
2022-04-27 22:00:00,2022-04-27 23:00:00,220,14,220,0,0,744,1198,17596
2022-04-27 23:00:00,2022-04-28 00:00:00,220,21,221,0,0,672,1134,17330
2022-04-28 00:00:00,2022-04-28 01:00:00,219,5,220,0,0,723,1167,17442
2022-04-28 01:00:00,2022-04-28 02:00:00,220,0,222,50,0,753,1245,17668
2022-04-28 02:00:00,2022-04-28 03:00:00,220,17,221,57,32,811,1358,17916
2022-04-28 03:00:00,2022-04-28 04:00:00,220,70,219,57,268,762,1596,19942
2022-04-28 04:00:00,2022-04-28 05:00:00,219,185,218,57,1102,529,2310,21858
2022-04-28 05:00:00,2022-04-28 06:00:00,220,343,223,57,2109,287,3239,22187
2022-04-28 06:00:00,2022-04-28 07:00:00,219,34,247,7,3160,205,3872,21973
2022-04-28 07:00:00,2022-04-28 08:00:00,219,0,232,0,4202,220,4873,21607
2022-04-28 08:00:00,2022-04-28 09:00:00,219,0,231,0,4568,321,5339,21973
2022-04-28 09:00:00,2022-04-28 10:00:00,218,0,221,0,4493,405,5337,21912
2022-04-28 10:00:00,2022-04-28 11:00:00,219,0,221,0,4605,427,5472,22139
2022-04-28 11:00:00,2022-04-28 12:00:00,222,0,225,0,4265,404,5116,21768
2022-04-28 12:00:00,2022-04-28 13:00:00,221,0,229,0,3567,446,4463,21581
2022-04-28 13:00:00,2022-04-28 14:00:00,221,0,228,0,2994,497,3940,21773
2022-04-28 14:00:00,2022-04-28 15:00:00,224,17,240,0,2162,489,3132,21916
2022-04-28 15:00:00,2022-04-28 16:00:00,249,376,261,50,1126,462,2524,21938
2022-04-28 16:00:00,2022-04-28 17:00:00,240,805,291,57,414,458,2265,22376
2022-04-28 17:00:00,2022-04-28 18:00:00,228,945,295,57,35,496,2056,23162
2022-04-28 18:00:00,2022-04-28 19:00:00,237,672,286,57,0,425,1677,22278
2022-04-28 19:00:00,2022-04-28 20:00:00,224,143,265,57,0,397,1086,20767
2022-04-28 20:00:00,2022-04-28 21:00:00,219,63,234,7,0,395,918,19311
2022-04-28 21:00:00,2022-04-28 22:00:00,219,7,221,0,0,456,903,18229
2022-04-28 22:00:00,2022-04-28 23:00:00,220,0,218,0,0,478,916,17710
2022-04-28 23:00:00,2022-04-29 00:00:00,221,0,218,0,0,532,971,17326
2022-04-29 00:00:00,2022-04-29 01:00:00,219,0,218,0,0,604,1041,17404
2022-04-29 01:00:00,2022-04-29 02:00:00,219,31,218,0,0,605,1073,17601
2022-04-29 02:00:00,2022-04-29 03:00:00,220,65,216,50,39,577,1167,17847
2022-04-29 03:00:00,2022-04-29 04:00:00,220,79,211,57,335,486,1388,19914
2022-04-29 04:00:00,2022-04-29 05:00:00,220,109,210,57,1300,323,2219,21749
2022-04-29 05:00:00,2022-04-29 06:00:00,219,45,217,57,2629,99,3266,22275
2022-04-29 06:00:00,2022-04-29 07:00:00,219,0,221,7,3714,103,4264,21825
2022-04-29 07:00:00,2022-04-29 08:00:00,220,0,214,0,4628,138,5200,21592
2022-04-29 08:00:00,2022-04-29 09:00:00,221,0,212,0,4848,198,5479,21760
2022-04-29 09:00:00,2022-04-29 10:00:00,220,0,212,0,4747,257,5436,21706
2022-04-29 10:00:00,2022-04-29 11:00:00,220,0,213,0,4600,301,5334,21480
2022-04-29 11:00:00,2022-04-29 12:00:00,219,0,213,0,4524,394,5350,21189
2022-04-29 12:00:00,2022-04-29 13:00:00,220,0,213,0,4228,418,5079,21534
2022-04-29 13:00:00,2022-04-29 14:00:00,230,0,220,0,3221,382,4053,21224
2022-04-29 14:00:00,2022-04-29 15:00:00,251,0,226,0,2398,383,3258,21553
2022-04-29 15:00:00,2022-04-29 16:00:00,242,58,227,50,1404,352,2333,21723
2022-04-29 16:00:00,2022-04-29 17:00:00,242,390,238,57,480,370,1777,21917
2022-04-29 17:00:00,2022-04-29 18:00:00,249,800,248,57,47,524,1925,22398
2022-04-29 18:00:00,2022-04-29 19:00:00,259,557,249,57,0,759,1881,21535
2022-04-29 19:00:00,2022-04-29 20:00:00,285,23,247,57,0,1000,1612,20021
2022-04-29 20:00:00,2022-04-29 21:00:00,279,0,219,57,0,1302,1857,18730
2022-04-29 21:00:00,2022-04-29 22:00:00,257,0,207,7,0,1332,1803,17519
2022-04-29 22:00:00,2022-04-29 23:00:00,250,0,205,0,0,1305,1760,16764
2022-04-29 23:00:00,2022-04-30 00:00:00,253,0,205,0,0,1228,1686,16353
2022-04-30 00:00:00,2022-04-30 01:00:00,250,0,205,0,0,1078,1533,16297
2022-04-30 01:00:00,2022-04-30 02:00:00,251,0,204,0,0,962,1417,16299
2022-04-30 02:00:00,2022-04-30 03:00:00,256,0,204,0,50,946,1456,15769
2022-04-30 03:00:00,2022-04-30 04:00:00,256,18,202,50,405,919,1850,16393
2022-04-30 04:00:00,2022-04-30 05:00:00,255,89,202,57,1334,711,2648,17432
2022-04-30 05:00:00,2022-04-30 06:00:00,255,302,218,7,2338,394,3514,18321
2022-04-30 06:00:00,2022-04-30 07:00:00,254,285,218,0,3254,296,4307,18746
2022-04-30 07:00:00,2022-04-30 08:00:00,255,237,218,0,3788,222,4720,18401
2022-04-30 08:00:00,2022-04-30 09:00:00,256,104,210,0,4525,187,5282,18846
2022-04-30 09:00:00,2022-04-30 10:00:00,256,0,209,0,4591,204,5260,18682
2022-04-30 10:00:00,2022-04-30 11:00:00,254,0,208,0,4176,189,4827,18159
2022-04-30 11:00:00,2022-04-30 12:00:00,254,0,206,0,4131,191,4782,18026
2022-04-30 12:00:00,2022-04-30 13:00:00,255,0,206,0,3703,221,4385,18083
2022-04-30 13:00:00,2022-04-30 14:00:00,255,0,210,0,2740,251,3456,17900
2022-04-30 14:00:00,2022-04-30 15:00:00,252,15,220,50,2073,227,2837,18281
2022-04-30 15:00:00,2022-04-30 16:00:00,262,149,226,57,1175,206,2075,18348
2022-04-30 16:00:00,2022-04-30 17:00:00,285,359,235,57,383,297,1616,18381
2022-04-30 17:00:00,2022-04-30 18:00:00,285,507,246,57,52,484,1631,19026
2022-04-30 18:00:00,2022-04-30 19:00:00,284,492,248,57,0,712,1793,18604
2022-04-30 19:00:00,2022-04-30 20:00:00,263,174,246,57,0,858,1598,17398
2022-04-30 20:00:00,2022-04-30 21:00:00,252,27,219,57,0,937,1492,16197
2022-04-30 21:00:00,2022-04-30 22:00:00,249,0,210,7,0,1082,1548,15323
2022-04-30 22:00:00,2022-04-30 23:00:00,252,0,209,0,0,1183,1644,14761
2022-04-30 23:00:00,2022-05-01 00:00:00,248,0,209,0,0,1127,1584,14456
2022-05-01 00:00:00,2022-05-01 01:00:00,248,0,209,0,0,911,1368,14254
2022-05-01 01:00:00,2022-05-01 02:00:00,250,0,209,0,6,730,1195,14144
2022-05-01 02:00:00,2022-05-01 03:00:00,249,0,208,0,52,555,1064,13531
2022-05-01 03:00:00,2022-05-01 04:00:00,250,58,206,50,380,492,1436,13643
2022-05-01 04:00:00,2022-05-01 05:00:00,249,95,206,57,1232,336,2175,14092
2022-05-01 05:00:00,2022-05-01 06:00:00,250,239,213,7,2349,172,3230,14662
2022-05-01 06:00:00,2022-05-01 07:00:00,251,302,215,0,3556,95,4419,15178
2022-05-01 07:00:00,2022-05-01 08:00:00,253,183,214,0,4343,104,5097,15312
2022-05-01 08:00:00,2022-05-01 09:00:00,250,8,215,0,4636,156,5265,14986
2022-05-01 09:00:00,2022-05-01 10:00:00,251,0,220,0,4754,263,5488,15040
2022-05-01 10:00:00,2022-05-01 11:00:00,251,0,219,0,4595,359,5424,15213
2022-05-01 11:00:00,2022-05-01 12:00:00,253,0,216,0,3768,360,4597,14739
2022-05-01 12:00:00,2022-05-01 13:00:00,254,0,215,0,3701,322,4492,15275
2022-05-01 13:00:00,2022-05-01 14:00:00,252,0,218,0,2589,428,3487,15218
2022-05-01 14:00:00,2022-05-01 15:00:00,250,30,237,0,1852,534,2903,15831
2022-05-01 15:00:00,2022-05-01 16:00:00,253,350,261,50,1087,505,2506,16359
2022-05-01 16:00:00,2022-05-01 17:00:00,250,664,273,57,455,497,2196,16751
2022-05-01 17:00:00,2022-05-01 18:00:00,254,590,277,57,70,742,1990,17346
2022-05-01 18:00:00,2022-05-01 19:00:00,252,256,272,56,4,987,1827,17220
2022-05-01 19:00:00,2022-05-01 20:00:00,252,36,265,56,0,1070,1679,16445
2022-05-01 20:00:00,2022-05-01 21:00:00,251,1,220,56,0,1009,1537,15321
2022-05-01 21:00:00,2022-05-01 22:00:00,249,0,212,7,0,946,1414,14552
2022-05-01 22:00:00,2022-05-01 23:00:00,250,0,211,0,0,825,1286,14082
2022-05-01 23:00:00,2022-05-02 00:00:00,250,0,211,0,0,673,1134,13879
2022-05-02 00:00:00,2022-05-02 01:00:00,251,0,211,0,0,587,1049,13895
2022-05-02 01:00:00,2022-05-02 02:00:00,250,0,212,0,7,451,920,14079
2022-05-02 02:00:00,2022-05-02 03:00:00,249,0,211,0,53,306,819,14024
2022-05-02 03:00:00,2022-05-02 04:00:00,252,53,212,0,377,251,1145,15327
2022-05-02 04:00:00,2022-05-02 05:00:00,250,63,212,49,1275,119,1968,16513
2022-05-02 05:00:00,2022-05-02 06:00:00,249,20,232,56,2458,31,3046,17385
2022-05-02 06:00:00,2022-05-02 07:00:00,251,0,241,7,3772,27,4298,17685
2022-05-02 07:00:00,2022-05-02 08:00:00,252,0,226,0,4679,32,5189,17469
2022-05-02 08:00:00,2022-05-02 09:00:00,249,0,223,0,5252,62,5786,17514
2022-05-02 09:00:00,2022-05-02 10:00:00,250,0,215,0,5329,116,5910,17646
2022-05-02 10:00:00,2022-05-02 11:00:00,250,0,218,0,4875,206,5549,17697
2022-05-02 11:00:00,2022-05-02 12:00:00,251,0,214,0,4560,345,5370,17730
2022-05-02 12:00:00,2022-05-02 13:00:00,250,0,213,0,3884,488,4835,17844
2022-05-02 13:00:00,2022-05-02 14:00:00,251,0,216,0,3071,591,4129,17856
2022-05-02 14:00:00,2022-05-02 15:00:00,251,0,225,0,2076,718,3270,17875
2022-05-02 15:00:00,2022-05-02 16:00:00,256,64,257,49,1105,680,2411,18044
2022-05-02 16:00:00,2022-05-02 17:00:00,272,528,276,56,461,516,2109,18432
2022-05-02 17:00:00,2022-05-02 18:00:00,273,908,277,56,77,513,2104,19031
2022-05-02 18:00:00,2022-05-02 19:00:00,272,780,271,56,2,633,2014,18680
2022-05-02 19:00:00,2022-05-02 20:00:00,273,214,267,56,0,888,1698,17571
2022-05-02 20:00:00,2022-05-02 21:00:00,257,9,251,56,0,901,1474,16242
2022-05-02 21:00:00,2022-05-02 22:00:00,249,0,243,7,0,978,1477,15293
2022-05-02 22:00:00,2022-05-02 23:00:00,248,0,242,0,0,1276,1766,14767
2022-05-02 23:00:00,2022-05-03 00:00:00,249,0,242,0,0,1370,1861,14337
2022-05-03 00:00:00,2022-05-03 01:00:00,250,0,242,0,0,1465,1957,14270
2022-05-03 01:00:00,2022-05-03 02:00:00,251,0,242,0,10,1671,2174,14178
2022-05-03 02:00:00,2022-05-03 03:00:00,251,0,238,0,64,1679,2232,13595
2022-05-03 03:00:00,2022-05-03 04:00:00,251,45,211,0,400,1555,2462,13829
2022-05-03 04:00:00,2022-05-03 05:00:00,251,214,211,0,1274,931,2881,14409
2022-05-03 05:00:00,2022-05-03 06:00:00,250,265,214,0,2490,522,3741,15270
2022-05-03 06:00:00,2022-05-03 07:00:00,253,148,217,0,3304,609,4531,15362
2022-05-03 07:00:00,2022-05-03 08:00:00,253,0,229,0,3974,755,5211,15566
2022-05-03 08:00:00,2022-05-03 09:00:00,251,0,227,0,4537,747,5762,16004
2022-05-03 09:00:00,2022-05-03 10:00:00,252,0,227,0,4550,820,5849,16380
2022-05-03 10:00:00,2022-05-03 11:00:00,251,0,227,0,4018,863,5359,16121
2022-05-03 11:00:00,2022-05-03 12:00:00,251,0,225,0,3640,890,5006,15871
2022-05-03 12:00:00,2022-05-03 13:00:00,251,0,222,0,3628,884,4985,16180
2022-05-03 13:00:00,2022-05-03 14:00:00,255,0,212,0,2718,920,4105,15946
2022-05-03 14:00:00,2022-05-03 15:00:00,252,8,212,0,1951,885,3308,16331
2022-05-03 15:00:00,2022-05-03 16:00:00,252,134,235,0,1071,788,2480,16871
2022-05-03 16:00:00,2022-05-03 17:00:00,252,191,252,47,336,673,1751,17160
2022-05-03 17:00:00,2022-05-03 18:00:00,254,766,266,53,64,780,2183,17928
2022-05-03 18:00:00,2022-05-03 19:00:00,255,657,263,53,2,940,2170,17791
2022-05-03 19:00:00,2022-05-03 20:00:00,252,331,232,53,0,883,1751,16771
2022-05-03 20:00:00,2022-05-03 21:00:00,252,45,223,53,0,826,1399,15623
2022-05-03 21:00:00,2022-05-03 22:00:00,249,10,197,7,0,915,1378,14856
2022-05-03 22:00:00,2022-05-03 23:00:00,246,10,194,0,0,928,1378,14397
2022-05-03 23:00:00,2022-05-04 00:00:00,250,1,194,0,0,987,1432,14247
2022-05-04 00:00:00,2022-05-04 01:00:00,248,0,194,0,0,1000,1442,14277
2022-05-04 01:00:00,2022-05-04 02:00:00,248,0,194,0,8,1064,1514,14584
2022-05-04 02:00:00,2022-05-04 03:00:00,248,24,194,0,49,1155,1670,15221
2022-05-04 03:00:00,2022-05-04 04:00:00,248,27,194,0,355,1157,1981,18018
2022-05-04 04:00:00,2022-05-04 05:00:00,249,0,202,0,1218,720,2389,20096
2022-05-04 05:00:00,2022-05-04 06:00:00,248,71,222,0,2475,369,3385,21010
2022-05-04 06:00:00,2022-05-04 07:00:00,243,10,234,0,3672,314,4473,20926
2022-05-04 07:00:00,2022-05-04 08:00:00,247,44,215,0,4489,368,5363,20478
2022-05-04 08:00:00,2022-05-04 09:00:00,251,262,209,0,4801,306,5829,20948
2022-05-04 09:00:00,2022-05-04 10:00:00,251,281,199,0,4680,254,5665,21232
2022-05-04 10:00:00,2022-05-04 11:00:00,252,248,199,0,4445,218,5362,21100
2022-05-04 11:00:00,2022-05-04 12:00:00,250,0,198,0,4400,219,5067,21123
2022-05-04 12:00:00,2022-05-04 13:00:00,250,0,197,0,3691,212,4350,20773
2022-05-04 13:00:00,2022-05-04 14:00:00,250,0,198,0,2905,225,3578,20719
2022-05-04 14:00:00,2022-05-04 15:00:00,252,0,208,47,2261,235,3003,21111
2022-05-04 15:00:00,2022-05-04 16:00:00,260,163,230,53,1348,324,2378,21258
2022-05-04 16:00:00,2022-05-04 17:00:00,260,436,237,53,569,521,2076,21669
2022-05-04 17:00:00,2022-05-04 18:00:00,261,501,242,53,163,1039,2259,22178
2022-05-04 18:00:00,2022-05-04 19:00:00,261,280,251,53,5,1905,2755,21318
2022-05-04 19:00:00,2022-05-04 20:00:00,261,9,233,53,0,2562,3118,19564
2022-05-04 20:00:00,2022-05-04 21:00:00,253,0,210,7,0,2905,3375,18070
2022-05-04 21:00:00,2022-05-04 22:00:00,251,0,195,0,0,3117,3563,17063
2022-05-04 22:00:00,2022-05-04 23:00:00,248,0,194,0,0,3003,3445,16493
2022-05-04 23:00:00,2022-05-05 00:00:00,249,0,194,0,0,2692,3135,16206
2022-05-05 00:00:00,2022-05-05 01:00:00,249,0,194,0,0,2428,2871,16368
2022-05-05 01:00:00,2022-05-05 02:00:00,249,0,194,0,54,2180,2677,16539
2022-05-05 02:00:00,2022-05-05 03:00:00,250,0,194,47,131,1933,2555,16778
2022-05-05 03:00:00,2022-05-05 04:00:00,250,0,194,53,403,1691,2591,18918
2022-05-05 04:00:00,2022-05-05 05:00:00,249,58,193,7,1120,1079,2706,20613
2022-05-05 05:00:00,2022-05-05 06:00:00,248,210,193,0,2111,563,3325,21078
2022-05-05 06:00:00,2022-05-05 07:00:00,248,66,197,0,3061,311,3883,20934
2022-05-05 07:00:00,2022-05-05 08:00:00,249,65,198,0,3588,248,4348,20229
2022-05-05 08:00:00,2022-05-05 09:00:00,248,8,194,0,4231,314,4995,20517
2022-05-05 09:00:00,2022-05-05 10:00:00,249,0,194,0,4502,436,5381,20833
2022-05-05 10:00:00,2022-05-05 11:00:00,252,0,197,0,4442,349,5240,21097
2022-05-05 11:00:00,2022-05-05 12:00:00,249,0,193,0,3804,270,4516,21032
2022-05-05 12:00:00,2022-05-05 13:00:00,248,40,190,0,3267,396,4141,21571
2022-05-05 13:00:00,2022-05-05 14:00:00,249,155,191,0,2659,524,3778,21811
2022-05-05 14:00:00,2022-05-05 15:00:00,252,113,190,0,1674,623,2852,21534
2022-05-05 15:00:00,2022-05-05 16:00:00,260,442,237,47,753,820,2559,21389
2022-05-05 16:00:00,2022-05-05 17:00:00,258,721,249,53,283,1166,2730,21953
2022-05-05 17:00:00,2022-05-05 18:00:00,261,619,258,53,57,1138,2386,22249
2022-05-05 18:00:00,2022-05-05 19:00:00,261,543,245,53,2,1244,2348,21419
2022-05-05 19:00:00,2022-05-05 20:00:00,260,43,236,53,0,991,1583,19657
2022-05-05 20:00:00,2022-05-05 21:00:00,253,3,217,53,0,835,1361,18315
2022-05-05 21:00:00,2022-05-05 22:00:00,251,0,196,7,0,802,1256,17382
2022-05-05 22:00:00,2022-05-05 23:00:00,251,0,195,0,0,831,1277,16696
2022-05-05 23:00:00,2022-05-06 00:00:00,193,0,194,0,0,895,1282,16389
2022-05-06 00:00:00,2022-05-06 01:00:00,173,0,194,0,0,868,1235,16426
2022-05-06 01:00:00,2022-05-06 02:00:00,171,0,193,0,9,908,1281,16642
2022-05-06 02:00:00,2022-05-06 03:00:00,184,0,193,47,57,793,1274,16797
2022-05-06 03:00:00,2022-05-06 04:00:00,233,18,193,53,282,620,1399,19102
2022-05-06 04:00:00,2022-05-06 05:00:00,249,109,193,7,896,413,1867,20957
2022-05-06 05:00:00,2022-05-06 06:00:00,244,283,199,0,1854,255,2835,22071
2022-05-06 06:00:00,2022-05-06 07:00:00,245,145,211,0,2428,210,3239,21949
2022-05-06 07:00:00,2022-05-06 08:00:00,244,42,206,0,3019,271,3782,21409
2022-05-06 08:00:00,2022-05-06 09:00:00,246,0,197,0,3660,404,4507,21813
2022-05-06 09:00:00,2022-05-06 10:00:00,246,0,198,0,3540,530,4514,21543
2022-05-06 10:00:00,2022-05-06 11:00:00,245,0,198,0,3474,585,4502,21361
2022-05-06 11:00:00,2022-05-06 12:00:00,243,0,197,0,3347,652,4439,21257
2022-05-06 12:00:00,2022-05-06 13:00:00,244,0,196,0,3127,723,4290,21466
2022-05-06 13:00:00,2022-05-06 14:00:00,245,0,203,0,2577,662,3687,21446
2022-05-06 14:00:00,2022-05-06 15:00:00,244,25,210,0,1908,577,2964,21509
2022-05-06 15:00:00,2022-05-06 16:00:00,248,330,238,47,1134,445,2442,21519
2022-05-06 16:00:00,2022-05-06 17:00:00,258,742,260,53,455,329,2097,21653
2022-05-06 17:00:00,2022-05-06 18:00:00,256,932,264,53,100,362,1967,21956
2022-05-06 18:00:00,2022-05-06 19:00:00,255,586,259,53,3,368,1524,21358
2022-05-06 19:00:00,2022-05-06 20:00:00,249,43,225,53,0,363,933,19805
2022-05-06 20:00:00,2022-05-06 21:00:00,247,0,213,53,0,404,917,18460
2022-05-06 21:00:00,2022-05-06 22:00:00,247,91,191,53,0,495,1077,17362
2022-05-06 22:00:00,2022-05-06 23:00:00,247,9,190,53,0,689,1188,16717
2022-05-06 23:00:00,2022-05-07 00:00:00,247,0,190,7,0,884,1328,16324
2022-05-07 00:00:00,2022-05-07 01:00:00,247,0,190,0,0,991,1428,16212
2022-05-07 01:00:00,2022-05-07 02:00:00,247,0,189,0,9,1034,1479,16019
2022-05-07 02:00:00,2022-05-07 03:00:00,246,19,188,47,77,1108,1685,15604
2022-05-07 03:00:00,2022-05-07 04:00:00,248,65,186,53,445,1040,2037,16277
2022-05-07 04:00:00,2022-05-07 05:00:00,249,75,186,7,1285,808,2610,17529
2022-05-07 05:00:00,2022-05-07 06:00:00,252,178,195,0,2270,467,3362,18493
2022-05-07 06:00:00,2022-05-07 07:00:00,252,66,199,0,3265,367,4149,19045
2022-05-07 07:00:00,2022-05-07 08:00:00,252,0,199,0,3820,534,4805,19093
2022-05-07 08:00:00,2022-05-07 09:00:00,251,0,201,0,3915,713,5080,19023
2022-05-07 09:00:00,2022-05-07 10:00:00,253,0,195,0,3864,834,5146,18785
2022-05-07 10:00:00,2022-05-07 11:00:00,252,0,188,0,3859,958,5257,18524
2022-05-07 11:00:00,2022-05-07 12:00:00,252,0,188,0,3440,1000,4880,17962
2022-05-07 12:00:00,2022-05-07 13:00:00,253,0,188,0,2992,1087,4520,17913
2022-05-07 13:00:00,2022-05-07 14:00:00,253,0,195,0,2667,899,4014,18131
2022-05-07 14:00:00,2022-05-07 15:00:00,251,99,209,0,1990,831,3380,18292
2022-05-07 15:00:00,2022-05-07 16:00:00,253,321,214,47,1217,886,2938,18510
2022-05-07 16:00:00,2022-05-07 17:00:00,259,784,213,53,512,717,2538,18685
2022-05-07 17:00:00,2022-05-07 18:00:00,260,1038,215,53,92,387,2045,19016
2022-05-07 18:00:00,2022-05-07 19:00:00,262,1035,216,53,3,407,1976,18741
2022-05-07 19:00:00,2022-05-07 20:00:00,254,479,215,53,0,429,1430,17641
2022-05-07 20:00:00,2022-05-07 21:00:00,250,268,198,53,0,420,1189,16295
2022-05-07 21:00:00,2022-05-07 22:00:00,251,4,188,53,0,517,1013,15213
2022-05-07 22:00:00,2022-05-07 23:00:00,251,0,186,53,0,606,1096,14621
2022-05-07 23:00:00,2022-05-08 00:00:00,250,0,186,53,0,632,1121,14280
2022-05-08 00:00:00,2022-05-08 01:00:00,247,0,186,7,0,709,1149,14112
2022-05-08 01:00:00,2022-05-08 02:00:00,247,0,186,0,8,753,1194,13891
2022-05-08 02:00:00,2022-05-08 03:00:00,252,0,185,0,66,663,1166,13411
2022-05-08 03:00:00,2022-05-08 04:00:00,252,0,184,0,374,515,1325,13678
2022-05-08 04:00:00,2022-05-08 05:00:00,252,4,184,0,1012,291,1743,14288
2022-05-08 05:00:00,2022-05-08 06:00:00,251,6,190,0,1912,220,2579,14895
2022-05-08 06:00:00,2022-05-08 07:00:00,250,98,194,0,2844,391,3777,15267
2022-05-08 07:00:00,2022-05-08 08:00:00,251,0,183,0,3625,626,4685,15471
2022-05-08 08:00:00,2022-05-08 09:00:00,249,0,183,0,4074,781,5287,15536
2022-05-08 09:00:00,2022-05-08 10:00:00,250,0,182,0,4056,816,5304,15545
2022-05-08 10:00:00,2022-05-08 11:00:00,251,0,179,0,4317,848,5595,15992
2022-05-08 11:00:00,2022-05-08 12:00:00,250,0,179,0,4107,945,5481,15771
2022-05-08 12:00:00,2022-05-08 13:00:00,250,0,178,0,3578,1080,5086,15706
2022-05-08 13:00:00,2022-05-08 14:00:00,250,0,180,0,2598,1188,4216,15431
2022-05-08 14:00:00,2022-05-08 15:00:00,250,9,186,47,1753,1494,3739,15935
2022-05-08 15:00:00,2022-05-08 16:00:00,250,270,203,53,1162,1675,3613,16810
2022-05-08 16:00:00,2022-05-08 17:00:00,250,549,215,53,473,1575,3115,17352
2022-05-08 17:00:00,2022-05-08 18:00:00,250,804,244,53,110,1575,3036,17970
2022-05-08 18:00:00,2022-05-08 19:00:00,251,734,248,53,2,1861,3149,17853
2022-05-08 19:00:00,2022-05-08 20:00:00,251,186,233,53,0,2187,2910,16969
2022-05-08 20:00:00,2022-05-08 21:00:00,249,0,207,53,0,2503,3012,15923
2022-05-08 21:00:00,2022-05-08 22:00:00,250,0,178,7,0,2400,2835,14851
2022-05-08 22:00:00,2022-05-08 23:00:00,250,0,177,0,0,2520,2947,14550
2022-05-08 23:00:00,2022-05-09 00:00:00,249,0,177,0,0,2603,3029,14271
2022-05-09 00:00:00,2022-05-09 01:00:00,248,0,177,0,0,2575,3000,14328
2022-05-09 01:00:00,2022-05-09 02:00:00,249,0,177,0,11,2605,3042,14595
2022-05-09 02:00:00,2022-05-09 03:00:00,249,0,177,0,74,2395,2895,15119
2022-05-09 03:00:00,2022-05-09 04:00:00,250,14,177,47,495,1907,2890,17957
2022-05-09 04:00:00,2022-05-09 05:00:00,250,26,180,53,1638,908,3055,20145
2022-05-09 05:00:00,2022-05-09 06:00:00,249,51,200,53,2897,411,3861,20825
2022-05-09 06:00:00,2022-05-09 07:00:00,251,78,200,7,4149,323,5008,20721
2022-05-09 07:00:00,2022-05-09 08:00:00,252,0,197,0,5123,333,5905,20599
2022-05-09 08:00:00,2022-05-09 09:00:00,249,0,196,0,5406,356,6207,20755
2022-05-09 09:00:00,2022-05-09 10:00:00,251,0,195,0,5511,302,6259,20852
2022-05-09 10:00:00,2022-05-09 11:00:00,249,0,195,0,5269,241,5954,20426
2022-05-09 11:00:00,2022-05-09 12:00:00,249,0,178,0,5105,282,5814,20285
2022-05-09 12:00:00,2022-05-09 13:00:00,249,0,177,0,4626,342,5394,20545
2022-05-09 13:00:00,2022-05-09 14:00:00,251,0,184,0,3877,382,4694,20770
2022-05-09 14:00:00,2022-05-09 15:00:00,250,2,191,46,2646,429,3564,20923
2022-05-09 15:00:00,2022-05-09 16:00:00,261,348,212,53,1418,538,2830,21037
2022-05-09 16:00:00,2022-05-09 17:00:00,262,696,221,53,605,714,2551,21518
2022-05-09 17:00:00,2022-05-09 18:00:00,260,650,239,53,144,1177,2523,21998
2022-05-09 18:00:00,2022-05-09 19:00:00,260,260,237,53,2,1738,2550,21348
2022-05-09 19:00:00,2022-05-09 20:00:00,262,21,214,53,0,2310,2860,19588
2022-05-09 20:00:00,2022-05-09 21:00:00,253,1,183,53,0,2776,3266,18067
2022-05-09 21:00:00,2022-05-09 22:00:00,249,0,179,53,0,3102,3583,16916
2022-05-09 22:00:00,2022-05-09 23:00:00,251,0,180,53,0,3335,3819,16306
2022-05-09 23:00:00,2022-05-10 00:00:00,249,0,180,7,0,3408,3844,16033
2022-05-10 00:00:00,2022-05-10 01:00:00,248,0,180,0,0,3351,3779,16074
2022-05-10 01:00:00,2022-05-10 02:00:00,249,0,180,0,10,3308,3747,16193
2022-05-10 02:00:00,2022-05-10 03:00:00,250,0,180,46,81,3246,3803,16452
2022-05-10 03:00:00,2022-05-10 04:00:00,249,46,180,52,560,2746,3833,18703
2022-05-10 04:00:00,2022-05-10 05:00:00,249,176,180,52,1834,1529,4020,20608
2022-05-10 05:00:00,2022-05-10 06:00:00,250,255,183,7,3203,640,4538,21173
2022-05-10 06:00:00,2022-05-10 07:00:00,249,187,184,0,4291,524,5435,20797
2022-05-10 07:00:00,2022-05-10 08:00:00,249,144,191,0,5081,651,6316,20189
2022-05-10 08:00:00,2022-05-10 09:00:00,254,0,192,0,5495,822,6763,20209
2022-05-10 09:00:00,2022-05-10 10:00:00,253,0,183,0,5673,825,6934,20246
2022-05-10 10:00:00,2022-05-10 11:00:00,239,0,181,0,5767,869,7056,20261
2022-05-10 11:00:00,2022-05-10 12:00:00,242,0,179,0,5458,911,6790,20200
2022-05-10 12:00:00,2022-05-10 13:00:00,251,0,182,0,4832,954,6219,20553
2022-05-10 13:00:00,2022-05-10 14:00:00,252,0,187,0,3938,1031,5408,20870
2022-05-10 14:00:00,2022-05-10 15:00:00,250,0,196,0,2787,1014,4247,21234
2022-05-10 15:00:00,2022-05-10 16:00:00,252,442,233,0,1555,901,3383,21530
2022-05-10 16:00:00,2022-05-10 17:00:00,252,787,254,46,576,995,2910,21782
2022-05-10 17:00:00,2022-05-10 18:00:00,251,843,256,52,110,1576,3088,22136
2022-05-10 18:00:00,2022-05-10 19:00:00,251,419,247,52,5,2511,3485,21455
2022-05-10 19:00:00,2022-05-10 20:00:00,254,220,217,52,0,3179,3922,19866
2022-05-10 20:00:00,2022-05-10 21:00:00,251,52,193,52,0,3491,4039,18203
2022-05-10 21:00:00,2022-05-10 22:00:00,250,2,175,7,0,3672,4106,16957
2022-05-10 22:00:00,2022-05-10 23:00:00,248,0,170,0,0,3630,4048,16416
2022-05-10 23:00:00,2022-05-11 00:00:00,249,0,170,0,0,3224,3643,16079
2022-05-11 00:00:00,2022-05-11 01:00:00,249,0,170,0,0,2824,3243,16080
2022-05-11 01:00:00,2022-05-11 02:00:00,249,0,170,0,12,2576,3007,16147
2022-05-11 02:00:00,2022-05-11 03:00:00,252,0,166,0,87,2331,2836,16386
2022-05-11 03:00:00,2022-05-11 04:00:00,251,22,168,0,418,2034,2893,18604
2022-05-11 04:00:00,2022-05-11 05:00:00,250,69,173,0,1176,1510,3178,20534
2022-05-11 05:00:00,2022-05-11 06:00:00,250,362,202,0,2213,803,3830,21312
2022-05-11 06:00:00,2022-05-11 07:00:00,248,24,203,0,3128,497,4100,21305
2022-05-11 07:00:00,2022-05-11 08:00:00,251,68,204,0,3711,508,4742,20979
2022-05-11 08:00:00,2022-05-11 09:00:00,249,0,202,0,4244,635,5330,21091
2022-05-11 09:00:00,2022-05-11 10:00:00,250,0,175,0,4332,923,5680,21401
2022-05-11 10:00:00,2022-05-11 11:00:00,251,0,175,0,4302,1141,5869,21585
2022-05-11 11:00:00,2022-05-11 12:00:00,250,0,173,0,4053,1432,5908,21431
2022-05-11 12:00:00,2022-05-11 13:00:00,250,0,171,0,3494,1697,5612,21517
2022-05-11 13:00:00,2022-05-11 14:00:00,259,0,179,0,2892,1674,5004,21538
2022-05-11 14:00:00,2022-05-11 15:00:00,259,164,188,0,2169,1700,4480,21553
2022-05-11 15:00:00,2022-05-11 16:00:00,259,701,191,46,1434,1652,4283,21721
2022-05-11 16:00:00,2022-05-11 17:00:00,260,1119,200,53,554,1539,3725,21863
2022-05-11 17:00:00,2022-05-11 18:00:00,260,902,214,52,131,2175,3734,22284
2022-05-11 18:00:00,2022-05-11 19:00:00,260,406,214,52,4,2961,3897,21663
2022-05-11 19:00:00,2022-05-11 20:00:00,259,25,213,52,0,3377,3926,19910
2022-05-11 20:00:00,2022-05-11 21:00:00,260,0,193,52,0,3650,4155,18495
2022-05-11 21:00:00,2022-05-11 22:00:00,254,0,176,7,0,3644,4081,17357
2022-05-11 22:00:00,2022-05-11 23:00:00,250,0,174,0,0,3427,3851,16544
2022-05-11 23:00:00,2022-05-12 00:00:00,250,0,175,0,0,3381,3806,16174
2022-05-12 00:00:00,2022-05-12 01:00:00,248,0,175,0,0,2959,3382,16151
2022-05-12 01:00:00,2022-05-12 02:00:00,249,0,175,0,14,3204,3642,16165
2022-05-12 02:00:00,2022-05-12 03:00:00,249,0,170,0,81,3651,4151,16401
2022-05-12 03:00:00,2022-05-12 04:00:00,250,69,168,0,448,4089,5024,18825
2022-05-12 04:00:00,2022-05-12 05:00:00,250,332,182,0,1306,4716,6786,20756
2022-05-12 05:00:00,2022-05-12 06:00:00,250,411,194,0,2218,5316,8389,21467
2022-05-12 06:00:00,2022-05-12 07:00:00,249,169,183,0,2914,5594,9109,21219
2022-05-12 07:00:00,2022-05-12 08:00:00,249,0,180,0,3493,5960,9882,20833
2022-05-12 08:00:00,2022-05-12 09:00:00,252,0,180,0,3834,6080,10346,20956
2022-05-12 09:00:00,2022-05-12 10:00:00,251,0,177,0,3938,6199,10565,20862
2022-05-12 10:00:00,2022-05-12 11:00:00,249,0,177,0,4458,6122,11006,20982
2022-05-12 11:00:00,2022-05-12 12:00:00,248,0,172,0,4245,5895,10560,20449
2022-05-12 12:00:00,2022-05-12 13:00:00,250,0,171,0,3816,5585,9822,20475
2022-05-12 13:00:00,2022-05-12 14:00:00,251,0,172,0,3326,5177,8926,20787
2022-05-12 14:00:00,2022-05-12 15:00:00,251,0,181,0,2635,4609,7676,21342
2022-05-12 15:00:00,2022-05-12 16:00:00,250,38,198,46,1442,3740,5714,21392
2022-05-12 16:00:00,2022-05-12 17:00:00,235,290,209,53,615,2666,4068,21761
2022-05-12 17:00:00,2022-05-12 18:00:00,233,672,238,52,163,1913,3271,22099
2022-05-12 18:00:00,2022-05-12 19:00:00,234,769,231,52,5,1694,2985,21580
2022-05-12 19:00:00,2022-05-12 20:00:00,235,356,204,52,0,1581,2428,19866
2022-05-12 20:00:00,2022-05-12 21:00:00,234,14,183,52,0,1526,2009,18532
2022-05-12 21:00:00,2022-05-12 22:00:00,233,0,171,7,0,1478,1889,17313
2022-05-12 22:00:00,2022-05-12 23:00:00,229,0,168,0,0,1440,1837,16645
2022-05-12 23:00:00,2022-05-13 00:00:00,232,0,168,0,0,1473,1873,16305
2022-05-13 00:00:00,2022-05-13 01:00:00,232,0,168,0,0,1476,1876,16244
2022-05-13 01:00:00,2022-05-13 02:00:00,232,0,168,0,22,1470,1892,16201
2022-05-13 02:00:00,2022-05-13 03:00:00,233,0,165,0,112,1490,2000,16426
2022-05-13 03:00:00,2022-05-13 04:00:00,234,92,164,0,509,1332,2331,18691
2022-05-13 04:00:00,2022-05-13 05:00:00,234,367,165,0,1336,995,3097,20643
2022-05-13 05:00:00,2022-05-13 06:00:00,234,187,168,0,2274,818,3681,21206
2022-05-13 06:00:00,2022-05-13 07:00:00,234,2,175,0,3366,1083,4860,21282
2022-05-13 07:00:00,2022-05-13 08:00:00,235,0,184,0,4012,1438,5869,21040
2022-05-13 08:00:00,2022-05-13 09:00:00,234,0,184,0,4262,1894,6574,21659
2022-05-13 09:00:00,2022-05-13 10:00:00,233,0,183,0,4223,2317,6956,21731
2022-05-13 10:00:00,2022-05-13 11:00:00,234,0,182,0,3980,2496,6892,21484
2022-05-13 11:00:00,2022-05-13 12:00:00,235,0,180,0,3655,2460,6530,21415
2022-05-13 12:00:00,2022-05-13 13:00:00,235,0,179,0,3087,2452,5953,21630
2022-05-13 13:00:00,2022-05-13 14:00:00,235,0,180,0,2369,2109,4893,21446
2022-05-13 14:00:00,2022-05-13 15:00:00,234,0,183,0,1719,2387,4523,21459
2022-05-13 15:00:00,2022-05-13 16:00:00,233,17,185,0,1207,2606,4248,21579
2022-05-13 16:00:00,2022-05-13 17:00:00,233,407,190,46,473,2747,4096,21617
2022-05-13 17:00:00,2022-05-13 18:00:00,235,604,204,53,98,2434,3628,21739
2022-05-13 18:00:00,2022-05-13 19:00:00,234,579,215,52,6,2682,3768,21109
2022-05-13 19:00:00,2022-05-13 20:00:00,234,317,219,52,0,2737,3559,19562
2022-05-13 20:00:00,2022-05-13 21:00:00,234,3,201,52,0,2675,3165,18164
2022-05-13 21:00:00,2022-05-13 22:00:00,235,0,177,7,0,3036,3455,17094
2022-05-13 22:00:00,2022-05-13 23:00:00,235,0,173,0,0,3232,3640,16357
2022-05-13 23:00:00,2022-05-14 00:00:00,234,0,172,0,0,3438,3844,15969
2022-05-14 00:00:00,2022-05-14 01:00:00,233,0,172,0,0,3364,3769,15778
2022-05-14 01:00:00,2022-05-14 02:00:00,234,0,172,0,11,3501,3918,15564
2022-05-14 02:00:00,2022-05-14 03:00:00,235,0,171,0,87,3611,4104,15080
2022-05-14 03:00:00,2022-05-14 04:00:00,235,0,171,0,461,3665,4532,15985
2022-05-14 04:00:00,2022-05-14 05:00:00,233,0,171,0,1232,3624,5260,17043
2022-05-14 05:00:00,2022-05-14 06:00:00,234,0,173,0,2195,3803,6405,18144
2022-05-14 06:00:00,2022-05-14 07:00:00,234,153,173,0,2797,4416,7773,18561
2022-05-14 07:00:00,2022-05-14 08:00:00,236,192,172,0,3415,4982,8997,19162
2022-05-14 08:00:00,2022-05-14 09:00:00,234,226,165,0,3496,5308,9429,19075
2022-05-14 09:00:00,2022-05-14 10:00:00,235,185,164,0,3544,5411,9539,18857
2022-05-14 10:00:00,2022-05-14 11:00:00,234,0,164,0,3694,5502,9594,18627
2022-05-14 11:00:00,2022-05-14 12:00:00,233,0,162,0,3548,5348,9291,18107
2022-05-14 12:00:00,2022-05-14 13:00:00,234,2,160,0,3089,5195,8680,17735
2022-05-14 13:00:00,2022-05-14 14:00:00,235,0,159,0,2814,5144,8352,17956
2022-05-14 14:00:00,2022-05-14 15:00:00,235,0,165,0,1920,4887,7207,17845
2022-05-14 15:00:00,2022-05-14 16:00:00,234,0,174,0,1223,4206,5837,18079
2022-05-14 16:00:00,2022-05-14 17:00:00,233,323,183,46,527,3569,4881,18322
2022-05-14 17:00:00,2022-05-14 18:00:00,233,748,193,53,129,3095,4451,18578
2022-05-14 18:00:00,2022-05-14 19:00:00,234,610,215,53,6,2964,4082,18348
2022-05-14 19:00:00,2022-05-14 20:00:00,234,533,228,52,0,3105,4152,17353
2022-05-14 20:00:00,2022-05-14 21:00:00,234,86,227,7,0,3297,3851,16185
2022-05-14 21:00:00,2022-05-14 22:00:00,233,11,199,0,0,3249,3692,15214
2022-05-14 22:00:00,2022-05-14 23:00:00,233,4,194,0,0,3121,3552,14490
2022-05-14 23:00:00,2022-05-15 00:00:00,236,0,194,0,0,3032,3462,13988
2022-05-15 00:00:00,2022-05-15 01:00:00,234,0,194,0,0,2933,3361,13772
2022-05-15 01:00:00,2022-05-15 02:00:00,233,0,194,0,12,2863,3302,13468
2022-05-15 02:00:00,2022-05-15 03:00:00,234,0,192,0,102,2657,3185,13049
2022-05-15 03:00:00,2022-05-15 04:00:00,235,0,192,0,609,1992,3028,13413
2022-05-15 04:00:00,2022-05-15 05:00:00,233,0,192,0,1768,1358,3551,14200
2022-05-15 05:00:00,2022-05-15 06:00:00,233,124,171,0,3089,1201,4818,14834
2022-05-15 06:00:00,2022-05-15 07:00:00,235,211,168,0,4140,1279,6033,15104
2022-05-15 07:00:00,2022-05-15 08:00:00,235,190,165,0,5025,1537,7152,15612
2022-05-15 08:00:00,2022-05-15 09:00:00,234,7,159,0,5294,1814,7508,15627
2022-05-15 09:00:00,2022-05-15 10:00:00,233,0,156,0,5178,1991,7558,15293
2022-05-15 10:00:00,2022-05-15 11:00:00,232,0,156,0,5298,2067,7753,15376
2022-05-15 11:00:00,2022-05-15 12:00:00,232,0,152,0,5141,1845,7370,14963
2022-05-15 12:00:00,2022-05-15 13:00:00,234,0,151,0,4847,1725,6957,14987
2022-05-15 13:00:00,2022-05-15 14:00:00,235,0,151,0,4083,1597,6066,15221
2022-05-15 14:00:00,2022-05-15 15:00:00,236,0,152,0,2986,1444,4818,15947
2022-05-15 15:00:00,2022-05-15 16:00:00,234,126,154,46,1722,1178,3460,16616
2022-05-15 16:00:00,2022-05-15 17:00:00,234,549,160,53,653,921,2570,17175
2022-05-15 17:00:00,2022-05-15 18:00:00,234,624,179,53,157,876,2123,17513
2022-05-15 18:00:00,2022-05-15 19:00:00,233,594,189,53,6,967,2042,17650
2022-05-15 19:00:00,2022-05-15 20:00:00,233,573,187,53,0,1009,2055,16896
2022-05-15 20:00:00,2022-05-15 21:00:00,234,121,169,7,0,1024,1555,15919
2022-05-15 21:00:00,2022-05-15 22:00:00,231,1,160,0,0,944,1336,15084
2022-05-15 22:00:00,2022-05-15 23:00:00,234,0,160,0,0,776,1170,14659
2022-05-15 23:00:00,2022-05-16 00:00:00,235,0,160,0,0,658,1053,14411
2022-05-16 00:00:00,2022-05-16 01:00:00,235,0,160,0,0,586,981,14550
2022-05-16 01:00:00,2022-05-16 02:00:00,233,0,160,0,12,473,878,14675
2022-05-16 02:00:00,2022-05-16 03:00:00,235,17,158,0,110,449,969,15149
2022-05-16 03:00:00,2022-05-16 04:00:00,234,29,158,0,645,408,1474,17824
2022-05-16 04:00:00,2022-05-16 05:00:00,234,204,163,0,1918,212,2731,20075
2022-05-16 05:00:00,2022-05-16 06:00:00,233,95,165,47,3254,64,3858,20765
2022-05-16 06:00:00,2022-05-16 07:00:00,234,0,166,53,4338,61,4852,20720
2022-05-16 07:00:00,2022-05-16 08:00:00,232,0,163,7,5126,90,5618,20424
2022-05-16 08:00:00,2022-05-16 09:00:00,193,0,163,0,5507,133,5996,20599
2022-05-16 09:00:00,2022-05-16 10:00:00,231,0,160,0,5627,168,6186,20710
2022-05-16 10:00:00,2022-05-16 11:00:00,235,0,160,0,5457,231,6083,20652
2022-05-16 11:00:00,2022-05-16 12:00:00,235,0,155,0,5059,299,5748,20449
2022-05-16 12:00:00,2022-05-16 13:00:00,235,0,154,0,4570,397,5356,20766
2022-05-16 13:00:00,2022-05-16 14:00:00,234,0,156,0,3777,474,4641,20887
2022-05-16 14:00:00,2022-05-16 15:00:00,234,0,160,0,2762,568,3724,21147
2022-05-16 15:00:00,2022-05-16 16:00:00,233,232,185,46,1518,631,2845,21206
2022-05-16 16:00:00,2022-05-16 17:00:00,234,568,210,53,615,781,2461,21634
2022-05-16 17:00:00,2022-05-16 18:00:00,233,656,226,53,133,1164,2465,21826
2022-05-16 18:00:00,2022-05-16 19:00:00,235,334,229,52,6,1728,2584,21356
2022-05-16 19:00:00,2022-05-16 20:00:00,235,10,208,52,0,2042,2547,19689
2022-05-16 20:00:00,2022-05-16 21:00:00,232,0,164,7,0,2219,2622,18138
2022-05-16 21:00:00,2022-05-16 22:00:00,234,0,157,0,0,2158,2549,17038
2022-05-16 22:00:00,2022-05-16 23:00:00,234,0,154,0,0,1957,2345,16429
2022-05-16 23:00:00,2022-05-17 00:00:00,234,0,154,0,0,1743,2131,16100
2022-05-17 00:00:00,2022-05-17 01:00:00,232,0,154,0,0,1641,2027,16124
2022-05-17 01:00:00,2022-05-17 02:00:00,233,0,155,0,12,1779,2179,16040
2022-05-17 02:00:00,2022-05-17 03:00:00,234,0,153,0,124,1844,2355,16282
2022-05-17 03:00:00,2022-05-17 04:00:00,234,0,152,0,554,1418,2358,18558
2022-05-17 04:00:00,2022-05-17 05:00:00,234,71,152,0,1529,937,2923,20449
2022-05-17 05:00:00,2022-05-17 06:00:00,234,222,150,0,2503,790,3899,21292
2022-05-17 06:00:00,2022-05-17 07:00:00,233,94,149,0,3279,791,4546,21288
2022-05-17 07:00:00,2022-05-17 08:00:00,234,0,149,0,3927,688,4998,21042
2022-05-17 08:00:00,2022-05-17 09:00:00,235,0,150,0,4145,689,5219,21331
2022-05-17 09:00:00,2022-05-17 10:00:00,235,0,147,0,4230,768,5380,21470
2022-05-17 10:00:00,2022-05-17 11:00:00,235,0,146,0,4232,1067,5680,21291
2022-05-17 11:00:00,2022-05-17 12:00:00,235,0,146,0,3937,1532,5850,20912
2022-05-17 12:00:00,2022-05-17 13:00:00,232,0,146,0,3788,2111,6277,21297
2022-05-17 13:00:00,2022-05-17 14:00:00,232,0,149,0,3120,2573,6074,21255
2022-05-17 14:00:00,2022-05-17 15:00:00,235,0,152,0,2208,2855,5450,21023
2022-05-17 15:00:00,2022-05-17 16:00:00,236,49,186,47,1318,3018,4854,20957
2022-05-17 16:00:00,2022-05-17 17:00:00,233,199,200,53,597,3146,4428,21489
2022-05-17 17:00:00,2022-05-17 18:00:00,234,337,215,53,167,3015,4021,21701
2022-05-17 18:00:00,2022-05-17 19:00:00,235,319,208,53,15,3213,4043,21231
2022-05-17 19:00:00,2022-05-17 20:00:00,234,97,187,53,0,3297,3868,19676
2022-05-17 20:00:00,2022-05-17 21:00:00,232,3,155,7,0,3060,3457,18147
2022-05-17 21:00:00,2022-05-17 22:00:00,233,0,150,0,0,2900,3283,17132
2022-05-17 22:00:00,2022-05-17 23:00:00,232,0,150,0,0,2630,3012,16612
2022-05-17 23:00:00,2022-05-18 00:00:00,232,0,150,0,0,2293,2675,16394
2022-05-18 00:00:00,2022-05-18 01:00:00,234,0,150,0,0,1963,2347,16313
2022-05-18 01:00:00,2022-05-18 02:00:00,234,0,150,0,21,1687,2092,16276
2022-05-18 02:00:00,2022-05-18 03:00:00,233,0,148,0,137,1403,1921,16585
2022-05-18 03:00:00,2022-05-18 04:00:00,235,70,148,0,793,990,2236,18982
2022-05-18 04:00:00,2022-05-18 05:00:00,234,10,148,0,2233,472,3097,20867
2022-05-18 05:00:00,2022-05-18 06:00:00,235,0,157,0,3797,355,4544,21553
2022-05-18 06:00:00,2022-05-18 07:00:00,233,0,171,0,4994,299,5697,21343
2022-05-18 07:00:00,2022-05-18 08:00:00,235,0,167,0,5904,273,6579,20982
2022-05-18 08:00:00,2022-05-18 09:00:00,235,0,164,0,6423,290,7112,21214
2022-05-18 09:00:00,2022-05-18 10:00:00,234,0,161,0,6581,318,7294,21136
2022-05-18 10:00:00,2022-05-18 11:00:00,234,11,161,0,6561,295,7262,21062
2022-05-18 11:00:00,2022-05-18 12:00:00,235,11,161,0,6326,302,7035,20880
2022-05-18 12:00:00,2022-05-18 13:00:00,233,0,154,0,5696,319,6402,21145
2022-05-18 13:00:00,2022-05-18 14:00:00,233,0,146,0,4691,315,5385,21230
2022-05-18 14:00:00,2022-05-18 15:00:00,235,4,153,0,3375,316,4083,21460
2022-05-18 15:00:00,2022-05-18 16:00:00,234,209,168,47,1920,314,2892,21547
2022-05-18 16:00:00,2022-05-18 17:00:00,233,717,204,53,681,360,2248,21675
2022-05-18 17:00:00,2022-05-18 18:00:00,235,744,216,53,196,573,2017,21831
2022-05-18 18:00:00,2022-05-18 19:00:00,232,370,213,53,13,1067,1948,21384
2022-05-18 19:00:00,2022-05-18 20:00:00,235,76,173,53,0,1720,2257,19764
2022-05-18 20:00:00,2022-05-18 21:00:00,234,10,153,53,0,2227,2677,18248
2022-05-18 21:00:00,2022-05-18 22:00:00,237,0,144,7,0,2451,2839,17026
2022-05-18 22:00:00,2022-05-18 23:00:00,233,0,144,0,0,2713,3090,16415
2022-05-18 23:00:00,2022-05-19 00:00:00,232,0,144,0,0,3000,3376,16146
2022-05-19 00:00:00,2022-05-19 01:00:00,235,0,144,0,0,3206,3585,16136
2022-05-19 01:00:00,2022-05-19 02:00:00,234,0,144,0,27,3392,3797,16104
2022-05-19 02:00:00,2022-05-19 03:00:00,236,0,142,0,170,3564,4112,16260
2022-05-19 03:00:00,2022-05-19 04:00:00,234,9,142,0,842,3440,4667,18663
2022-05-19 04:00:00,2022-05-19 05:00:00,231,1,143,0,2129,2232,4736,20559
2022-05-19 05:00:00,2022-05-19 06:00:00,235,0,149,0,3563,988,4935,21207
2022-05-19 06:00:00,2022-05-19 07:00:00,238,0,150,0,4784,790,5962,21223
2022-05-19 07:00:00,2022-05-19 08:00:00,234,0,142,0,5540,796,6712,20837
2022-05-19 08:00:00,2022-05-19 09:00:00,235,0,139,0,6003,813,7190,21052
2022-05-19 09:00:00,2022-05-19 10:00:00,233,0,136,0,6220,857,7446,21182
2022-05-19 10:00:00,2022-05-19 11:00:00,232,0,136,0,6121,760,7249,21163
2022-05-19 11:00:00,2022-05-19 12:00:00,236,0,135,0,5757,669,6797,21052
2022-05-19 12:00:00,2022-05-19 13:00:00,235,0,136,0,5101,660,6132,21305
2022-05-19 13:00:00,2022-05-19 14:00:00,239,0,135,0,4094,671,5139,21535
2022-05-19 14:00:00,2022-05-19 15:00:00,239,0,137,0,2820,713,3909,21627
2022-05-19 15:00:00,2022-05-19 16:00:00,237,350,149,47,1620,682,3085,21627
2022-05-19 16:00:00,2022-05-19 17:00:00,237,689,163,53,584,867,2593,21665
2022-05-19 17:00:00,2022-05-19 18:00:00,241,817,168,53,165,1446,2890,21926
2022-05-19 18:00:00,2022-05-19 19:00:00,240,572,167,53,15,2318,3365,21442
2022-05-19 19:00:00,2022-05-19 20:00:00,239,166,165,53,0,3323,3946,19900
2022-05-19 20:00:00,2022-05-19 21:00:00,237,17,151,7,0,3947,4359,18342
2022-05-19 21:00:00,2022-05-19 22:00:00,234,0,142,0,0,4232,4608,17212
2022-05-19 22:00:00,2022-05-19 23:00:00,235,0,142,0,0,4102,4479,16582
2022-05-19 23:00:00,2022-05-20 00:00:00,234,0,142,0,0,3948,4324,16242
2022-05-20 00:00:00,2022-05-20 01:00:00,235,0,142,0,0,3970,4347,16200
2022-05-20 01:00:00,2022-05-20 02:00:00,237,0,142,0,31,4050,4460,16166
2022-05-20 02:00:00,2022-05-20 03:00:00,240,0,139,0,155,4002,4536,16421
2022-05-20 03:00:00,2022-05-20 04:00:00,240,0,137,0,653,3631,4661,18735
2022-05-20 04:00:00,2022-05-20 05:00:00,240,117,137,0,1538,2906,4938,20711
2022-05-20 05:00:00,2022-05-20 06:00:00,239,167,142,0,2502,2366,5416,21444
2022-05-20 06:00:00,2022-05-20 07:00:00,242,63,141,0,2971,2330,5747,21214
2022-05-20 07:00:00,2022-05-20 08:00:00,240,0,141,0,3778,2510,6669,20805
2022-05-20 08:00:00,2022-05-20 09:00:00,238,16,140,0,4597,3153,8144,21274
2022-05-20 09:00:00,2022-05-20 10:00:00,238,16,138,0,4908,3383,8683,21414
2022-05-20 10:00:00,2022-05-20 11:00:00,240,0,137,0,5052,3518,8947,21536
2022-05-20 11:00:00,2022-05-20 12:00:00,239,0,133,0,4688,3404,8464,21190
2022-05-20 12:00:00,2022-05-20 13:00:00,239,0,133,0,4388,3178,7938,21396
2022-05-20 13:00:00,2022-05-20 14:00:00,241,0,133,0,3538,2530,6442,21440
2022-05-20 14:00:00,2022-05-20 15:00:00,240,315,135,0,2371,1875,4936,21430
2022-05-20 15:00:00,2022-05-20 16:00:00,238,826,166,47,1378,1201,3856,21438
2022-05-20 16:00:00,2022-05-20 17:00:00,239,1018,181,53,529,672,2692,21444
2022-05-20 17:00:00,2022-05-20 18:00:00,239,900,198,53,164,552,2106,21601
2022-05-20 18:00:00,2022-05-20 19:00:00,241,808,194,53,14,764,2074,21295
2022-05-20 19:00:00,2022-05-20 20:00:00,240,594,176,53,0,860,1923,19701
2022-05-20 20:00:00,2022-05-20 21:00:00,239,87,146,53,0,997,1522,18324
2022-05-20 21:00:00,2022-05-20 22:00:00,234,0,146,53,0,1290,1723,17020
2022-05-20 22:00:00,2022-05-20 23:00:00,233,0,145,7,0,1546,1931,16234
2022-05-20 23:00:00,2022-05-21 00:00:00,235,0,144,0,0,1931,2310,15723
2022-05-21 00:00:00,2022-05-21 01:00:00,233,0,147,0,0,2297,2677,15458
2022-05-21 01:00:00,2022-05-21 02:00:00,238,0,148,0,29,3010,3425,15216
2022-05-21 02:00:00,2022-05-21 03:00:00,237,112,145,0,97,3754,4345,14900
2022-05-21 03:00:00,2022-05-21 04:00:00,239,385,140,0,304,4564,5632,15610
2022-05-21 04:00:00,2022-05-21 05:00:00,240,604,142,0,802,5453,7241,16744
2022-05-21 05:00:00,2022-05-21 06:00:00,240,516,143,0,1547,6044,8490,18050
2022-05-21 06:00:00,2022-05-21 07:00:00,200,38,145,0,2082,6121,8586,18468
2022-05-21 07:00:00,2022-05-21 08:00:00,170,0,140,0,2500,6182,8992,18376
2022-05-21 08:00:00,2022-05-21 09:00:00,172,0,139,0,3090,6065,9466,18566
2022-05-21 09:00:00,2022-05-21 10:00:00,225,0,137,0,3175,6008,9545,18526
2022-05-21 10:00:00,2022-05-21 11:00:00,241,0,136,0,3193,6119,9689,18357
2022-05-21 11:00:00,2022-05-21 12:00:00,239,0,136,0,2711,6104,9190,17586
2022-05-21 12:00:00,2022-05-21 13:00:00,237,1,136,0,2240,5961,8575,17299
2022-05-21 13:00:00,2022-05-21 14:00:00,239,0,136,0,2121,5727,8223,17614
2022-05-21 14:00:00,2022-05-21 15:00:00,238,62,137,0,1571,5499,7507,17678
2022-05-21 15:00:00,2022-05-21 16:00:00,238,354,140,0,940,4897,6569,17698
2022-05-21 16:00:00,2022-05-21 17:00:00,238,472,145,46,424,4525,5850,17938
2022-05-21 17:00:00,2022-05-21 18:00:00,239,539,172,53,136,4390,5529,18107
2022-05-21 18:00:00,2022-05-21 19:00:00,238,173,184,53,15,4163,4826,18008
2022-05-21 19:00:00,2022-05-21 20:00:00,238,56,174,7,0,4201,4676,16902
2022-05-21 20:00:00,2022-05-21 21:00:00,238,10,141,0,0,4076,4465,15691
2022-05-21 21:00:00,2022-05-21 22:00:00,234,0,139,0,0,4013,4386,14664
2022-05-21 22:00:00,2022-05-21 23:00:00,185,0,139,0,0,3938,4262,14163
2022-05-21 23:00:00,2022-05-22 00:00:00,186,0,139,0,0,3897,4222,13842
2022-05-22 00:00:00,2022-05-22 01:00:00,227,0,139,0,0,3644,4010,13560
2022-05-22 01:00:00,2022-05-22 02:00:00,239,0,139,0,27,3497,3902,13289
2022-05-22 02:00:00,2022-05-22 03:00:00,240,0,138,0,135,3213,3726,12882
2022-05-22 03:00:00,2022-05-22 04:00:00,238,0,139,0,474,2874,3725,13194
2022-05-22 04:00:00,2022-05-22 05:00:00,238,0,139,0,1091,2686,4154,13890
2022-05-22 05:00:00,2022-05-22 06:00:00,239,0,140,0,1788,2919,5086,14868
2022-05-22 06:00:00,2022-05-22 07:00:00,237,100,140,0,2417,3076,5970,15842
2022-05-22 07:00:00,2022-05-22 08:00:00,239,166,140,0,2501,3034,6080,16126
2022-05-22 08:00:00,2022-05-22 09:00:00,238,0,140,0,2573,2972,5923,16473
2022-05-22 09:00:00,2022-05-22 10:00:00,241,0,140,0,2790,3030,6201,16758
2022-05-22 10:00:00,2022-05-22 11:00:00,238,0,140,0,2957,2901,6236,16803
2022-05-22 11:00:00,2022-05-22 12:00:00,238,0,137,0,2724,2823,5922,16258
2022-05-22 12:00:00,2022-05-22 13:00:00,239,0,137,0,2769,2799,5944,16269
2022-05-22 13:00:00,2022-05-22 14:00:00,239,0,137,0,2227,2538,5141,15859
2022-05-22 14:00:00,2022-05-22 15:00:00,239,17,139,0,1831,2273,4499,16228
2022-05-22 15:00:00,2022-05-22 16:00:00,238,152,146,0,1300,1892,3728,16733
2022-05-22 16:00:00,2022-05-22 17:00:00,237,285,176,47,471,1367,2583,16958
2022-05-22 17:00:00,2022-05-22 18:00:00,237,421,192,53,164,1126,2193,17284
2022-05-22 18:00:00,2022-05-22 19:00:00,239,297,196,53,15,1099,1899,17479
2022-05-22 19:00:00,2022-05-22 20:00:00,240,93,186,53,0,1010,1582,16733
2022-05-22 20:00:00,2022-05-22 21:00:00,239,3,180,53,0,969,1444,15734
2022-05-22 21:00:00,2022-05-22 22:00:00,235,0,174,7,0,823,1239,14844
2022-05-22 22:00:00,2022-05-22 23:00:00,233,0,174,0,0,764,1171,14526
2022-05-22 23:00:00,2022-05-23 00:00:00,234,0,174,0,0,750,1158,14392
2022-05-23 00:00:00,2022-05-23 01:00:00,232,0,175,0,0,630,1037,14401
2022-05-23 01:00:00,2022-05-23 02:00:00,237,0,175,0,27,572,1011,14404
2022-05-23 02:00:00,2022-05-23 03:00:00,240,0,173,0,136,616,1165,15051
2022-05-23 03:00:00,2022-05-23 04:00:00,239,112,173,0,606,510,1640,17758
2022-05-23 04:00:00,2022-05-23 05:00:00,239,820,175,0,1729,198,3161,19937
2022-05-23 05:00:00,2022-05-23 06:00:00,236,413,168,0,3059,79,3955,20996
2022-05-23 06:00:00,2022-05-23 07:00:00,239,5,143,0,4093,91,4571,21067
2022-05-23 07:00:00,2022-05-23 08:00:00,239,0,140,0,4915,128,5422,20777
2022-05-23 08:00:00,2022-05-23 09:00:00,240,0,140,0,5404,168,5952,21168
2022-05-23 09:00:00,2022-05-23 10:00:00,240,0,138,0,5490,232,6100,21239
2022-05-23 10:00:00,2022-05-23 11:00:00,239,0,135,0,5222,348,5944,20876
2022-05-23 11:00:00,2022-05-23 12:00:00,239,0,135,0,4854,518,5746,20544
2022-05-23 12:00:00,2022-05-23 13:00:00,238,0,138,0,4355,651,5382,20805
2022-05-23 13:00:00,2022-05-23 14:00:00,238,30,136,0,3578,793,4775,20809
2022-05-23 14:00:00,2022-05-23 15:00:00,240,519,140,0,2621,940,4460,20791
2022-05-23 15:00:00,2022-05-23 16:00:00,240,569,152,47,1639,1079,3726,20910
2022-05-23 16:00:00,2022-05-23 17:00:00,239,655,189,53,641,1336,3113,21234
2022-05-23 17:00:00,2022-05-23 18:00:00,240,720,198,53,219,1851,3281,21413
2022-05-23 18:00:00,2022-05-23 19:00:00,240,396,190,53,15,2722,3616,21157
2022-05-23 19:00:00,2022-05-23 20:00:00,238,10,164,53,0,3506,3971,19575
2022-05-23 20:00:00,2022-05-23 21:00:00,238,0,162,7,0,4024,4431,18098
2022-05-23 21:00:00,2022-05-23 22:00:00,233,0,143,0,0,4359,4735,17060
2022-05-23 22:00:00,2022-05-23 23:00:00,227,0,140,0,0,4571,4938,16420
2022-05-23 23:00:00,2022-05-24 00:00:00,237,0,140,0,0,4637,5014,16042
2022-05-24 00:00:00,2022-05-24 01:00:00,235,0,140,0,0,4664,5039,15999
2022-05-24 01:00:00,2022-05-24 02:00:00,235,0,140,0,36,4734,5145,15925
2022-05-24 02:00:00,2022-05-24 03:00:00,238,0,139,0,183,4541,5101,16196
2022-05-24 03:00:00,2022-05-24 04:00:00,240,0,138,0,627,4053,5058,18472
2022-05-24 04:00:00,2022-05-24 05:00:00,239,70,138,0,1425,3585,5457,20243
2022-05-24 05:00:00,2022-05-24 06:00:00,239,353,137,0,2134,3570,6433,20871
2022-05-24 06:00:00,2022-05-24 07:00:00,238,163,137,0,2683,3674,6895,20843
2022-05-24 07:00:00,2022-05-24 08:00:00,239,0,137,0,3217,3457,7050,20719
2022-05-24 08:00:00,2022-05-24 09:00:00,237,0,137,0,3348,3303,7025,21253
2022-05-24 09:00:00,2022-05-24 10:00:00,239,0,135,0,3096,3055,6525,21348
2022-05-24 10:00:00,2022-05-24 11:00:00,239,0,134,0,3350,2768,6491,21720
2022-05-24 11:00:00,2022-05-24 12:00:00,238,0,131,0,2941,2388,5698,21398
2022-05-24 12:00:00,2022-05-24 13:00:00,238,0,132,0,2292,2108,4770,21500
2022-05-24 13:00:00,2022-05-24 14:00:00,239,213,132,0,1418,1790,3792,21268
2022-05-24 14:00:00,2022-05-24 15:00:00,239,582,133,0,1025,1642,3621,21388
2022-05-24 15:00:00,2022-05-24 16:00:00,239,674,138,47,536,1545,3179,21229
2022-05-24 16:00:00,2022-05-24 17:00:00,238,824,154,53,239,1452,2960,21519
2022-05-24 17:00:00,2022-05-24 18:00:00,237,712,174,53,97,1350,2623,21739
2022-05-24 18:00:00,2022-05-24 19:00:00,238,482,186,53,14,1251,2224,21156
2022-05-24 19:00:00,2022-05-24 20:00:00,237,22,143,53,0,1208,1663,19725
2022-05-24 20:00:00,2022-05-24 21:00:00,240,0,135,7,0,1312,1694,18268
2022-05-24 21:00:00,2022-05-24 22:00:00,241,0,128,0,0,1357,1726,17163
2022-05-24 22:00:00,2022-05-24 23:00:00,241,0,127,0,0,1249,1617,16642
2022-05-24 23:00:00,2022-05-25 00:00:00,239,0,127,0,0,915,1281,16344
2022-05-25 00:00:00,2022-05-25 01:00:00,239,0,127,0,0,716,1082,16333
2022-05-25 01:00:00,2022-05-25 02:00:00,240,0,127,0,28,724,1119,16234
2022-05-25 02:00:00,2022-05-25 03:00:00,238,0,125,0,130,663,1156,16641
2022-05-25 03:00:00,2022-05-25 04:00:00,240,2,125,0,448,429,1244,18880
2022-05-25 04:00:00,2022-05-25 05:00:00,240,208,125,0,952,289,1814,20905
2022-05-25 05:00:00,2022-05-25 06:00:00,239,217,150,0,1383,276,2265,21734
2022-05-25 06:00:00,2022-05-25 07:00:00,238,70,153,0,1797,337,2595,21946
2022-05-25 07:00:00,2022-05-25 08:00:00,239,2,144,0,2191,391,2967,21927
2022-05-25 08:00:00,2022-05-25 09:00:00,240,0,142,0,2071,462,2915,22362
2022-05-25 09:00:00,2022-05-25 10:00:00,239,38,137,0,1924,569,2907,22511
2022-05-25 10:00:00,2022-05-25 11:00:00,238,8,136,0,1933,604,2919,22387
2022-05-25 11:00:00,2022-05-25 12:00:00,240,0,136,0,1688,751,2815,21949
2022-05-25 12:00:00,2022-05-25 13:00:00,240,0,136,0,1510,996,2882,21995
2022-05-25 13:00:00,2022-05-25 14:00:00,240,142,136,0,1446,901,2865,21810
2022-05-25 14:00:00,2022-05-25 15:00:00,236,294,138,0,1085,998,2751,21508
2022-05-25 15:00:00,2022-05-25 16:00:00,238,576,170,47,690,843,2564,21391
2022-05-25 16:00:00,2022-05-25 17:00:00,239,826,174,53,254,761,2307,21637
2022-05-25 17:00:00,2022-05-25 18:00:00,240,839,189,53,121,894,2336,21690
2022-05-25 18:00:00,2022-05-25 19:00:00,240,566,191,53,18,1172,2240,21325
2022-05-25 19:00:00,2022-05-25 20:00:00,240,102,174,53,0,1364,1933,19883
2022-05-25 20:00:00,2022-05-25 21:00:00,239,4,148,7,0,1688,2086,18405
2022-05-25 21:00:00,2022-05-25 22:00:00,239,0,134,0,0,2143,2516,17157
2022-05-25 22:00:00,2022-05-25 23:00:00,239,0,132,0,0,2447,2818,16411
2022-05-25 23:00:00,2022-05-26 00:00:00,237,0,132,0,0,2560,2929,16003
2022-05-26 00:00:00,2022-05-26 01:00:00,238,0,132,0,0,3031,3401,16029
2022-05-26 01:00:00,2022-05-26 02:00:00,238,0,132,0,33,3541,3944,15788
2022-05-26 02:00:00,2022-05-26 03:00:00,238,0,128,0,180,3793,4339,16117
2022-05-26 03:00:00,2022-05-26 04:00:00,238,33,124,0,734,3312,4441,18477
2022-05-26 04:00:00,2022-05-26 05:00:00,237,670,126,0,1773,2876,5682,20525
2022-05-26 05:00:00,2022-05-26 06:00:00,239,664,128,0,2888,3000,6919,21140
2022-05-26 06:00:00,2022-05-26 07:00:00,238,324,136,0,3841,3785,8324,20995
2022-05-26 07:00:00,2022-05-26 08:00:00,236,27,134,0,4466,4881,9744,20850
2022-05-26 08:00:00,2022-05-26 09:00:00,237,0,126,0,4315,5494,10172,21154
2022-05-26 09:00:00,2022-05-26 10:00:00,232,0,127,0,3890,6029,10278,21572
2022-05-26 10:00:00,2022-05-26 11:00:00,239,0,124,0,3757,6189,10309,21390
2022-05-26 11:00:00,2022-05-26 12:00:00,239,0,125,0,3468,6181,10013,20912
2022-05-26 12:00:00,2022-05-26 13:00:00,225,0,123,0,2881,5963,9192,20760
2022-05-26 13:00:00,2022-05-26 14:00:00,171,0,124,0,2651,5899,8845,21163
2022-05-26 14:00:00,2022-05-26 15:00:00,171,0,136,0,1724,5744,7775,20876
2022-05-26 15:00:00,2022-05-26 16:00:00,236,7,144,0,1152,5403,6942,21007
2022-05-26 16:00:00,2022-05-26 17:00:00,240,80,168,47,363,4955,5853,21177
2022-05-26 17:00:00,2022-05-26 18:00:00,239,473,179,53,151,4253,5348,21453
2022-05-26 18:00:00,2022-05-26 19:00:00,239,591,167,53,19,3877,4946,21118
2022-05-26 19:00:00,2022-05-26 20:00:00,239,40,146,53,0,3749,4227,19714
2022-05-26 20:00:00,2022-05-26 21:00:00,238,0,133,53,0,3639,4063,18227
2022-05-26 21:00:00,2022-05-26 22:00:00,238,0,127,53,0,3243,3661,17035
2022-05-26 22:00:00,2022-05-26 23:00:00,237,0,126,7,0,3138,3508,16375
2022-05-26 23:00:00,2022-05-27 00:00:00,238,0,126,0,0,2998,3362,15995
2022-05-27 00:00:00,2022-05-27 01:00:00,237,0,126,0,0,3167,3530,16100
2022-05-27 01:00:00,2022-05-27 02:00:00,245,0,126,0,37,3354,3762,16064
2022-05-27 02:00:00,2022-05-27 03:00:00,246,0,125,0,106,3575,4052,16389
2022-05-27 03:00:00,2022-05-27 04:00:00,244,16,125,0,350,3665,4400,18603
2022-05-27 04:00:00,2022-05-27 05:00:00,242,10,125,0,911,4143,5431,20775
2022-05-27 05:00:00,2022-05-27 06:00:00,239,0,129,0,1394,4751,6513,21654
2022-05-27 06:00:00,2022-05-27 07:00:00,184,235,132,0,2004,5036,7591,21832
2022-05-27 07:00:00,2022-05-27 08:00:00,173,0,123,0,2632,5642,8570,21646
2022-05-27 08:00:00,2022-05-27 09:00:00,181,0,122,0,3003,5713,9019,21876
2022-05-27 09:00:00,2022-05-27 10:00:00,227,0,120,0,3271,5883,9501,22237
2022-05-27 10:00:00,2022-05-27 11:00:00,244,0,118,0,3071,5938,9371,21890
2022-05-27 11:00:00,2022-05-27 12:00:00,247,0,118,0,2839,5997,9201,21439
2022-05-27 12:00:00,2022-05-27 13:00:00,244,0,118,0,2493,5820,8675,21364
2022-05-27 13:00:00,2022-05-27 14:00:00,242,17,118,0,1933,5854,8164,21183
2022-05-27 14:00:00,2022-05-27 15:00:00,243,314,120,0,1402,5735,7814,20907
2022-05-27 15:00:00,2022-05-27 16:00:00,247,515,131,0,840,5457,7190,20811
2022-05-27 16:00:00,2022-05-27 17:00:00,247,524,145,46,360,5220,6542,21160
2022-05-27 17:00:00,2022-05-27 18:00:00,248,664,170,53,128,4876,6139,21239
2022-05-27 18:00:00,2022-05-27 19:00:00,248,602,157,53,29,4830,5919,20832
2022-05-27 19:00:00,2022-05-27 20:00:00,247,585,123,53,0,4811,5819,19438
2022-05-27 20:00:00,2022-05-27 21:00:00,247,283,117,7,0,4820,5474,18291
2022-05-27 21:00:00,2022-05-27 22:00:00,239,27,120,0,0,4897,5283,17008
2022-05-27 22:00:00,2022-05-27 23:00:00,238,3,119,0,0,4860,5220,16261
2022-05-27 23:00:00,2022-05-28 00:00:00,236,0,119,0,0,4741,5096,15703
2022-05-28 00:00:00,2022-05-28 01:00:00,237,0,119,0,0,4846,5202,15582
2022-05-28 01:00:00,2022-05-28 02:00:00,243,0,120,0,41,4708,5112,15149
2022-05-28 02:00:00,2022-05-28 03:00:00,247,0,118,0,199,4675,5239,14931
2022-05-28 03:00:00,2022-05-28 04:00:00,248,0,117,0,688,4681,5734,15660
2022-05-28 04:00:00,2022-05-28 05:00:00,248,0,117,0,1519,4966,6850,16908
2022-05-28 05:00:00,2022-05-28 06:00:00,247,0,124,0,2251,4838,7460,17778
2022-05-28 06:00:00,2022-05-28 07:00:00,246,0,127,0,2878,4867,8118,18367
2022-05-28 07:00:00,2022-05-28 08:00:00,250,0,121,0,3319,4896,8586,18360
2022-05-28 08:00:00,2022-05-28 09:00:00,250,0,119,0,3838,5020,9227,18780
2022-05-28 09:00:00,2022-05-28 10:00:00,248,0,119,0,3971,5285,9623,18812
2022-05-28 10:00:00,2022-05-28 11:00:00,247,0,119,0,3537,5464,9367,18176
2022-05-28 11:00:00,2022-05-28 12:00:00,248,0,119,0,3255,5355,8977,17606
2022-05-28 12:00:00,2022-05-28 13:00:00,246,0,120,0,2967,5228,8561,17734
2022-05-28 13:00:00,2022-05-28 14:00:00,249,0,120,0,2371,4877,7617,17532
2022-05-28 14:00:00,2022-05-28 15:00:00,248,12,122,0,1782,4286,6450,17693
2022-05-28 15:00:00,2022-05-28 16:00:00,247,244,126,0,798,3706,5121,17637
2022-05-28 16:00:00,2022-05-28 17:00:00,248,427,146,46,376,3568,4811,18174
2022-05-28 17:00:00,2022-05-28 18:00:00,244,593,169,53,181,3449,4689,18518
2022-05-28 18:00:00,2022-05-28 19:00:00,241,501,159,53,41,3397,4392,18325
2022-05-28 19:00:00,2022-05-28 20:00:00,247,84,129,53,0,3506,4019,17427
2022-05-28 20:00:00,2022-05-28 21:00:00,246,0,128,7,0,3486,3867,16211
2022-05-28 21:00:00,2022-05-28 22:00:00,239,0,126,0,0,3349,3714,15089
2022-05-28 22:00:00,2022-05-28 23:00:00,236,0,127,0,0,3042,3405,14322
2022-05-28 23:00:00,2022-05-29 00:00:00,237,0,132,0,0,2814,3183,13923
2022-05-29 00:00:00,2022-05-29 01:00:00,236,0,134,0,0,2738,3108,13822
2022-05-29 01:00:00,2022-05-29 02:00:00,243,0,134,0,39,2584,3000,13342
2022-05-29 02:00:00,2022-05-29 03:00:00,247,0,132,0,171,2281,2831,13032
2022-05-29 03:00:00,2022-05-29 04:00:00,248,0,132,0,634,1747,2761,13439
2022-05-29 04:00:00,2022-05-29 05:00:00,246,0,132,0,1582,1242,3202,14233
2022-05-29 05:00:00,2022-05-29 06:00:00,249,0,135,0,2671,1065,4120,15147
2022-05-29 06:00:00,2022-05-29 07:00:00,249,0,144,0,3427,936,4756,15763
2022-05-29 07:00:00,2022-05-29 08:00:00,247,0,137,0,3763,818,4965,15984
2022-05-29 08:00:00,2022-05-29 09:00:00,245,0,136,0,3666,748,4795,16312
2022-05-29 09:00:00,2022-05-29 10:00:00,248,0,127,0,3357,723,4455,16122
2022-05-29 10:00:00,2022-05-29 11:00:00,248,0,125,0,3001,587,3961,15880
2022-05-29 11:00:00,2022-05-29 12:00:00,248,0,125,0,3206,514,4093,16068
2022-05-29 12:00:00,2022-05-29 13:00:00,247,0,126,0,2997,453,3823,16136
2022-05-29 13:00:00,2022-05-29 14:00:00,246,0,121,0,2361,254,2982,15956
2022-05-29 14:00:00,2022-05-29 15:00:00,247,0,122,0,1765,186,2320,16177
2022-05-29 15:00:00,2022-05-29 16:00:00,248,5,126,47,1086,115,1627,16651
2022-05-29 16:00:00,2022-05-29 17:00:00,247,231,133,53,392,101,1157,16954
2022-05-29 17:00:00,2022-05-29 18:00:00,247,400,176,53,155,145,1176,17416
2022-05-29 18:00:00,2022-05-29 19:00:00,248,354,177,53,32,190,1054,17563
2022-05-29 19:00:00,2022-05-29 20:00:00,248,87,166,53,0,292,846,16942
2022-05-29 20:00:00,2022-05-29 21:00:00,247,5,166,53,0,429,900,15908
2022-05-29 21:00:00,2022-05-29 22:00:00,239,0,166,7,0,507,919,15001
2022-05-29 22:00:00,2022-05-29 23:00:00,237,0,164,0,0,453,854,14600
2022-05-29 23:00:00,2022-05-30 00:00:00,237,0,164,0,0,473,874,14337
2022-05-30 00:00:00,2022-05-30 01:00:00,233,0,164,0,0,556,953,14407
2022-05-30 01:00:00,2022-05-30 02:00:00,241,0,164,0,36,483,924,14500
2022-05-30 02:00:00,2022-05-30 03:00:00,248,0,163,0,149,363,923,15202
2022-05-30 03:00:00,2022-05-30 04:00:00,249,90,163,0,424,266,1192,18259
2022-05-30 04:00:00,2022-05-30 05:00:00,249,274,164,0,930,228,1845,20544
2022-05-30 05:00:00,2022-05-30 06:00:00,247,130,162,0,1676,206,2421,21773
2022-05-30 06:00:00,2022-05-30 07:00:00,248,145,155,0,2363,267,3178,22086
2022-05-30 07:00:00,2022-05-30 08:00:00,247,10,135,0,2575,281,3248,21638
2022-05-30 08:00:00,2022-05-30 09:00:00,247,0,130,0,3120,436,3933,22012
2022-05-30 09:00:00,2022-05-30 10:00:00,248,0,128,0,3118,656,4150,21700
2022-05-30 10:00:00,2022-05-30 11:00:00,249,0,126,0,3174,716,4265,21205
2022-05-30 11:00:00,2022-05-30 12:00:00,247,0,126,0,3640,835,4848,21349
2022-05-30 12:00:00,2022-05-30 13:00:00,246,0,131,0,3021,844,4242,20948
2022-05-30 13:00:00,2022-05-30 14:00:00,247,0,130,0,2666,1035,4078,20828
2022-05-30 14:00:00,2022-05-30 15:00:00,249,0,132,0,2167,1170,3718,20977
2022-05-30 15:00:00,2022-05-30 16:00:00,248,32,166,46,1135,922,2549,20825
2022-05-30 16:00:00,2022-05-30 17:00:00,244,385,176,53,497,659,2014,21216
2022-05-30 17:00:00,2022-05-30 18:00:00,249,641,189,53,192,654,1978,21496
2022-05-30 18:00:00,2022-05-30 19:00:00,247,562,189,53,30,748,1829,21004
2022-05-30 19:00:00,2022-05-30 20:00:00,248,175,141,52,0,1008,1624,19651
2022-05-30 20:00:00,2022-05-30 21:00:00,246,5,135,7,0,1162,1555,18153
2022-05-30 21:00:00,2022-05-30 22:00:00,236,0,133,0,0,1310,1679,16968
2022-05-30 22:00:00,2022-05-30 23:00:00,236,0,133,0,0,1306,1675,16354
2022-05-30 23:00:00,2022-05-31 00:00:00,235,0,133,0,0,1107,1475,15989
2022-05-31 00:00:00,2022-05-31 01:00:00,238,0,133,0,0,1057,1428,16076
2022-05-31 01:00:00,2022-05-31 02:00:00,243,0,133,0,32,918,1326,15966
2022-05-31 02:00:00,2022-05-31 03:00:00,249,0,130,0,199,711,1289,16313
2022-05-31 03:00:00,2022-05-31 04:00:00,249,0,126,0,797,412,1584,18728
2022-05-31 04:00:00,2022-05-31 05:00:00,247,88,126,0,2099,191,2751,20680
2022-05-31 05:00:00,2022-05-31 06:00:00,250,370,136,0,3544,221,4521,21263
2022-05-31 06:00:00,2022-05-31 07:00:00,249,175,149,0,4509,423,5505,21128
2022-05-31 07:00:00,2022-05-31 08:00:00,247,0,149,0,4827,668,5891,20707
2022-05-31 08:00:00,2022-05-31 09:00:00,245,0,149,0,4963,644,6001,21030
2022-05-31 09:00:00,2022-05-31 10:00:00,247,0,145,0,5000,660,6052,21041
2022-05-31 10:00:00,2022-05-31 11:00:00,248,0,130,0,4530,561,5469,20613
2022-05-31 11:00:00,2022-05-31 12:00:00,249,0,130,0,4430,499,5308,20621
2022-05-31 12:00:00,2022-05-31 13:00:00,247,0,129,0,3934,409,4719,20888
2022-05-31 13:00:00,2022-05-31 14:00:00,247,0,132,0,3224,287,3890,21007
2022-05-31 14:00:00,2022-05-31 15:00:00,248,20,134,0,2342,257,3001,20999
2022-05-31 15:00:00,2022-05-31 16:00:00,246,491,142,0,1321,215,2415,21113
2022-05-31 16:00:00,2022-05-31 17:00:00,246,809,156,46,482,319,2058,21290
2022-05-31 17:00:00,2022-05-31 18:00:00,246,964,165,53,160,719,2307,21536
2022-05-31 18:00:00,2022-05-31 19:00:00,248,743,184,52,35,1152,2414,21155
2022-05-31 19:00:00,2022-05-31 20:00:00,245,300,165,7,0,1499,2216,19682
2022-05-31 20:00:00,2022-05-31 21:00:00,210,0,138,0,0,1752,2100,18216
2022-05-31 21:00:00,2022-05-31 22:00:00,234,0,140,0,0,1986,2360,17129
2022-05-31 22:00:00,2022-05-31 23:00:00,237,0,141,0,0,1898,2276,16449
2022-05-31 23:00:00,2022-06-01 00:00:00,235,0,141,0,0,1685,2061,16155
2022-06-01 00:00:00,2022-06-01 01:00:00,237,0,141,5,0,1674,2057,16141
2022-06-01 01:00:00,2022-06-01 02:00:00,245,0,141,5,44,1637,2072,16128
2022-06-01 02:00:00,2022-06-01 03:00:00,248,0,139,0,149,1485,2021,16474
2022-06-01 03:00:00,2022-06-01 04:00:00,248,0,133,0,429,1562,2372,18790
2022-06-01 04:00:00,2022-06-01 05:00:00,248,320,132,0,997,1180,2877,20579
2022-06-01 05:00:00,2022-06-01 06:00:00,247,509,134,0,1633,939,3462,21274
2022-06-01 06:00:00,2022-06-01 07:00:00,248,202,144,0,2285,1030,3909,21355
2022-06-01 07:00:00,2022-06-01 08:00:00,248,0,144,0,3256,1120,4768,21436
2022-06-01 08:00:00,2022-06-01 09:00:00,248,0,145,0,4018,1193,5604,21737
2022-06-01 09:00:00,2022-06-01 10:00:00,249,0,142,0,4268,1445,6104,21723
2022-06-01 10:00:00,2022-06-01 11:00:00,246,107,138,0,4312,1676,6479,21613
2022-06-01 11:00:00,2022-06-01 12:00:00,248,0,133,0,4270,1918,6569,21079
2022-06-01 12:00:00,2022-06-01 13:00:00,248,0,132,0,3885,1940,6205,20967
2022-06-01 13:00:00,2022-06-01 14:00:00,247,0,134,0,3056,1810,5247,20642
2022-06-01 14:00:00,2022-06-01 15:00:00,247,0,145,0,2384,1515,4291,20882
2022-06-01 15:00:00,2022-06-01 16:00:00,249,300,180,0,1216,1032,2977,20813
2022-06-01 16:00:00,2022-06-01 17:00:00,247,918,185,46,519,792,2707,21309
2022-06-01 17:00:00,2022-06-01 18:00:00,249,788,192,53,190,883,2355,21556
2022-06-01 18:00:00,2022-06-01 19:00:00,246,499,193,53,31,876,1898,21245
2022-06-01 19:00:00,2022-06-01 20:00:00,248,322,172,52,0,685,1479,19972
2022-06-01 20:00:00,2022-06-01 21:00:00,247,233,138,7,0,756,1381,18441
2022-06-01 21:00:00,2022-06-01 22:00:00,240,0,137,0,0,1015,1392,17186
2022-06-01 22:00:00,2022-06-01 23:00:00,233,0,137,0,0,1104,1474,16520
2022-06-01 23:00:00,2022-06-02 00:00:00,234,0,137,0,0,1080,1451,16241
2022-06-02 00:00:00,2022-06-02 01:00:00,235,0,137,0,0,1118,1490,16172
2022-06-02 01:00:00,2022-06-02 02:00:00,240,0,137,0,37,1313,1727,16003
2022-06-02 02:00:00,2022-06-02 03:00:00,247,0,137,0,142,1312,1838,16345
2022-06-02 03:00:00,2022-06-02 04:00:00,248,17,136,0,415,1244,2060,18736
2022-06-02 04:00:00,2022-06-02 05:00:00,248,227,153,0,952,1067,2647,20761
2022-06-02 05:00:00,2022-06-02 06:00:00,231,490,156,0,1866,899,3642,21426
2022-06-02 06:00:00,2022-06-02 07:00:00,220,81,148,0,3200,1142,4791,21771
2022-06-02 07:00:00,2022-06-02 08:00:00,237,0,142,0,3703,1399,5481,21130
2022-06-02 08:00:00,2022-06-02 09:00:00,246,0,138,0,3955,1611,5950,21032
2022-06-02 09:00:00,2022-06-02 10:00:00,249,0,134,0,4325,1870,6578,20936
2022-06-02 10:00:00,2022-06-02 11:00:00,246,0,133,0,4697,2169,7245,20939
2022-06-02 11:00:00,2022-06-02 12:00:00,248,0,134,0,4521,2311,7214,20499
2022-06-02 12:00:00,2022-06-02 13:00:00,247,0,133,0,4217,2092,6689,20739
2022-06-02 13:00:00,2022-06-02 14:00:00,247,0,133,0,3629,1860,5869,20734
2022-06-02 14:00:00,2022-06-02 15:00:00,246,0,141,0,2482,1672,4541,20599
2022-06-02 15:00:00,2022-06-02 16:00:00,247,74,160,0,1299,1335,3115,20648
2022-06-02 16:00:00,2022-06-02 17:00:00,248,691,161,46,509,912,2567,21135
2022-06-02 17:00:00,2022-06-02 18:00:00,247,957,182,53,188,755,2382,21347
2022-06-02 18:00:00,2022-06-02 19:00:00,246,1046,191,52,39,710,2284,21275
2022-06-02 19:00:00,2022-06-02 20:00:00,245,902,148,52,0,649,1996,19960
2022-06-02 20:00:00,2022-06-02 21:00:00,247,294,138,7,0,707,1393,18456
2022-06-02 21:00:00,2022-06-02 22:00:00,238,0,132,0,0,716,1086,17150
2022-06-02 22:00:00,2022-06-02 23:00:00,235,0,131,0,0,723,1089,16465
2022-06-02 23:00:00,2022-06-03 00:00:00,235,0,131,0,0,680,1046,16193
2022-06-03 00:00:00,2022-06-03 01:00:00,236,0,131,0,0,634,1001,16189
2022-06-03 01:00:00,2022-06-03 02:00:00,242,0,131,0,42,590,1005,15974
2022-06-03 02:00:00,2022-06-03 03:00:00,245,14,131,0,206,530,1126,16366
2022-06-03 03:00:00,2022-06-03 04:00:00,248,155,129,0,802,404,1738,18666
2022-06-03 04:00:00,2022-06-03 05:00:00,248,394,147,0,2141,293,3223,20598
2022-06-03 05:00:00,2022-06-03 06:00:00,248,66,154,0,3580,367,4415,21382
2022-06-03 06:00:00,2022-06-03 07:00:00,246,0,140,0,4618,448,5452,21112
2022-06-03 07:00:00,2022-06-03 08:00:00,248,0,135,0,5238,458,6079,20723
2022-06-03 08:00:00,2022-06-03 09:00:00,249,0,128,0,5511,476,6364,20789
2022-06-03 09:00:00,2022-06-03 10:00:00,247,0,128,0,5786,465,6626,20912
2022-06-03 10:00:00,2022-06-03 11:00:00,247,0,128,0,5729,436,6540,20672
2022-06-03 11:00:00,2022-06-03 12:00:00,250,0,127,0,5513,363,6253,20387
2022-06-03 12:00:00,2022-06-03 13:00:00,246,26,127,0,5014,318,5731,20735
2022-06-03 13:00:00,2022-06-03 14:00:00,247,78,127,0,4060,312,4824,20861
2022-06-03 14:00:00,2022-06-03 15:00:00,248,0,127,0,2878,267,3520,20862
2022-06-03 15:00:00,2022-06-03 16:00:00,246,173,148,0,1585,250,2402,20928
2022-06-03 16:00:00,2022-06-03 17:00:00,249,455,156,46,578,326,1810,21056
2022-06-03 17:00:00,2022-06-03 18:00:00,247,492,185,52,196,551,1723,21073
2022-06-03 18:00:00,2022-06-03 19:00:00,250,392,191,52,25,1001,1911,20783
2022-06-03 19:00:00,2022-06-03 20:00:00,248,18,174,52,0,1381,1873,19470
2022-06-03 20:00:00,2022-06-03 21:00:00,249,0,172,6,0,1712,2139,18039
2022-06-03 21:00:00,2022-06-03 22:00:00,239,0,166,0,0,1886,2291,16886
2022-06-03 22:00:00,2022-06-03 23:00:00,239,0,165,0,0,1808,2212,16199
2022-06-03 23:00:00,2022-06-04 00:00:00,237,0,165,0,0,1589,1991,15839
2022-06-04 00:00:00,2022-06-04 01:00:00,235,0,165,0,0,1378,1778,15600
2022-06-04 01:00:00,2022-06-04 02:00:00,238,0,165,0,38,1106,1547,15206
2022-06-04 02:00:00,2022-06-04 03:00:00,246,0,163,0,230,938,1577,14963
2022-06-04 03:00:00,2022-06-04 04:00:00,247,0,157,0,681,784,1869,15803
2022-06-04 04:00:00,2022-06-04 05:00:00,245,0,157,0,1289,485,2176,17063
2022-06-04 05:00:00,2022-06-04 06:00:00,248,0,150,0,1932,330,2660,18327
2022-06-04 06:00:00,2022-06-04 07:00:00,247,0,137,0,2570,310,3264,19141
2022-06-04 07:00:00,2022-06-04 08:00:00,249,174,129,0,3073,350,3975,19659
2022-06-04 08:00:00,2022-06-04 09:00:00,248,275,127,0,3025,402,4077,19575
2022-06-04 09:00:00,2022-06-04 10:00:00,245,101,129,0,3338,520,4333,19523
2022-06-04 10:00:00,2022-06-04 11:00:00,248,0,133,0,3273,636,4290,18968
2022-06-04 11:00:00,2022-06-04 12:00:00,247,0,134,0,3260,718,4359,18627
2022-06-04 12:00:00,2022-06-04 13:00:00,245,0,133,0,3049,791,4218,18605
2022-06-04 13:00:00,2022-06-04 14:00:00,247,0,133,0,2439,844,3663,18175
2022-06-04 14:00:00,2022-06-04 15:00:00,246,0,134,0,1666,879,2925,17963
2022-06-04 15:00:00,2022-06-04 16:00:00,246,152,140,0,1015,857,2410,17902
2022-06-04 16:00:00,2022-06-04 17:00:00,247,477,154,46,471,828,2223,17918
2022-06-04 17:00:00,2022-06-04 18:00:00,247,715,178,52,216,827,2235,17953
2022-06-04 18:00:00,2022-06-04 19:00:00,247,736,179,52,45,952,2211,17898
2022-06-04 19:00:00,2022-06-04 20:00:00,249,459,164,6,0,1134,2012,17197
2022-06-04 20:00:00,2022-06-04 21:00:00,245,221,161,0,0,1223,1850,16055
2022-06-04 21:00:00,2022-06-04 22:00:00,240,0,148,0,0,1187,1575,15071
2022-06-04 22:00:00,2022-06-04 23:00:00,235,0,131,0,0,1224,1590,14406
2022-06-04 23:00:00,2022-06-05 00:00:00,236,0,131,0,0,1193,1560,13895
2022-06-05 00:00:00,2022-06-05 01:00:00,235,0,131,0,0,1105,1471,13574
2022-06-05 01:00:00,2022-06-05 02:00:00,238,98,131,0,49,1033,1549,13150
2022-06-05 02:00:00,2022-06-05 03:00:00,246,163,131,0,221,916,1677,12852
2022-06-05 03:00:00,2022-06-05 04:00:00,247,252,128,0,759,566,1952,13129
2022-06-05 04:00:00,2022-06-05 05:00:00,247,252,129,0,1821,243,2692,13864
2022-06-05 05:00:00,2022-06-05 06:00:00,247,242,135,0,3155,143,3922,14845
2022-06-05 06:00:00,2022-06-05 07:00:00,250,128,140,0,4438,150,5106,15496
2022-06-05 07:00:00,2022-06-05 08:00:00,249,0,137,0,5265,153,5804,15683
2022-06-05 08:00:00,2022-06-05 09:00:00,248,0,133,0,5727,155,6263,15741
2022-06-05 09:00:00,2022-06-05 10:00:00,246,0,131,0,5917,158,6452,15758
2022-06-05 10:00:00,2022-06-05 11:00:00,246,0,131,0,5919,196,6492,15721
2022-06-05 11:00:00,2022-06-05 12:00:00,247,0,134,0,5756,286,6423,15539
2022-06-05 12:00:00,2022-06-05 13:00:00,248,0,135,0,5134,428,5945,15204
2022-06-05 13:00:00,2022-06-05 14:00:00,247,0,151,0,4277,594,5269,15353
2022-06-05 14:00:00,2022-06-05 15:00:00,246,0,154,0,3021,759,4180,15780
2022-06-05 15:00:00,2022-06-05 16:00:00,246,0,174,0,1626,860,2906,16345
2022-06-05 16:00:00,2022-06-05 17:00:00,244,42,184,46,626,965,2107,16731
2022-06-05 17:00:00,2022-06-05 18:00:00,247,155,195,52,262,1340,2251,17081
2022-06-05 18:00:00,2022-06-05 19:00:00,245,140,196,52,48,1925,2606,17293
2022-06-05 19:00:00,2022-06-05 20:00:00,245,29,178,6,0,2408,2866,16755
2022-06-05 20:00:00,2022-06-05 21:00:00,244,0,165,0,0,2901,3310,15477
2022-06-05 21:00:00,2022-06-05 22:00:00,239,0,141,0,0,3160,3540,14524
2022-06-05 22:00:00,2022-06-05 23:00:00,238,0,138,0,0,3143,3519,14049
2022-06-05 23:00:00,2022-06-06 00:00:00,242,0,138,0,0,3326,3706,13886
2022-06-06 00:00:00,2022-06-06 01:00:00,253,0,138,0,0,3627,4018,13767
2022-06-06 01:00:00,2022-06-06 02:00:00,264,0,138,0,52,3431,3885,13597
2022-06-06 02:00:00,2022-06-06 03:00:00,270,0,138,0,252,3209,3869,14318
2022-06-06 03:00:00,2022-06-06 04:00:00,271,0,133,0,832,2737,3973,17380
2022-06-06 04:00:00,2022-06-06 05:00:00,277,12,130,0,1823,1719,3961,19769
2022-06-06 05:00:00,2022-06-06 06:00:00,280,59,135,0,2994,876,4344,20914
2022-06-06 06:00:00,2022-06-06 07:00:00,285,4,137,0,3906,829,5161,21215
2022-06-06 07:00:00,2022-06-06 08:00:00,286,0,131,0,4467,1026,5910,20962
2022-06-06 08:00:00,2022-06-06 09:00:00,284,0,130,0,4565,1140,6119,21137
2022-06-06 09:00:00,2022-06-06 10:00:00,283,0,129,0,4099,1054,5565,20925
2022-06-06 10:00:00,2022-06-06 11:00:00,284,0,128,0,3839,995,5246,20999
2022-06-06 11:00:00,2022-06-06 12:00:00,283,0,126,0,3486,853,4748,21044
2022-06-06 12:00:00,2022-06-06 13:00:00,283,0,125,0,2854,677,3939,21024
2022-06-06 13:00:00,2022-06-06 14:00:00,284,30,126,0,2479,513,3432,21291
2022-06-06 14:00:00,2022-06-06 15:00:00,282,549,126,0,1846,336,3139,21451
2022-06-06 15:00:00,2022-06-06 16:00:00,291,719,144,0,1102,269,2525,21308
2022-06-06 16:00:00,2022-06-06 17:00:00,293,945,173,46,470,418,2345,21636
2022-06-06 17:00:00,2022-06-06 18:00:00,294,986,186,52,171,588,2277,21629
2022-06-06 18:00:00,2022-06-06 19:00:00,294,890,185,52,21,723,2165,21135
2022-06-06 19:00:00,2022-06-06 20:00:00,294,168,169,7,0,911,1549,19846
2022-06-06 20:00:00,2022-06-06 21:00:00,287,9,146,0,0,825,1267,18493
2022-06-06 21:00:00,2022-06-06 22:00:00,266,0,130,0,0,706,1102,17206
2022-06-06 22:00:00,2022-06-06 23:00:00,263,0,127,0,0,758,1148,16572
2022-06-06 23:00:00,2022-06-07 00:00:00,264,0,127,0,0,690,1081,16361
2022-06-07 00:00:00,2022-06-07 01:00:00,265,0,127,0,0,674,1066,16243
2022-06-07 01:00:00,2022-06-07 02:00:00,266,0,127,0,22,788,1203,15964
2022-06-07 02:00:00,2022-06-07 03:00:00,271,0,128,0,185,655,1239,16261
2022-06-07 03:00:00,2022-06-07 04:00:00,274,0,124,0,676,420,1494,18633
2022-06-07 04:00:00,2022-06-07 05:00:00,281,207,124,0,1721,246,2579,20648
2022-06-07 05:00:00,2022-06-07 06:00:00,283,342,130,0,2835,190,3780,21560
2022-06-07 06:00:00,2022-06-07 07:00:00,283,75,132,0,3831,164,4485,21755
2022-06-07 07:00:00,2022-06-07 08:00:00,286,0,131,0,4377,199,4993,21493
2022-06-07 08:00:00,2022-06-07 09:00:00,288,0,130,0,4853,215,5486,22028
2022-06-07 09:00:00,2022-06-07 10:00:00,287,0,130,0,4378,228,5023,21994
2022-06-07 10:00:00,2022-06-07 11:00:00,289,0,130,0,4110,226,4755,22172
2022-06-07 11:00:00,2022-06-07 12:00:00,287,202,126,0,3526,256,4397,22023
2022-06-07 12:00:00,2022-06-07 13:00:00,286,343,124,0,2532,401,3686,21898
2022-06-07 13:00:00,2022-06-07 14:00:00,287,422,123,0,1861,406,3099,21683
2022-06-07 14:00:00,2022-06-07 15:00:00,288,315,125,0,1089,380,2197,21413
2022-06-07 15:00:00,2022-06-07 16:00:00,292,373,162,0,658,440,1925,21507
2022-06-07 16:00:00,2022-06-07 17:00:00,293,469,176,46,299,584,1867,21871
2022-06-07 17:00:00,2022-06-07 18:00:00,290,427,185,52,165,538,1657,21884
2022-06-07 18:00:00,2022-06-07 19:00:00,292,387,183,52,12,540,1466,21193
2022-06-07 19:00:00,2022-06-07 20:00:00,292,183,164,7,0,713,1359,19843
2022-06-07 20:00:00,2022-06-07 21:00:00,288,19,137,0,0,781,1225,18389
2022-06-07 21:00:00,2022-06-07 22:00:00,275,0,130,0,0,714,1119,17170
2022-06-07 22:00:00,2022-06-07 23:00:00,269,0,125,0,0,608,1002,16517
2022-06-07 23:00:00,2022-06-08 00:00:00,263,0,124,0,0,504,891,16130
2022-06-08 00:00:00,2022-06-08 01:00:00,265,0,124,0,0,427,816,16101
2022-06-08 01:00:00,2022-06-08 02:00:00,268,0,124,0,20,320,732,15986
2022-06-08 02:00:00,2022-06-08 03:00:00,273,0,126,0,159,271,829,16559
2022-06-08 03:00:00,2022-06-08 04:00:00,285,70,121,0,520,139,1135,19002
2022-06-08 04:00:00,2022-06-08 05:00:00,293,393,120,0,1048,63,1917,20893
2022-06-08 05:00:00,2022-06-08 06:00:00,293,541,123,0,1811,30,2798,21724
2022-06-08 06:00:00,2022-06-08 07:00:00,292,275,126,0,2468,15,3176,21844
2022-06-08 07:00:00,2022-06-08 08:00:00,292,0,140,0,2949,19,3400,21670
2022-06-08 08:00:00,2022-06-08 09:00:00,288,0,140,0,3268,41,3737,21976
2022-06-08 09:00:00,2022-06-08 10:00:00,288,0,134,0,3366,63,3851,22079
2022-06-08 10:00:00,2022-06-08 11:00:00,286,0,135,0,3656,86,4163,22162
2022-06-08 11:00:00,2022-06-08 12:00:00,287,0,134,0,3494,121,4036,21882
2022-06-08 12:00:00,2022-06-08 13:00:00,286,0,134,0,3035,144,3599,21779
2022-06-08 13:00:00,2022-06-08 14:00:00,293,0,125,0,2239,178,2835,21368
2022-06-08 14:00:00,2022-06-08 15:00:00,293,12,123,0,1848,249,2525,21400
2022-06-08 15:00:00,2022-06-08 16:00:00,292,125,131,0,1127,314,1989,21287
2022-06-08 16:00:00,2022-06-08 17:00:00,293,504,136,46,461,402,1842,21681
2022-06-08 17:00:00,2022-06-08 18:00:00,294,628,184,53,162,530,1851,21787
2022-06-08 18:00:00,2022-06-08 19:00:00,295,390,190,52,17,790,1734,21323
2022-06-08 19:00:00,2022-06-08 20:00:00,287,9,144,7,0,1092,1539,20071
2022-06-08 20:00:00,2022-06-08 21:00:00,283,0,137,0,0,1150,1570,18522
2022-06-08 21:00:00,2022-06-08 22:00:00,233,0,126,0,0,1021,1380,17411
2022-06-08 22:00:00,2022-06-08 23:00:00,217,0,120,0,0,1020,1357,16745
2022-06-08 23:00:00,2022-06-09 00:00:00,219,0,120,0,0,735,1074,16436
2022-06-09 00:00:00,2022-06-09 01:00:00,220,0,120,0,0,542,882,16406
2022-06-09 01:00:00,2022-06-09 02:00:00,226,0,120,0,27,574,947,16182
2022-06-09 02:00:00,2022-06-09 03:00:00,229,0,120,0,193,738,1280,16505
2022-06-09 03:00:00,2022-06-09 04:00:00,229,0,117,0,582,582,1510,18856
2022-06-09 04:00:00,2022-06-09 05:00:00,231,50,116,0,1350,207,1954,20953
2022-06-09 05:00:00,2022-06-09 06:00:00,239,100,121,0,2108,63,2631,21766
2022-06-09 06:00:00,2022-06-09 07:00:00,238,0,126,0,2923,108,3395,21954
2022-06-09 07:00:00,2022-06-09 08:00:00,240,0,122,0,3894,200,4456,22102
2022-06-09 08:00:00,2022-06-09 09:00:00,240,0,121,0,4092,215,4668,22286
2022-06-09 09:00:00,2022-06-09 10:00:00,241,24,120,0,4026,282,4693,22294
2022-06-09 10:00:00,2022-06-09 11:00:00,239,168,119,0,3657,340,4523,22085
2022-06-09 11:00:00,2022-06-09 12:00:00,238,0,119,0,3492,495,4344,22260
2022-06-09 12:00:00,2022-06-09 13:00:00,236,23,119,0,2998,716,4092,22646
2022-06-09 13:00:00,2022-06-09 14:00:00,237,168,132,0,1747,806,3090,22090
2022-06-09 14:00:00,2022-06-09 15:00:00,243,234,137,0,1233,799,2646,21946
2022-06-09 15:00:00,2022-06-09 16:00:00,238,321,144,0,748,770,2221,21811
2022-06-09 16:00:00,2022-06-09 17:00:00,242,433,145,46,391,911,2168,21991
2022-06-09 17:00:00,2022-06-09 18:00:00,241,391,162,53,149,1093,2089,21832
2022-06-09 18:00:00,2022-06-09 19:00:00,241,154,163,53,14,1163,1788,21160
2022-06-09 19:00:00,2022-06-09 20:00:00,242,4,158,7,0,1388,1799,19979
2022-06-09 20:00:00,2022-06-09 21:00:00,229,0,141,0,0,1388,1758,18595
2022-06-09 21:00:00,2022-06-09 22:00:00,219,105,127,0,0,1363,1814,17422
2022-06-09 22:00:00,2022-06-09 23:00:00,217,0,125,0,0,1554,1896,16784
2022-06-09 23:00:00,2022-06-10 00:00:00,218,0,125,0,0,1648,1991,16464
2022-06-10 00:00:00,2022-06-10 01:00:00,218,0,125,0,0,1669,2012,16340
2022-06-10 01:00:00,2022-06-10 02:00:00,222,0,125,0,21,1696,2064,16124
2022-06-10 02:00:00,2022-06-10 03:00:00,198,0,125,0,180,1709,2212,16562
2022-06-10 03:00:00,2022-06-10 04:00:00,163,12,122,0,578,1648,2523,19017
2022-06-10 04:00:00,2022-06-10 05:00:00,166,154,121,0,1063,1643,3147,20915
2022-06-10 05:00:00,2022-06-10 06:00:00,219,148,137,0,1713,1527,3744,21804
2022-06-10 06:00:00,2022-06-10 07:00:00,241,0,144,0,2610,1514,4509,22323
2022-06-10 07:00:00,2022-06-10 08:00:00,241,2,131,0,3298,1438,5110,22073
2022-06-10 08:00:00,2022-06-10 09:00:00,240,5,129,0,3832,1488,5694,22379
2022-06-10 09:00:00,2022-06-10 10:00:00,240,0,123,0,4188,1642,6193,22340
2022-06-10 10:00:00,2022-06-10 11:00:00,238,0,124,0,4208,1719,6289,21938
2022-06-10 11:00:00,2022-06-10 12:00:00,240,0,124,0,4174,1625,6163,21483
2022-06-10 12:00:00,2022-06-10 13:00:00,239,0,132,0,3667,1561,5599,21374
2022-06-10 13:00:00,2022-06-10 14:00:00,240,0,139,0,3360,1539,5278,21556
2022-06-10 14:00:00,2022-06-10 15:00:00,239,0,144,0,2396,1527,4306,21383
2022-06-10 15:00:00,2022-06-10 16:00:00,240,350,179,0,1241,1348,3358,21147
2022-06-10 16:00:00,2022-06-10 17:00:00,234,721,184,46,485,1151,2821,21384
2022-06-10 17:00:00,2022-06-10 18:00:00,232,880,184,53,176,949,2474,21345
2022-06-10 18:00:00,2022-06-10 19:00:00,239,760,184,53,12,851,2099,20846
2022-06-10 19:00:00,2022-06-10 20:00:00,230,396,175,7,0,895,1703,19956
2022-06-10 20:00:00,2022-06-10 21:00:00,228,174,132,0,0,977,1511,18564
2022-06-10 21:00:00,2022-06-10 22:00:00,220,158,124,0,0,1073,1575,17274
2022-06-10 22:00:00,2022-06-10 23:00:00,215,53,123,0,0,1052,1443,16477
2022-06-10 23:00:00,2022-06-11 00:00:00,216,8,123,0,0,987,1334,16033
2022-06-11 00:00:00,2022-06-11 01:00:00,215,6,123,0,0,919,1263,15865
2022-06-11 01:00:00,2022-06-11 02:00:00,221,0,123,0,33,883,1260,15281
2022-06-11 02:00:00,2022-06-11 03:00:00,230,0,125,0,235,861,1451,15157
2022-06-11 03:00:00,2022-06-11 04:00:00,230,0,121,0,815,754,1920,16037
2022-06-11 04:00:00,2022-06-11 05:00:00,230,0,121,0,2040,445,2836,17526
2022-06-11 05:00:00,2022-06-11 06:00:00,230,0,83,0,3346,300,3959,18662
2022-06-11 06:00:00,2022-06-11 07:00:00,230,56,80,0,4403,231,5000,19247
2022-06-11 07:00:00,2022-06-11 08:00:00,230,0,80,0,5392,282,5984,19343
2022-06-11 08:00:00,2022-06-11 09:00:00,228,0,81,0,5642,358,6309,19213
2022-06-11 09:00:00,2022-06-11 10:00:00,230,0,73,0,5588,410,6301,18990
2022-06-11 10:00:00,2022-06-11 11:00:00,228,0,71,0,5320,439,6058,18684
2022-06-11 11:00:00,2022-06-11 12:00:00,230,0,70,0,5060,394,5754,18188
2022-06-11 12:00:00,2022-06-11 13:00:00,229,0,90,0,4539,356,5214,18176
2022-06-11 13:00:00,2022-06-11 14:00:00,228,0,137,0,3784,327,4476,18144
2022-06-11 14:00:00,2022-06-11 15:00:00,230,39,142,0,2762,311,3484,18357
2022-06-11 15:00:00,2022-06-11 16:00:00,229,480,149,0,1532,350,2740,18339
2022-06-11 16:00:00,2022-06-11 17:00:00,229,790,175,46,687,366,2293,18421
2022-06-11 17:00:00,2022-06-11 18:00:00,230,813,178,53,244,442,1960,18425
2022-06-11 18:00:00,2022-06-11 19:00:00,228,930,178,53,13,500,1902,18443
2022-06-11 19:00:00,2022-06-11 20:00:00,229,658,171,53,0,464,1575,17755
2022-06-11 20:00:00,2022-06-11 21:00:00,229,110,127,7,0,454,927,16495
2022-06-11 21:00:00,2022-06-11 22:00:00,222,0,122,0,0,667,1011,15253
2022-06-11 22:00:00,2022-06-11 23:00:00,219,0,122,0,0,964,1305,14576
2022-06-11 23:00:00,2022-06-12 00:00:00,220,0,122,0,0,1053,1395,14109
2022-06-12 00:00:00,2022-06-12 01:00:00,220,0,122,0,0,1007,1349,13838
2022-06-12 01:00:00,2022-06-12 02:00:00,224,0,122,0,36,930,1312,13188
2022-06-12 02:00:00,2022-06-12 03:00:00,228,0,122,0,238,817,1405,12947
2022-06-12 03:00:00,2022-06-12 04:00:00,230,0,121,0,853,663,1867,13345
2022-06-12 04:00:00,2022-06-12 05:00:00,230,0,121,0,2013,305,2669,14342
2022-06-12 05:00:00,2022-06-12 06:00:00,230,0,125,0,3315,188,3858,15277
2022-06-12 06:00:00,2022-06-12 07:00:00,228,0,132,0,4397,320,5077,15896
2022-06-12 07:00:00,2022-06-12 08:00:00,232,0,131,0,5003,352,5718,15972
2022-06-12 08:00:00,2022-06-12 09:00:00,230,0,131,0,5299,287,5947,16080
2022-06-12 09:00:00,2022-06-12 10:00:00,229,0,125,0,5094,334,5782,16185
2022-06-12 10:00:00,2022-06-12 11:00:00,228,0,125,0,4818,349,5520,16166
2022-06-12 11:00:00,2022-06-12 12:00:00,229,0,125,0,4678,370,5402,16169
2022-06-12 12:00:00,2022-06-12 13:00:00,228,0,124,0,4056,374,4782,15924
2022-06-12 13:00:00,2022-06-12 14:00:00,227,0,126,0,3139,424,3916,15855
2022-06-12 14:00:00,2022-06-12 15:00:00,228,7,127,0,2574,321,3257,16349
2022-06-12 15:00:00,2022-06-12 16:00:00,229,583,133,0,1547,298,2790,16838
2022-06-12 16:00:00,2022-06-12 17:00:00,229,681,174,0,596,229,1909,17088
2022-06-12 17:00:00,2022-06-12 18:00:00,230,693,179,46,195,224,1567,17359
2022-06-12 18:00:00,2022-06-12 19:00:00,229,454,175,53,13,348,1272,17628
2022-06-12 19:00:00,2022-06-12 20:00:00,230,338,149,53,0,453,1223,17287
2022-06-12 20:00:00,2022-06-12 21:00:00,230,50,125,7,0,510,922,16144
2022-06-12 21:00:00,2022-06-12 22:00:00,237,0,120,0,0,579,936,15179
2022-06-12 22:00:00,2022-06-12 23:00:00,247,16,119,0,0,698,1080,14768
2022-06-12 23:00:00,2022-06-13 00:00:00,252,2,119,0,0,819,1192,14601
2022-06-13 00:00:00,2022-06-13 01:00:00,253,0,119,0,0,913,1285,14647
2022-06-13 01:00:00,2022-06-13 02:00:00,262,7,119,0,29,786,1203,14454
2022-06-13 02:00:00,2022-06-13 03:00:00,263,4,119,0,237,732,1355,15051
2022-06-13 03:00:00,2022-06-13 04:00:00,258,0,118,0,748,640,1764,17740
2022-06-13 04:00:00,2022-06-13 05:00:00,241,307,118,0,1561,621,2848,20107
2022-06-13 05:00:00,2022-06-13 06:00:00,238,508,119,0,2274,876,4015,21364
2022-06-13 06:00:00,2022-06-13 07:00:00,241,320,121,0,3056,1254,4992,22027
2022-06-13 07:00:00,2022-06-13 08:00:00,241,153,120,0,3089,1529,5132,21727
2022-06-13 08:00:00,2022-06-13 09:00:00,239,17,118,0,3012,1754,5140,22035
2022-06-13 09:00:00,2022-06-13 10:00:00,239,0,117,0,2731,1815,4902,21928
2022-06-13 10:00:00,2022-06-13 11:00:00,241,0,116,0,2684,1933,4974,21943
2022-06-13 11:00:00,2022-06-13 12:00:00,239,0,116,0,2436,2410,5201,21764
2022-06-13 12:00:00,2022-06-13 13:00:00,238,0,116,0,2120,2639,5113,21700
2022-06-13 13:00:00,2022-06-13 14:00:00,239,0,116,0,1795,2651,4801,21377
2022-06-13 14:00:00,2022-06-13 15:00:00,237,24,116,0,1297,2553,4227,20901
2022-06-13 15:00:00,2022-06-13 16:00:00,241,253,120,0,863,2522,3999,20884
2022-06-13 16:00:00,2022-06-13 17:00:00,241,563,135,47,432,2365,3783,21157
2022-06-13 17:00:00,2022-06-13 18:00:00,240,518,172,53,185,2212,3380,21063
2022-06-13 18:00:00,2022-06-13 19:00:00,240,264,172,53,19,2385,3133,20623
2022-06-13 19:00:00,2022-06-13 20:00:00,239,60,150,53,0,2663,3165,19406
2022-06-13 20:00:00,2022-06-13 21:00:00,239,0,147,7,0,3092,3485,18069
2022-06-13 21:00:00,2022-06-13 22:00:00,227,0,123,0,0,3396,3746,16859
2022-06-13 22:00:00,2022-06-13 23:00:00,222,0,119,0,0,3646,3987,16227
2022-06-13 23:00:00,2022-06-14 00:00:00,223,0,119,0,0,3700,4042,15972
2022-06-14 00:00:00,2022-06-14 01:00:00,222,0,119,0,0,3748,4089,15905
2022-06-14 01:00:00,2022-06-14 02:00:00,224,0,119,0,28,3613,3984,15487
2022-06-14 02:00:00,2022-06-14 03:00:00,233,0,119,0,226,3336,3914,15980
2022-06-14 03:00:00,2022-06-14 04:00:00,234,0,117,0,818,2719,3888,18298
2022-06-14 04:00:00,2022-06-14 05:00:00,230,17,117,0,1952,2521,4837,20211
2022-06-14 05:00:00,2022-06-14 06:00:00,232,143,123,0,3391,2717,6606,21120
2022-06-14 06:00:00,2022-06-14 07:00:00,210,145,126,0,4000,3196,7677,21278
2022-06-14 07:00:00,2022-06-14 08:00:00,157,0,125,0,4082,3789,8153,20929
2022-06-14 08:00:00,2022-06-14 09:00:00,232,0,120,0,3848,4153,8353,21296
2022-06-14 09:00:00,2022-06-14 10:00:00,233,0,118,0,3916,4105,8372,21442
2022-06-14 10:00:00,2022-06-14 11:00:00,231,0,118,0,3942,4260,8551,21359
2022-06-14 11:00:00,2022-06-14 12:00:00,233,0,118,0,3827,4156,8334,21092
2022-06-14 12:00:00,2022-06-14 13:00:00,232,0,118,0,3357,4121,7828,20925
2022-06-14 13:00:00,2022-06-14 14:00:00,182,0,118,0,2962,4006,7268,20887
2022-06-14 14:00:00,2022-06-14 15:00:00,233,0,117,0,2120,3720,6190,20772
2022-06-14 15:00:00,2022-06-14 16:00:00,234,89,150,0,1384,3131,4988,21010
2022-06-14 16:00:00,2022-06-14 17:00:00,238,631,158,0,619,2448,4094,21176
2022-06-14 17:00:00,2022-06-14 18:00:00,237,1040,171,46,208,1964,3666,21193
2022-06-14 18:00:00,2022-06-14 19:00:00,239,963,172,53,15,1887,3329,20822
2022-06-14 19:00:00,2022-06-14 20:00:00,238,239,128,53,0,2110,2768,19756
2022-06-14 20:00:00,2022-06-14 21:00:00,232,18,123,7,0,2245,2625,18388
2022-06-14 21:00:00,2022-06-14 22:00:00,224,0,123,0,0,2211,2558,17160
2022-06-14 22:00:00,2022-06-14 23:00:00,222,0,123,0,0,2139,2484,16552
2022-06-14 23:00:00,2022-06-15 00:00:00,223,0,123,0,0,2029,2375,16154
2022-06-15 00:00:00,2022-06-15 01:00:00,220,0,123,0,0,1868,2211,16049
2022-06-15 01:00:00,2022-06-15 02:00:00,224,0,123,0,33,1737,2117,15773
2022-06-15 02:00:00,2022-06-15 03:00:00,232,0,123,0,259,1438,2052,16139
2022-06-15 03:00:00,2022-06-15 04:00:00,234,0,119,0,910,920,2183,18429
2022-06-15 04:00:00,2022-06-15 05:00:00,233,149,119,0,2097,495,3093,20345
2022-06-15 05:00:00,2022-06-15 06:00:00,232,545,120,0,3372,442,4711,21087
2022-06-15 06:00:00,2022-06-15 07:00:00,232,396,131,0,4367,549,5675,21192
2022-06-15 07:00:00,2022-06-15 08:00:00,235,149,124,0,4964,581,6053,21172
2022-06-15 08:00:00,2022-06-15 09:00:00,233,17,120,0,5191,624,6185,21376
2022-06-15 09:00:00,2022-06-15 10:00:00,233,0,116,0,5291,612,6252,21424
2022-06-15 10:00:00,2022-06-15 11:00:00,232,0,116,0,5217,603,6168,21258
2022-06-15 11:00:00,2022-06-15 12:00:00,232,0,116,0,5152,490,5990,21082
2022-06-15 12:00:00,2022-06-15 13:00:00,233,0,116,0,4740,421,5510,21170
2022-06-15 13:00:00,2022-06-15 14:00:00,233,0,115,0,3922,365,4635,21046
2022-06-15 14:00:00,2022-06-15 15:00:00,238,25,115,0,2980,331,3689,21113
2022-06-15 15:00:00,2022-06-15 16:00:00,240,449,121,0,1723,270,2803,20852
2022-06-15 16:00:00,2022-06-15 17:00:00,237,871,127,47,654,204,2140,20849
2022-06-15 17:00:00,2022-06-15 18:00:00,240,961,141,53,273,264,1932,20804
2022-06-15 18:00:00,2022-06-15 19:00:00,239,568,144,53,16,553,1573,20329
2022-06-15 19:00:00,2022-06-15 20:00:00,238,226,128,53,0,858,1503,19214
2022-06-15 20:00:00,2022-06-15 21:00:00,231,11,126,7,0,1064,1439,17702
2022-06-15 21:00:00,2022-06-15 22:00:00,225,10,129,0,0,1246,1610,16427
2022-06-15 22:00:00,2022-06-15 23:00:00,223,1,129,0,0,1341,1694,15672
2022-06-15 23:00:00,2022-06-16 00:00:00,223,0,129,0,0,1307,1659,15151
2022-06-16 00:00:00,2022-06-16 01:00:00,222,0,129,0,0,1262,1613,14795
2022-06-16 01:00:00,2022-06-16 02:00:00,221,0,129,0,37,1108,1495,14275
2022-06-16 02:00:00,2022-06-16 03:00:00,227,0,129,0,255,1154,1765,13689
2022-06-16 03:00:00,2022-06-16 04:00:00,235,0,126,0,861,1068,2290,13773
2022-06-16 04:00:00,2022-06-16 05:00:00,234,0,126,0,1979,615,2954,14517
2022-06-16 05:00:00,2022-06-16 06:00:00,234,0,128,0,3319,220,3901,15348
2022-06-16 06:00:00,2022-06-16 07:00:00,234,0,136,0,4256,224,4850,15808
2022-06-16 07:00:00,2022-06-16 08:00:00,234,0,136,0,5106,289,5765,16092
2022-06-16 08:00:00,2022-06-16 09:00:00,232,0,136,0,5412,371,6151,16152
2022-06-16 09:00:00,2022-06-16 10:00:00,232,0,136,0,5300,524,6192,16211
2022-06-16 10:00:00,2022-06-16 11:00:00,233,0,131,0,4888,661,5913,16381
2022-06-16 11:00:00,2022-06-16 12:00:00,235,0,130,0,4669,841,5875,16359
2022-06-16 12:00:00,2022-06-16 13:00:00,232,0,129,0,3720,1084,5165,15976
2022-06-16 13:00:00,2022-06-16 14:00:00,231,0,132,0,3195,1480,5038,16268
2022-06-16 14:00:00,2022-06-16 15:00:00,231,0,134,0,2059,1797,4221,16101
2022-06-16 15:00:00,2022-06-16 16:00:00,230,0,145,0,1065,1752,3192,16203
2022-06-16 16:00:00,2022-06-16 17:00:00,230,238,154,0,478,1625,2725,16495
2022-06-16 17:00:00,2022-06-16 18:00:00,231,673,166,46,207,1441,2764,16661
2022-06-16 18:00:00,2022-06-16 19:00:00,230,920,179,53,20,1320,2722,16738
2022-06-16 19:00:00,2022-06-16 20:00:00,231,503,166,53,0,1405,2358,16365
2022-06-16 20:00:00,2022-06-16 21:00:00,232,73,160,7,0,1438,1910,15275
2022-06-16 21:00:00,2022-06-16 22:00:00,224,4,136,0,0,1589,1953,14321
2022-06-16 22:00:00,2022-06-16 23:00:00,221,145,136,0,0,1664,2166,13812
2022-06-16 23:00:00,2022-06-17 00:00:00,221,82,136,0,0,1670,2109,13587
2022-06-17 00:00:00,2022-06-17 01:00:00,222,38,136,0,0,1725,2121,13464
2022-06-17 01:00:00,2022-06-17 02:00:00,222,4,136,0,29,1830,2221,13228
2022-06-17 02:00:00,2022-06-17 03:00:00,232,0,136,0,231,1510,2109,13555
2022-06-17 03:00:00,2022-06-17 04:00:00,234,0,132,0,764,903,2033,15259
2022-06-17 04:00:00,2022-06-17 05:00:00,231,0,133,0,1783,411,2558,16909
2022-06-17 05:00:00,2022-06-17 06:00:00,181,14,134,0,3136,351,3816,18065
2022-06-17 06:00:00,2022-06-17 07:00:00,231,14,134,0,4341,597,5317,18860
2022-06-17 07:00:00,2022-06-17 08:00:00,233,0,136,0,4754,997,6120,18623
2022-06-17 08:00:00,2022-06-17 09:00:00,233,0,137,0,5180,1111,6661,18750
2022-06-17 09:00:00,2022-06-17 10:00:00,233,0,137,0,5002,1186,6558,18624
2022-06-17 10:00:00,2022-06-17 11:00:00,232,0,136,0,4813,1249,6430,18511
2022-06-17 11:00:00,2022-06-17 12:00:00,231,0,136,0,4762,1148,6277,18390
2022-06-17 12:00:00,2022-06-17 13:00:00,232,0,135,0,4532,1118,6017,18770
2022-06-17 13:00:00,2022-06-17 14:00:00,232,0,135,0,3934,1073,5374,18894
2022-06-17 14:00:00,2022-06-17 15:00:00,234,0,136,0,2935,1029,4334,18931
2022-06-17 15:00:00,2022-06-17 16:00:00,238,271,139,0,1639,775,3062,18795
2022-06-17 16:00:00,2022-06-17 17:00:00,237,889,155,47,592,512,2432,18858
2022-06-17 17:00:00,2022-06-17 18:00:00,240,1280,185,53,246,402,2406,18942
2022-06-17 18:00:00,2022-06-17 19:00:00,239,1165,187,53,17,354,2015,18739
2022-06-17 19:00:00,2022-06-17 20:00:00,232,859,151,53,0,394,1689,18122
2022-06-17 20:00:00,2022-06-17 21:00:00,232,215,136,7,0,375,965,16821
2022-06-17 21:00:00,2022-06-17 22:00:00,225,0,133,0,0,368,726,15654
2022-06-17 22:00:00,2022-06-17 23:00:00,221,0,132,0,0,447,800,14964
2022-06-17 23:00:00,2022-06-18 00:00:00,221,0,131,0,0,699,1051,14500
2022-06-18 00:00:00,2022-06-18 01:00:00,221,17,132,0,0,1064,1434,14319
2022-06-18 01:00:00,2022-06-18 02:00:00,228,1,132,0,31,1480,1872,13934
2022-06-18 02:00:00,2022-06-18 03:00:00,231,0,133,0,242,1982,2588,14020
2022-06-18 03:00:00,2022-06-18 04:00:00,181,0,129,0,851,2278,3439,14953
2022-06-18 04:00:00,2022-06-18 05:00:00,188,0,128,0,1886,2012,4214,16175
2022-06-18 05:00:00,2022-06-18 06:00:00,232,0,129,0,3015,1440,4816,17293
2022-06-18 06:00:00,2022-06-18 07:00:00,233,0,130,0,3933,1343,5639,17939
2022-06-18 07:00:00,2022-06-18 08:00:00,233,0,136,0,4781,1475,6625,18348
2022-06-18 08:00:00,2022-06-18 09:00:00,232,0,130,0,5198,1697,7257,18225
2022-06-18 09:00:00,2022-06-18 10:00:00,234,0,129,0,5486,2236,8085,18189
2022-06-18 10:00:00,2022-06-18 11:00:00,232,0,129,0,5400,2636,8397,17789
2022-06-18 11:00:00,2022-06-18 12:00:00,233,0,129,0,5349,2668,8379,17542
2022-06-18 12:00:00,2022-06-18 13:00:00,232,0,130,0,4736,2488,7586,17366
2022-06-18 13:00:00,2022-06-18 14:00:00,233,0,127,0,4041,2384,6785,17512
2022-06-18 14:00:00,2022-06-18 15:00:00,232,0,126,0,2920,2135,5413,17758
2022-06-18 15:00:00,2022-06-18 16:00:00,233,166,131,0,1641,1781,3952,17879
2022-06-18 16:00:00,2022-06-18 17:00:00,232,906,136,46,714,1697,3731,17912
2022-06-18 17:00:00,2022-06-18 18:00:00,234,1122,184,53,235,1868,3696,17833
2022-06-18 18:00:00,2022-06-18 19:00:00,233,1099,191,53,16,2391,3983,17854
2022-06-18 19:00:00,2022-06-18 20:00:00,232,858,144,7,0,2571,3812,17320
2022-06-18 20:00:00,2022-06-18 21:00:00,232,636,136,0,0,2246,3250,15982
2022-06-18 21:00:00,2022-06-18 22:00:00,218,294,135,0,0,1877,2524,14948
2022-06-18 22:00:00,2022-06-18 23:00:00,222,40,135,0,0,1581,1978,14334
2022-06-18 23:00:00,2022-06-19 00:00:00,222,1,135,0,0,1386,1744,13967
2022-06-19 00:00:00,2022-06-19 01:00:00,222,0,135,0,0,1196,1553,13635
2022-06-19 01:00:00,2022-06-19 02:00:00,228,0,135,0,41,1153,1557,13097
2022-06-19 02:00:00,2022-06-19 03:00:00,233,0,133,0,261,1294,1921,12878
2022-06-19 03:00:00,2022-06-19 04:00:00,234,20,125,0,887,1342,2608,13355
2022-06-19 04:00:00,2022-06-19 05:00:00,233,268,125,0,1989,1144,3759,14205
2022-06-19 05:00:00,2022-06-19 06:00:00,233,286,125,0,3307,1061,5012,15044
2022-06-19 06:00:00,2022-06-19 07:00:00,233,114,124,0,4461,1300,6232,15644
2022-06-19 07:00:00,2022-06-19 08:00:00,234,0,124,0,5390,1722,7470,15968
2022-06-19 08:00:00,2022-06-19 09:00:00,233,0,124,0,5935,2813,9105,16149
2022-06-19 09:00:00,2022-06-19 10:00:00,234,0,125,0,6171,3476,10006,16122
2022-06-19 10:00:00,2022-06-19 11:00:00,231,0,125,0,6152,3562,10070,16193
2022-06-19 11:00:00,2022-06-19 12:00:00,231,0,124,0,5829,3858,10042,16043
2022-06-19 12:00:00,2022-06-19 13:00:00,230,0,124,0,5210,4306,9870,16053
2022-06-19 13:00:00,2022-06-19 14:00:00,232,0,124,0,4223,4648,9227,16446
2022-06-19 14:00:00,2022-06-19 15:00:00,230,0,124,0,2963,4540,7857,16795
2022-06-19 15:00:00,2022-06-19 16:00:00,232,0,128,0,1609,4371,6340,17141
2022-06-19 16:00:00,2022-06-19 17:00:00,230,314,136,0,625,3711,5016,17364
2022-06-19 17:00:00,2022-06-19 18:00:00,231,652,161,47,254,3717,5062,17480
2022-06-19 18:00:00,2022-06-19 19:00:00,229,354,163,53,22,3285,4106,17560
2022-06-19 19:00:00,2022-06-19 20:00:00,230,405,143,53,0,2254,3085,17373
2022-06-19 20:00:00,2022-06-19 21:00:00,229,442,129,7,0,1726,2533,16311
2022-06-19 21:00:00,2022-06-19 22:00:00,222,824,129,0,0,1368,2543,15377
2022-06-19 22:00:00,2022-06-19 23:00:00,223,243,129,0,0,1244,1839,14832
2022-06-19 23:00:00,2022-06-20 00:00:00,219,0,129,0,0,1235,1583,14529
2022-06-20 00:00:00,2022-06-20 01:00:00,220,0,129,0,0,1142,1491,14410
2022-06-20 01:00:00,2022-06-20 02:00:00,226,0,129,0,26,996,1377,14267
2022-06-20 02:00:00,2022-06-20 03:00:00,231,0,128,0,162,766,1287,15014
2022-06-20 03:00:00,2022-06-20 04:00:00,233,11,124,0,632,442,1442,18026
2022-06-20 04:00:00,2022-06-20 05:00:00,232,28,124,0,1487,293,2164,20335
2022-06-20 05:00:00,2022-06-20 06:00:00,234,96,139,0,2306,252,3027,21539
2022-06-20 06:00:00,2022-06-20 07:00:00,237,12,162,0,2920,342,3673,21821
2022-06-20 07:00:00,2022-06-20 08:00:00,216,0,132,0,3422,492,4262,21847
2022-06-20 08:00:00,2022-06-20 09:00:00,113,0,126,0,3642,761,4642,22229
2022-06-20 09:00:00,2022-06-20 10:00:00,240,0,123,0,3313,755,4431,22662
2022-06-20 10:00:00,2022-06-20 11:00:00,239,326,123,0,3077,660,4425,23050
2022-06-20 11:00:00,2022-06-20 12:00:00,237,508,124,0,2023,420,3312,22419
2022-06-20 12:00:00,2022-06-20 13:00:00,237,459,124,0,1378,691,2889,22290
2022-06-20 13:00:00,2022-06-20 14:00:00,237,533,123,0,930,1070,2893,21836
2022-06-20 14:00:00,2022-06-20 15:00:00,236,486,124,0,788,1240,2874,21527
2022-06-20 15:00:00,2022-06-20 16:00:00,236,359,131,0,712,1081,2519,21587
2022-06-20 16:00:00,2022-06-20 17:00:00,237,532,163,0,335,1026,2293,21631
2022-06-20 17:00:00,2022-06-20 18:00:00,236,682,184,46,141,993,2282,21529
2022-06-20 18:00:00,2022-06-20 19:00:00,238,538,191,53,10,1149,2179,20825
2022-06-20 19:00:00,2022-06-20 20:00:00,237,159,178,53,0,1406,2033,19713
2022-06-20 20:00:00,2022-06-20 21:00:00,230,0,176,7,0,1864,2277,18315
2022-06-20 21:00:00,2022-06-20 22:00:00,222,11,162,0,0,2128,2523,17184
2022-06-20 22:00:00,2022-06-20 23:00:00,222,1,159,0,0,2185,2567,16529
2022-06-20 23:00:00,2022-06-21 00:00:00,223,0,159,0,0,2376,2758,16158
2022-06-21 00:00:00,2022-06-21 01:00:00,220,0,159,0,0,2730,3109,16136
2022-06-21 01:00:00,2022-06-21 02:00:00,228,0,159,0,23,2910,3320,15799
2022-06-21 02:00:00,2022-06-21 03:00:00,232,0,157,0,163,3098,3650,16273
2022-06-21 03:00:00,2022-06-21 04:00:00,234,0,150,0,659,3090,4133,18400
2022-06-21 04:00:00,2022-06-21 05:00:00,233,33,123,0,1463,3289,5141,20267
2022-06-21 05:00:00,2022-06-21 06:00:00,234,332,124,0,2408,3498,6596,21247
2022-06-21 06:00:00,2022-06-21 07:00:00,234,164,122,0,3202,4047,7769,21649
2022-06-21 07:00:00,2022-06-21 08:00:00,234,0,120,0,3533,4469,8356,21358
2022-06-21 08:00:00,2022-06-21 09:00:00,233,0,120,0,3729,4479,8561,21725
2022-06-21 09:00:00,2022-06-21 10:00:00,232,0,115,0,3899,4429,8675,21836
2022-06-21 10:00:00,2022-06-21 11:00:00,232,0,115,0,4069,4228,8644,21809
2022-06-21 11:00:00,2022-06-21 12:00:00,234,0,116,0,3667,3993,8010,21122
2022-06-21 12:00:00,2022-06-21 13:00:00,235,0,116,0,3512,3713,7576,20948
2022-06-21 13:00:00,2022-06-21 14:00:00,236,0,116,0,3104,3452,6908,20819
2022-06-21 14:00:00,2022-06-21 15:00:00,234,0,116,0,2461,3176,5987,20882
2022-06-21 15:00:00,2022-06-21 16:00:00,235,66,118,0,1583,2892,4894,21095
2022-06-21 16:00:00,2022-06-21 17:00:00,236,356,123,0,581,2272,3568,21032
2022-06-21 17:00:00,2022-06-21 18:00:00,237,561,137,46,227,1823,3031,21131
2022-06-21 18:00:00,2022-06-21 19:00:00,237,564,141,53,17,1883,2895,20673
2022-06-21 19:00:00,2022-06-21 20:00:00,234,356,126,53,0,1851,2620,19669
2022-06-21 20:00:00,2022-06-21 21:00:00,238,13,123,7,0,1860,2241,18228
2022-06-21 21:00:00,2022-06-21 22:00:00,239,0,120,0,0,1897,2256,17018
2022-06-21 22:00:00,2022-06-21 23:00:00,197,0,118,0,0,1850,2165,16369
2022-06-21 23:00:00,2022-06-22 00:00:00,217,0,118,0,0,1683,2018,15995
2022-06-22 00:00:00,2022-06-22 01:00:00,248,17,118,0,0,1576,1959,15974
2022-06-22 01:00:00,2022-06-22 02:00:00,254,85,118,0,27,1506,1990,15728
2022-06-22 02:00:00,2022-06-22 03:00:00,252,0,116,0,199,1234,1801,16069
2022-06-22 03:00:00,2022-06-22 04:00:00,262,0,112,0,828,823,2025,18427
2022-06-22 04:00:00,2022-06-22 05:00:00,265,0,112,0,2190,410,2977,20434
2022-06-22 05:00:00,2022-06-22 06:00:00,195,0,113,0,3666,378,4352,21091
2022-06-22 06:00:00,2022-06-22 07:00:00,170,0,113,0,4835,467,5585,21033
2022-06-22 07:00:00,2022-06-22 08:00:00,149,0,112,0,5542,521,6324,20679
2022-06-22 08:00:00,2022-06-22 09:00:00,267,0,111,0,5917,607,6902,21099
2022-06-22 09:00:00,2022-06-22 10:00:00,268,0,111,0,5879,601,6859,21181
2022-06-22 10:00:00,2022-06-22 11:00:00,264,0,111,0,5742,526,6643,21083
2022-06-22 11:00:00,2022-06-22 12:00:00,269,0,116,0,5397,596,6378,20708
2022-06-22 12:00:00,2022-06-22 13:00:00,267,0,118,0,5134,591,6110,21324
2022-06-22 13:00:00,2022-06-22 14:00:00,269,0,117,0,4360,501,5247,21373
2022-06-22 14:00:00,2022-06-22 15:00:00,270,71,117,0,3199,415,4072,21391
2022-06-22 15:00:00,2022-06-22 16:00:00,271,271,151,0,1808,362,2863,21313
2022-06-22 16:00:00,2022-06-22 17:00:00,273,725,160,46,657,305,2166,21433
2022-06-22 17:00:00,2022-06-22 18:00:00,272,1065,169,53,252,413,2224,21537
2022-06-22 18:00:00,2022-06-22 19:00:00,286,805,171,53,14,492,1821,21011
2022-06-22 19:00:00,2022-06-22 20:00:00,282,391,147,7,0,613,1440,20075
2022-06-22 20:00:00,2022-06-22 21:00:00,264,107,120,0,0,623,1114,18518
2022-06-22 21:00:00,2022-06-22 22:00:00,265,0,119,0,0,618,1002,17256
2022-06-22 22:00:00,2022-06-22 23:00:00,267,0,119,0,0,596,982,16588
2022-06-22 23:00:00,2022-06-23 00:00:00,266,0,119,0,0,489,874,16197
2022-06-23 00:00:00,2022-06-23 01:00:00,256,0,119,0,0,376,751,16055
2022-06-23 01:00:00,2022-06-23 02:00:00,249,0,119,0,32,290,690,15818
2022-06-23 02:00:00,2022-06-23 03:00:00,249,0,118,0,196,239,802,16181
2022-06-23 03:00:00,2022-06-23 04:00:00,249,0,116,0,837,178,1380,18547
2022-06-23 04:00:00,2022-06-23 05:00:00,249,27,116,0,2100,74,2566,20624
2022-06-23 05:00:00,2022-06-23 06:00:00,254,399,125,0,3562,36,4376,21546
2022-06-23 06:00:00,2022-06-23 07:00:00,253,302,129,0,4746,38,5468,21739
2022-06-23 07:00:00,2022-06-23 08:00:00,255,0,121,0,5440,45,5861,21690
2022-06-23 08:00:00,2022-06-23 09:00:00,254,0,115,0,5797,45,6211,21964
2022-06-23 09:00:00,2022-06-23 10:00:00,253,0,115,0,5883,33,6284,22007
2022-06-23 10:00:00,2022-06-23 11:00:00,252,0,116,0,5747,36,6151,21699
2022-06-23 11:00:00,2022-06-23 12:00:00,255,0,116,0,5800,50,6221,21795
2022-06-23 12:00:00,2022-06-23 13:00:00,253,0,116,0,5264,65,5698,21850
2022-06-23 13:00:00,2022-06-23 14:00:00,255,0,116,0,4469,93,4933,21849
2022-06-23 14:00:00,2022-06-23 15:00:00,254,24,116,0,3305,157,3856,21854
2022-06-23 15:00:00,2022-06-23 16:00:00,254,513,122,0,1873,250,3012,21640
2022-06-23 16:00:00,2022-06-23 17:00:00,254,1104,122,46,679,422,2627,21681
2022-06-23 17:00:00,2022-06-23 18:00:00,254,744,175,53,324,738,2288,21816
2022-06-23 18:00:00,2022-06-23 19:00:00,254,565,184,53,34,1296,2386,21276
2022-06-23 19:00:00,2022-06-23 20:00:00,250,464,155,53,0,1791,2713,20350
2022-06-23 20:00:00,2022-06-23 21:00:00,249,38,126,7,0,2031,2451,18843
2022-06-23 21:00:00,2022-06-23 22:00:00,251,12,122,0,0,2079,2464,17461
2022-06-23 22:00:00,2022-06-23 23:00:00,251,1,121,0,0,2240,2613,16535
2022-06-23 23:00:00,2022-06-24 00:00:00,249,0,121,0,0,2481,2851,16224
2022-06-24 00:00:00,2022-06-24 01:00:00,249,0,121,0,0,2708,3078,15995
2022-06-24 01:00:00,2022-06-24 02:00:00,250,0,121,0,51,2944,3366,15733
2022-06-24 02:00:00,2022-06-24 03:00:00,249,0,121,0,250,2963,3583,16178
2022-06-24 03:00:00,2022-06-24 04:00:00,250,0,119,0,878,2700,3947,18575
2022-06-24 04:00:00,2022-06-24 05:00:00,250,133,117,0,2239,1511,4250,20879
2022-06-24 05:00:00,2022-06-24 06:00:00,252,153,124,0,3698,842,5069,21676
2022-06-24 06:00:00,2022-06-24 07:00:00,249,7,128,0,4887,1300,6571,21552
2022-06-24 07:00:00,2022-06-24 08:00:00,250,0,128,0,5709,2262,8349,21351
2022-06-24 08:00:00,2022-06-24 09:00:00,250,0,128,0,6193,2675,9246,21533
2022-06-24 09:00:00,2022-06-24 10:00:00,250,0,120,0,6249,2723,9342,21554
2022-06-24 10:00:00,2022-06-24 11:00:00,251,0,118,0,5992,2826,9187,21328
2022-06-24 11:00:00,2022-06-24 12:00:00,250,0,116,0,5578,2936,8880,21018
2022-06-24 12:00:00,2022-06-24 13:00:00,249,0,116,0,5227,2907,8499,21478
2022-06-24 13:00:00,2022-06-24 14:00:00,248,0,116,0,4269,2926,7559,21568
2022-06-24 14:00:00,2022-06-24 15:00:00,253,0,116,0,3178,2951,6498,21693
2022-06-24 15:00:00,2022-06-24 16:00:00,256,75,119,0,1695,2852,4997,21579
2022-06-24 16:00:00,2022-06-24 17:00:00,253,500,132,0,720,2650,4255,21609
2022-06-24 17:00:00,2022-06-24 18:00:00,254,770,154,46,326,2740,4290,21370
2022-06-24 18:00:00,2022-06-24 19:00:00,230,392,155,53,37,3442,4309,20858
2022-06-24 19:00:00,2022-06-24 20:00:00,223,69,145,7,0,4105,4549,20111
2022-06-24 20:00:00,2022-06-24 21:00:00,224,0,117,0,0,4448,4789,18771
2022-06-24 21:00:00,2022-06-24 22:00:00,224,0,113,0,0,4355,4692,17556
2022-06-24 22:00:00,2022-06-24 23:00:00,222,0,113,0,0,4070,4405,16716
2022-06-24 23:00:00,2022-06-25 00:00:00,222,0,113,0,0,3784,4119,16230
2022-06-25 00:00:00,2022-06-25 01:00:00,224,0,113,0,0,3423,3760,15959
2022-06-25 01:00:00,2022-06-25 02:00:00,223,0,113,0,52,3207,3595,15399
2022-06-25 02:00:00,2022-06-25 03:00:00,223,48,113,0,254,2977,3615,15275
2022-06-25 03:00:00,2022-06-25 04:00:00,224,15,111,0,842,2212,3404,16269
2022-06-25 04:00:00,2022-06-25 05:00:00,222,0,110,0,2026,1180,3538,17502
2022-06-25 05:00:00,2022-06-25 06:00:00,224,0,110,0,3478,683,4495,18722
2022-06-25 06:00:00,2022-06-25 07:00:00,223,0,110,0,4617,764,5714,19355
2022-06-25 07:00:00,2022-06-25 08:00:00,222,0,110,0,5214,1250,6796,19203
2022-06-25 08:00:00,2022-06-25 09:00:00,220,0,110,0,5667,1590,7587,19325
2022-06-25 09:00:00,2022-06-25 10:00:00,226,4,112,0,5831,1428,7601,19316
2022-06-25 10:00:00,2022-06-25 11:00:00,223,15,112,0,6014,1188,7552,19565
2022-06-25 11:00:00,2022-06-25 12:00:00,223,17,112,0,5368,1046,6766,19057
2022-06-25 12:00:00,2022-06-25 13:00:00,220,10,112,0,4749,986,6077,18971
2022-06-25 13:00:00,2022-06-25 14:00:00,222,22,112,0,4050,868,5274,18967
2022-06-25 14:00:00,2022-06-25 15:00:00,224,196,112,0,2867,897,4296,18994
2022-06-25 15:00:00,2022-06-25 16:00:00,223,525,113,0,1702,922,3485,19104
2022-06-25 16:00:00,2022-06-25 17:00:00,225,827,118,0,714,932,2816,19051
2022-06-25 17:00:00,2022-06-25 18:00:00,222,1186,159,46,309,1172,3094,18871
2022-06-25 18:00:00,2022-06-25 19:00:00,221,781,162,53,36,1680,2933,18653
2022-06-25 19:00:00,2022-06-25 20:00:00,224,601,126,7,0,2160,3118,18080
2022-06-25 20:00:00,2022-06-25 21:00:00,222,86,117,0,0,2495,2920,16823
2022-06-25 21:00:00,2022-06-25 22:00:00,221,0,109,0,0,2625,2955,15700
2022-06-25 22:00:00,2022-06-25 23:00:00,228,0,108,0,0,2642,2978,14942
2022-06-25 23:00:00,2022-06-26 00:00:00,224,0,108,0,0,2538,2870,14468
2022-06-26 00:00:00,2022-06-26 01:00:00,223,0,108,0,0,2338,2669,14208
2022-06-26 01:00:00,2022-06-26 02:00:00,222,0,108,0,53,2109,2492,13672
2022-06-26 02:00:00,2022-06-26 03:00:00,222,0,108,0,261,1833,2424,13525
2022-06-26 03:00:00,2022-06-26 04:00:00,224,0,113,0,845,1338,2520,14170
2022-06-26 04:00:00,2022-06-26 05:00:00,224,0,113,0,2133,570,3040,15233
2022-06-26 05:00:00,2022-06-26 06:00:00,223,0,119,0,3535,147,4024,16194
2022-06-26 06:00:00,2022-06-26 07:00:00,220,0,123,0,4720,181,5244,16767
2022-06-26 07:00:00,2022-06-26 08:00:00,217,17,116,0,5540,576,6466,17140
2022-06-26 08:00:00,2022-06-26 09:00:00,220,24,115,0,5957,996,7312,17299
2022-06-26 09:00:00,2022-06-26 10:00:00,225,7,111,0,5981,1084,7408,17280
2022-06-26 10:00:00,2022-06-26 11:00:00,223,6,110,0,5614,972,6925,17063
2022-06-26 11:00:00,2022-06-26 12:00:00,223,4,111,0,5117,837,6292,16857
2022-06-26 12:00:00,2022-06-26 13:00:00,221,4,111,0,4826,740,5902,17147
2022-06-26 13:00:00,2022-06-26 14:00:00,221,0,111,0,4035,761,5128,17480
2022-06-26 14:00:00,2022-06-26 15:00:00,222,57,110,0,3024,781,4194,17827
2022-06-26 15:00:00,2022-06-26 16:00:00,225,500,112,0,1747,862,3446,18038
2022-06-26 16:00:00,2022-06-26 17:00:00,222,724,126,0,684,976,2732,18145
2022-06-26 17:00:00,2022-06-26 18:00:00,223,866,152,46,283,1280,2850,18111
2022-06-26 18:00:00,2022-06-26 19:00:00,222,608,155,53,32,1901,2971,18152
2022-06-26 19:00:00,2022-06-26 20:00:00,222,522,141,7,0,2471,3363,17918
2022-06-26 20:00:00,2022-06-26 21:00:00,221,55,139,0,0,2956,3371,16731
2022-06-26 21:00:00,2022-06-26 22:00:00,221,10,135,0,0,3252,3618,15716
2022-06-26 22:00:00,2022-06-26 23:00:00,223,0,134,0,0,3285,3642,15078
2022-06-26 23:00:00,2022-06-27 00:00:00,223,0,134,0,0,3178,3535,14777
2022-06-27 00:00:00,2022-06-27 01:00:00,222,0,134,0,0,2959,3315,14651
2022-06-27 01:00:00,2022-06-27 02:00:00,222,0,134,0,48,2837,3241,14554
2022-06-27 02:00:00,2022-06-27 03:00:00,222,0,134,0,247,2590,3193,15216
2022-06-27 03:00:00,2022-06-27 04:00:00,222,0,134,0,818,2021,3195,18170
2022-06-27 04:00:00,2022-06-27 05:00:00,224,104,135,0,2089,930,3482,20755
2022-06-27 05:00:00,2022-06-27 06:00:00,227,201,119,0,3485,443,4475,22046
2022-06-27 06:00:00,2022-06-27 07:00:00,225,6,108,0,4641,770,5750,22423
2022-06-27 07:00:00,2022-06-27 08:00:00,226,0,106,0,5499,1512,7343,22310
2022-06-27 08:00:00,2022-06-27 09:00:00,226,0,111,0,5932,2044,8313,22571
2022-06-27 09:00:00,2022-06-27 10:00:00,224,0,111,0,6084,2167,8586,22733
2022-06-27 10:00:00,2022-06-27 11:00:00,227,2,111,0,5832,2017,8189,22549
2022-06-27 11:00:00,2022-06-27 12:00:00,226,8,111,0,5690,1888,7923,22529
2022-06-27 12:00:00,2022-06-27 13:00:00,226,0,110,0,4957,1871,7164,22591
2022-06-27 13:00:00,2022-06-27 14:00:00,228,0,110,0,4027,1721,6086,22517
2022-06-27 14:00:00,2022-06-27 15:00:00,226,6,110,0,2835,1641,4818,22509
2022-06-27 15:00:00,2022-06-27 16:00:00,224,458,110,0,1587,1558,3937,22505
2022-06-27 16:00:00,2022-06-27 17:00:00,225,866,124,46,599,1530,3390,22489
2022-06-27 17:00:00,2022-06-27 18:00:00,225,785,127,53,234,1918,3342,22318
2022-06-27 18:00:00,2022-06-27 19:00:00,227,539,119,7,21,2777,3690,21836
2022-06-27 19:00:00,2022-06-27 20:00:00,226,9,111,0,0,3352,3698,20788
2022-06-27 20:00:00,2022-06-27 21:00:00,225,0,111,0,0,3684,4020,19181
2022-06-27 21:00:00,2022-06-27 22:00:00,224,0,106,0,0,3652,3982,17853
2022-06-27 22:00:00,2022-06-27 23:00:00,218,0,104,0,0,3578,3900,17195
2022-06-27 23:00:00,2022-06-28 00:00:00,222,0,104,0,0,3206,3532,16868
2022-06-28 00:00:00,2022-06-28 01:00:00,221,0,104,0,0,2968,3293,16626
2022-06-28 01:00:00,2022-06-28 02:00:00,220,0,104,0,35,2659,3018,16311
2022-06-28 02:00:00,2022-06-28 03:00:00,221,0,104,0,217,2580,3122,16698
2022-06-28 03:00:00,2022-06-28 04:00:00,223,0,105,0,775,2415,3518,19198
2022-06-28 04:00:00,2022-06-28 05:00:00,225,0,105,0,1620,2100,4050,21370
2022-06-28 05:00:00,2022-06-28 06:00:00,226,181,105,0,2634,1677,4823,22493
2022-06-28 06:00:00,2022-06-28 07:00:00,224,152,104,0,3268,1494,5242,22810
2022-06-28 07:00:00,2022-06-28 08:00:00,226,0,106,0,3612,1321,5265,22638
2022-06-28 08:00:00,2022-06-28 09:00:00,228,0,106,0,3651,1234,5219,22890
2022-06-28 09:00:00,2022-06-28 10:00:00,226,40,105,0,3420,1313,5104,23004
2022-06-28 10:00:00,2022-06-28 11:00:00,225,370,104,0,3160,1412,5271,22719
2022-06-28 11:00:00,2022-06-28 12:00:00,226,85,104,0,3050,1341,4806,22639
2022-06-28 12:00:00,2022-06-28 13:00:00,226,0,104,0,2730,1422,4482,22589
2022-06-28 13:00:00,2022-06-28 14:00:00,226,0,104,0,2420,1540,4290,22498
2022-06-28 14:00:00,2022-06-28 15:00:00,228,0,104,0,1725,1379,3436,22281
2022-06-28 15:00:00,2022-06-28 16:00:00,235,0,115,0,979,939,2268,21928
2022-06-28 16:00:00,2022-06-28 17:00:00,238,489,153,46,540,676,2142,22124
2022-06-28 17:00:00,2022-06-28 18:00:00,238,428,167,53,167,601,1654,21883
2022-06-28 18:00:00,2022-06-28 19:00:00,233,182,151,7,14,808,1395,21448
2022-06-28 19:00:00,2022-06-28 20:00:00,231,13,147,0,0,948,1339,20514
2022-06-28 20:00:00,2022-06-28 21:00:00,226,0,140,0,0,774,1140,19067
2022-06-28 21:00:00,2022-06-28 22:00:00,223,0,101,0,0,764,1088,17749
2022-06-28 22:00:00,2022-06-28 23:00:00,223,0,99,0,0,740,1062,17035
2022-06-28 23:00:00,2022-06-29 00:00:00,221,0,99,0,0,737,1057,16625
2022-06-29 00:00:00,2022-06-29 01:00:00,223,0,99,0,0,752,1074,16598
2022-06-29 01:00:00,2022-06-29 02:00:00,224,0,99,0,29,651,1003,16293
2022-06-29 02:00:00,2022-06-29 03:00:00,222,0,99,0,185,583,1089,16767
2022-06-29 03:00:00,2022-06-29 04:00:00,224,13,101,0,646,346,1330,19136
2022-06-29 04:00:00,2022-06-29 05:00:00,227,97,102,0,1470,159,2055,21296
2022-06-29 05:00:00,2022-06-29 06:00:00,228,105,104,0,2246,164,2847,22241
2022-06-29 06:00:00,2022-06-29 07:00:00,227,11,104,0,2909,134,3385,22450
2022-06-29 07:00:00,2022-06-29 08:00:00,229,0,103,0,3735,128,4195,22524
2022-06-29 08:00:00,2022-06-29 09:00:00,228,0,104,0,4189,122,4643,22656
2022-06-29 09:00:00,2022-06-29 10:00:00,226,0,103,0,4519,134,4982,22577
2022-06-29 10:00:00,2022-06-29 11:00:00,227,0,103,0,4877,183,5390,22668
2022-06-29 11:00:00,2022-06-29 12:00:00,226,0,103,0,4701,203,5233,22532
2022-06-29 12:00:00,2022-06-29 13:00:00,235,0,103,0,3891,258,4487,22509
2022-06-29 13:00:00,2022-06-29 14:00:00,237,0,103,0,3471,270,4081,22879
2022-06-29 14:00:00,2022-06-29 15:00:00,236,169,103,0,2708,265,3481,22842
2022-06-29 15:00:00,2022-06-29 16:00:00,236,773,104,0,1336,341,2790,22189
2022-06-29 16:00:00,2022-06-29 17:00:00,236,1034,117,46,558,451,2442,22312
2022-06-29 17:00:00,2022-06-29 18:00:00,236,995,158,53,205,492,2139,22226
2022-06-29 18:00:00,2022-06-29 19:00:00,238,500,155,7,21,689,1610,21852
2022-06-29 19:00:00,2022-06-29 20:00:00,228,301,125,0,0,967,1621,20695
2022-06-29 20:00:00,2022-06-29 21:00:00,221,25,111,0,0,1183,1540,19145
2022-06-29 21:00:00,2022-06-29 22:00:00,224,0,106,0,0,1475,1805,17849
2022-06-29 22:00:00,2022-06-29 23:00:00,221,0,104,0,0,1464,1789,17088
2022-06-29 23:00:00,2022-06-30 00:00:00,220,0,104,0,0,1332,1656,16677
2022-06-30 00:00:00,2022-06-30 01:00:00,222,0,104,0,0,1160,1486,16651
2022-06-30 01:00:00,2022-06-30 02:00:00,222,0,104,0,32,1094,1452,16520
2022-06-30 02:00:00,2022-06-30 03:00:00,221,0,105,0,179,1000,1505,16710
2022-06-30 03:00:00,2022-06-30 04:00:00,223,0,104,0,626,1124,2077,18944
2022-06-30 04:00:00,2022-06-30 05:00:00,227,0,104,0,1520,1092,2943,21108
2022-06-30 05:00:00,2022-06-30 06:00:00,227,0,104,0,2601,971,3903,22252
2022-06-30 06:00:00,2022-06-30 07:00:00,226,0,106,0,3540,727,4599,22580
2022-06-30 07:00:00,2022-06-30 08:00:00,226,0,113,0,4517,586,5442,22765
2022-06-30 08:00:00,2022-06-30 09:00:00,227,19,114,0,5053,557,5970,23057
2022-06-30 09:00:00,2022-06-30 10:00:00,228,0,113,0,5183,518,6042,23304
2022-06-30 10:00:00,2022-06-30 11:00:00,226,0,113,0,4939,466,5744,23168
2022-06-30 11:00:00,2022-06-30 12:00:00,224,0,113,0,4238,516,5091,22776
2022-06-30 12:00:00,2022-06-30 13:00:00,232,0,112,0,3505,530,4379,22818
2022-06-30 13:00:00,2022-06-30 14:00:00,233,57,115,0,3002,546,3953,22999
2022-06-30 14:00:00,2022-06-30 15:00:00,231,475,115,0,1964,659,3444,22760
2022-06-30 15:00:00,2022-06-30 16:00:00,225,762,122,46,1164,691,3010,22633
2022-06-30 16:00:00,2022-06-30 17:00:00,235,1075,159,53,620,1020,3162,22840
2022-06-30 17:00:00,2022-06-30 18:00:00,237,447,172,53,220,1049,2178,22647
2022-06-30 18:00:00,2022-06-30 19:00:00,238,563,163,7,15,1047,2033,22066
2022-06-30 19:00:00,2022-06-30 20:00:00,229,90,139,0,0,893,1351,20947
2022-06-30 20:00:00,2022-06-30 21:00:00,220,131,119,0,0,953,1423,19345
2022-06-30 21:00:00,2022-06-30 22:00:00,226,114,112,0,0,1210,1662,18100
2022-06-30 22:00:00,2022-06-30 23:00:00,231,4,108,0,0,1308,1651,17381
2022-06-30 23:00:00,2022-07-01 00:00:00,234,0,108,0,0,1375,1717,16981
2022-07-01 00:00:00,2022-07-01 01:00:00,235,6,108,0,0,1622,1971,16783
2022-07-01 01:00:00,2022-07-01 02:00:00,233,1,108,0,15,1555,1912,16507
2022-07-01 02:00:00,2022-07-01 03:00:00,237,0,108,0,181,1544,2070,16891
2022-07-01 03:00:00,2022-07-01 04:00:00,232,0,103,0,737,1515,2587,19272
2022-07-01 04:00:00,2022-07-01 05:00:00,224,72,103,46,1859,910,3214,21465
2022-07-01 05:00:00,2022-07-01 06:00:00,236,118,103,7,3134,448,4046,22743
2022-07-01 06:00:00,2022-07-01 07:00:00,236,61,106,0,4095,364,4862,23095
2022-07-01 07:00:00,2022-07-01 08:00:00,235,308,109,0,4873,494,6019,23166
2022-07-01 08:00:00,2022-07-01 09:00:00,232,35,105,0,5386,791,6549,23473
2022-07-01 09:00:00,2022-07-01 10:00:00,237,0,105,0,5544,1101,6987,23514
2022-07-01 10:00:00,2022-07-01 11:00:00,235,0,106,0,5215,1462,7018,23274
2022-07-01 11:00:00,2022-07-01 12:00:00,234,0,106,0,4740,2007,7087,22969
2022-07-01 12:00:00,2022-07-01 13:00:00,236,0,110,0,3785,2616,6747,22948
2022-07-01 13:00:00,2022-07-01 14:00:00,230,0,110,0,3016,3340,6696,23056
2022-07-01 14:00:00,2022-07-01 15:00:00,199,0,110,0,1683,3742,5734,22384
2022-07-01 15:00:00,2022-07-01 16:00:00,236,78,108,0,824,3438,4684,22020
2022-07-01 16:00:00,2022-07-01 17:00:00,234,354,122,46,406,3260,4422,22159
2022-07-01 17:00:00,2022-07-01 18:00:00,235,293,126,53,139,2992,3838,21764
2022-07-01 18:00:00,2022-07-01 19:00:00,233,299,121,7,12,2582,3254,21147
2022-07-01 19:00:00,2022-07-01 20:00:00,237,286,115,0,0,2723,3361,20094
2022-07-01 20:00:00,2022-07-01 21:00:00,233,65,114,0,0,2611,3023,18584
2022-07-01 21:00:00,2022-07-01 22:00:00,179,317,105,0,0,2503,3104,17337
2022-07-01 22:00:00,2022-07-01 23:00:00,177,425,101,0,0,2674,3377,16674
2022-07-01 23:00:00,2022-07-02 00:00:00,212,162,101,0,0,2545,3020,16307
2022-07-02 00:00:00,2022-07-02 01:00:00,238,0,101,0,0,2508,2847,16130
2022-07-02 01:00:00,2022-07-02 02:00:00,237,0,101,0,22,2392,2752,15704
2022-07-02 02:00:00,2022-07-02 03:00:00,233,31,100,0,139,2337,2840,15479
2022-07-02 03:00:00,2022-07-02 04:00:00,237,12,100,0,420,2354,3123,16294
2022-07-02 04:00:00,2022-07-02 05:00:00,236,0,103,0,901,2005,3245,17197
2022-07-02 05:00:00,2022-07-02 06:00:00,235,0,103,0,1519,1726,3583,18167
2022-07-02 06:00:00,2022-07-02 07:00:00,234,0,104,0,2000,1795,4133,18974
2022-07-02 07:00:00,2022-07-02 08:00:00,235,0,112,0,2563,1785,4695,19279
2022-07-02 08:00:00,2022-07-02 09:00:00,235,0,112,0,2814,1632,4793,19423
2022-07-02 09:00:00,2022-07-02 10:00:00,233,0,112,0,2849,1467,4661,19252
2022-07-02 10:00:00,2022-07-02 11:00:00,234,0,109,0,2844,1269,4456,19017
2022-07-02 11:00:00,2022-07-02 12:00:00,237,0,108,0,2943,1047,4335,18622
2022-07-02 12:00:00,2022-07-02 13:00:00,235,0,115,0,2797,800,3947,18391
2022-07-02 13:00:00,2022-07-02 14:00:00,237,114,109,0,2516,635,3611,18133
2022-07-02 14:00:00,2022-07-02 15:00:00,236,468,98,0,2071,510,3383,17976
2022-07-02 15:00:00,2022-07-02 16:00:00,235,537,100,0,1245,382,2499,18012
2022-07-02 16:00:00,2022-07-02 17:00:00,235,717,114,0,463,288,1817,17963
2022-07-02 17:00:00,2022-07-02 18:00:00,234,896,149,46,152,284,1761,17836
2022-07-02 18:00:00,2022-07-02 19:00:00,234,824,143,53,15,478,1747,17770
2022-07-02 19:00:00,2022-07-02 20:00:00,236,637,113,53,0,709,1748,17390
2022-07-02 20:00:00,2022-07-02 21:00:00,234,255,95,7,0,924,1515,16228
2022-07-02 21:00:00,2022-07-02 22:00:00,235,140,94,0,0,1031,1500,15241
2022-07-02 22:00:00,2022-07-02 23:00:00,234,3,93,0,0,1068,1398,14489
2022-07-02 23:00:00,2022-07-03 00:00:00,237,0,93,0,0,1053,1383,14080
2022-07-03 00:00:00,2022-07-03 01:00:00,234,0,93,0,0,1032,1359,13753
2022-07-03 01:00:00,2022-07-03 02:00:00,237,53,93,0,19,1093,1495,13323
2022-07-03 02:00:00,2022-07-03 03:00:00,236,157,94,0,160,999,1646,13036
2022-07-03 03:00:00,2022-07-03 04:00:00,235,157,96,0,661,839,1988,13477
2022-07-03 04:00:00,2022-07-03 05:00:00,226,20,96,0,1821,425,2588,14377
2022-07-03 05:00:00,2022-07-03 06:00:00,221,0,104,0,3132,222,3679,15324
2022-07-03 06:00:00,2022-07-03 07:00:00,220,0,109,0,4108,352,4789,16075
2022-07-03 07:00:00,2022-07-03 08:00:00,222,0,100,0,4622,491,5435,16233
2022-07-03 08:00:00,2022-07-03 09:00:00,221,0,99,0,4971,477,5768,16381
2022-07-03 09:00:00,2022-07-03 10:00:00,220,0,98,0,5147,427,5892,16213
2022-07-03 10:00:00,2022-07-03 11:00:00,224,0,96,0,5226,362,5908,16164
2022-07-03 11:00:00,2022-07-03 12:00:00,221,0,95,0,5246,271,5833,16264
2022-07-03 12:00:00,2022-07-03 13:00:00,219,0,95,0,4716,253,5283,16149
2022-07-03 13:00:00,2022-07-03 14:00:00,225,0,95,0,4018,247,4585,16176
2022-07-03 14:00:00,2022-07-03 15:00:00,235,0,95,0,3000,244,3574,16570
2022-07-03 15:00:00,2022-07-03 16:00:00,237,15,95,0,1705,227,2279,16941
2022-07-03 16:00:00,2022-07-03 17:00:00,237,497,129,0,556,254,1673,17112
2022-07-03 17:00:00,2022-07-03 18:00:00,236,599,139,46,249,431,1700,17406
2022-07-03 18:00:00,2022-07-03 19:00:00,237,524,136,53,15,783,1748,17676
2022-07-03 19:00:00,2022-07-03 20:00:00,235,204,109,52,0,1207,1807,17534
2022-07-03 20:00:00,2022-07-03 21:00:00,235,0,96,7,0,1594,1932,16238
2022-07-03 21:00:00,2022-07-03 22:00:00,236,0,98,0,0,1932,2266,15091
2022-07-03 22:00:00,2022-07-03 23:00:00,235,0,98,0,0,2055,2388,14644
2022-07-03 23:00:00,2022-07-04 00:00:00,236,0,98,0,0,1768,2102,14412
2022-07-04 00:00:00,2022-07-04 01:00:00,235,0,98,0,0,1303,1636,14304
2022-07-04 01:00:00,2022-07-04 02:00:00,234,0,98,0,22,1085,1439,14220
2022-07-04 02:00:00,2022-07-04 03:00:00,236,0,97,0,175,1017,1525,14914
2022-07-04 03:00:00,2022-07-04 04:00:00,234,4,94,0,729,778,1839,17766
2022-07-04 04:00:00,2022-07-04 05:00:00,235,156,94,0,1894,409,2788,20170
2022-07-04 05:00:00,2022-07-04 06:00:00,236,213,111,0,3096,419,4075,21512
2022-07-04 06:00:00,2022-07-04 07:00:00,237,97,120,0,3941,500,4895,21922
2022-07-04 07:00:00,2022-07-04 08:00:00,238,0,114,0,4545,672,5569,21958
2022-07-04 08:00:00,2022-07-04 09:00:00,235,0,107,0,4801,821,5964,22266
2022-07-04 09:00:00,2022-07-04 10:00:00,235,0,105,0,4983,769,6092,22417
2022-07-04 10:00:00,2022-07-04 11:00:00,237,0,103,0,5325,765,6430,22599
2022-07-04 11:00:00,2022-07-04 12:00:00,236,0,103,0,4874,860,6073,22133
2022-07-04 12:00:00,2022-07-04 13:00:00,234,124,103,0,4266,868,5595,22095
2022-07-04 13:00:00,2022-07-04 14:00:00,240,324,103,0,3497,871,5035,21942
2022-07-04 14:00:00,2022-07-04 15:00:00,238,210,103,0,2521,911,3983,21763
2022-07-04 15:00:00,2022-07-04 16:00:00,243,263,98,0,1311,927,2842,21407
2022-07-04 16:00:00,2022-07-04 17:00:00,242,775,111,35,581,658,2402,21667
2022-07-04 17:00:00,2022-07-04 18:00:00,241,736,117,40,242,550,1926,21645
2022-07-04 18:00:00,2022-07-04 19:00:00,241,704,112,40,15,665,1777,21235
2022-07-04 19:00:00,2022-07-04 20:00:00,238,217,102,5,0,826,1388,20245
2022-07-04 20:00:00,2022-07-04 21:00:00,177,454,102,0,0,884,1617,18776
2022-07-04 21:00:00,2022-07-04 22:00:00,203,189,98,0,0,1020,1510,17560
2022-07-04 22:00:00,2022-07-04 23:00:00,240,0,97,0,0,998,1335,16784
2022-07-04 23:00:00,2022-07-05 00:00:00,237,0,97,0,0,949,1283,16360
2022-07-05 00:00:00,2022-07-05 01:00:00,235,0,97,0,0,936,1268,16307
2022-07-05 01:00:00,2022-07-05 02:00:00,236,0,95,0,19,961,1311,16119
2022-07-05 02:00:00,2022-07-05 03:00:00,235,0,95,0,190,813,1333,16487
2022-07-05 03:00:00,2022-07-05 04:00:00,235,0,95,0,614,582,1526,18784
2022-07-05 04:00:00,2022-07-05 05:00:00,235,0,94,0,1261,261,1851,20578
2022-07-05 05:00:00,2022-07-05 06:00:00,238,0,107,0,2020,193,2558,21634
2022-07-05 06:00:00,2022-07-05 07:00:00,238,0,114,0,2815,243,3410,22166
2022-07-05 07:00:00,2022-07-05 08:00:00,240,143,109,0,3196,354,4042,22220
2022-07-05 08:00:00,2022-07-05 09:00:00,239,161,104,0,3240,489,4233,22647
2022-07-05 09:00:00,2022-07-05 10:00:00,239,87,99,0,3126,739,4290,22778
2022-07-05 10:00:00,2022-07-05 11:00:00,239,0,97,0,2948,897,4181,22462
2022-07-05 11:00:00,2022-07-05 12:00:00,240,0,97,0,2911,1006,4254,22305
2022-07-05 12:00:00,2022-07-05 13:00:00,240,0,96,0,2508,996,3840,22307
2022-07-05 13:00:00,2022-07-05 14:00:00,238,0,96,0,1942,1023,3299,21932
2022-07-05 14:00:00,2022-07-05 15:00:00,237,0,96,0,1399,934,2666,21598
2022-07-05 15:00:00,2022-07-05 16:00:00,239,263,102,0,835,811,2250,21292
2022-07-05 16:00:00,2022-07-05 17:00:00,239,719,117,35,392,812,2314,21443
2022-07-05 17:00:00,2022-07-05 18:00:00,240,704,131,40,134,817,2066,21447
2022-07-05 18:00:00,2022-07-05 19:00:00,237,565,124,40,12,705,1683,20909
2022-07-05 19:00:00,2022-07-05 20:00:00,236,364,116,40,0,740,1496,19859
2022-07-05 20:00:00,2022-07-05 21:00:00,236,0,110,5,0,809,1160,18613
2022-07-05 21:00:00,2022-07-05 22:00:00,237,143,101,0,0,907,1388,17442
2022-07-05 22:00:00,2022-07-05 23:00:00,235,43,101,0,0,979,1358,16645
2022-07-05 23:00:00,2022-07-06 00:00:00,238,0,101,0,0,913,1252,16293
2022-07-06 00:00:00,2022-07-06 01:00:00,234,0,101,0,0,888,1223,16214
2022-07-06 01:00:00,2022-07-06 02:00:00,235,0,101,0,14,1115,1465,16021
2022-07-06 02:00:00,2022-07-06 03:00:00,236,0,99,0,103,1223,1661,16366
2022-07-06 03:00:00,2022-07-06 04:00:00,237,0,96,0,369,1167,1869,18447
2022-07-06 04:00:00,2022-07-06 05:00:00,236,184,98,0,965,997,2480,20181
2022-07-06 05:00:00,2022-07-06 06:00:00,234,640,105,0,1956,1041,3976,21079
2022-07-06 06:00:00,2022-07-06 07:00:00,237,210,109,0,2791,1234,4581,21186
2022-07-06 07:00:00,2022-07-06 08:00:00,237,0,108,0,3598,1414,5357,21193
2022-07-06 08:00:00,2022-07-06 09:00:00,236,0,107,0,4069,1750,6162,21578
2022-07-06 09:00:00,2022-07-06 10:00:00,236,0,107,0,4077,2052,6472,21727
2022-07-06 10:00:00,2022-07-06 11:00:00,235,0,107,0,3940,2277,6559,21775
2022-07-06 11:00:00,2022-07-06 12:00:00,236,0,106,0,3682,2398,6422,21294
2022-07-06 12:00:00,2022-07-06 13:00:00,235,0,106,0,3524,2576,6441,21492
2022-07-06 13:00:00,2022-07-06 14:00:00,239,0,106,0,3066,2750,6161,21432
2022-07-06 14:00:00,2022-07-06 15:00:00,238,0,119,0,2363,2518,5238,21171
2022-07-06 15:00:00,2022-07-06 16:00:00,238,0,122,0,1279,2198,3837,20627
2022-07-06 16:00:00,2022-07-06 17:00:00,239,35,158,35,469,1846,2782,20745
2022-07-06 17:00:00,2022-07-06 18:00:00,241,155,164,40,149,1420,2169,20884
2022-07-06 18:00:00,2022-07-06 19:00:00,239,96,173,40,14,1255,1817,20645
2022-07-06 19:00:00,2022-07-06 20:00:00,239,235,167,40,0,1420,2101,19628
2022-07-06 20:00:00,2022-07-06 21:00:00,236,59,114,5,0,1571,1985,18211
2022-07-06 21:00:00,2022-07-06 22:00:00,232,0,98,0,0,1661,1991,16930
2022-07-06 22:00:00,2022-07-06 23:00:00,232,0,96,0,0,1587,1915,16268
2022-07-06 23:00:00,2022-07-07 00:00:00,231,0,96,0,0,1607,1934,15853
2022-07-07 00:00:00,2022-07-07 01:00:00,234,0,96,0,0,1630,1960,15805
2022-07-07 01:00:00,2022-07-07 02:00:00,235,0,96,0,18,1708,2057,15550
2022-07-07 02:00:00,2022-07-07 03:00:00,232,0,96,0,179,1603,2110,15904
2022-07-07 03:00:00,2022-07-07 04:00:00,233,0,96,0,694,1422,2445,17997
2022-07-07 04:00:00,2022-07-07 05:00:00,233,0,98,0,1650,1217,3198,19837
2022-07-07 05:00:00,2022-07-07 06:00:00,238,0,100,0,2791,1400,4529,20652
2022-07-07 06:00:00,2022-07-07 07:00:00,238,19,105,0,3875,1964,6201,21013
2022-07-07 07:00:00,2022-07-07 08:00:00,237,30,105,0,4304,2134,6810,21101
2022-07-07 08:00:00,2022-07-07 09:00:00,240,287,101,0,4368,2054,7050,21859
2022-07-07 09:00:00,2022-07-07 10:00:00,238,132,101,0,3958,1994,6423,21814
2022-07-07 10:00:00,2022-07-07 11:00:00,237,14,102,0,3637,1780,5770,21700
2022-07-07 11:00:00,2022-07-07 12:00:00,238,0,101,0,3262,1546,5147,21229
2022-07-07 12:00:00,2022-07-07 13:00:00,239,0,101,0,3312,1456,5108,21598
2022-07-07 13:00:00,2022-07-07 14:00:00,238,0,106,0,2618,1329,4291,21352
2022-07-07 14:00:00,2022-07-07 15:00:00,236,58,124,0,1681,1245,3344,21002
2022-07-07 15:00:00,2022-07-07 16:00:00,235,287,133,0,1117,1027,2799,21002
2022-07-07 16:00:00,2022-07-07 17:00:00,236,480,151,35,592,793,2287,21244
2022-07-07 17:00:00,2022-07-07 18:00:00,236,768,156,40,164,681,2045,21130
2022-07-07 18:00:00,2022-07-07 19:00:00,237,513,161,40,16,636,1603,20845
2022-07-07 19:00:00,2022-07-07 20:00:00,238,223,144,40,0,804,1449,19735
2022-07-07 20:00:00,2022-07-07 21:00:00,235,0,101,5,0,916,1257,18352
2022-07-07 21:00:00,2022-07-07 22:00:00,236,0,94,0,0,955,1285,17103
2022-07-07 22:00:00,2022-07-07 23:00:00,243,0,92,0,0,1048,1383,16549
2022-07-07 23:00:00,2022-07-08 00:00:00,252,0,92,0,0,1123,1467,16192
2022-07-08 00:00:00,2022-07-08 01:00:00,261,0,92,0,0,1184,1537,16181
2022-07-08 01:00:00,2022-07-08 02:00:00,260,0,92,0,15,1278,1645,16042
2022-07-08 02:00:00,2022-07-08 03:00:00,262,0,92,0,144,1217,1715,16319
2022-07-08 03:00:00,2022-07-08 04:00:00,262,89,93,0,457,1167,2068,18382
2022-07-08 04:00:00,2022-07-08 05:00:00,266,166,96,0,1146,1223,2897,20310
2022-07-08 05:00:00,2022-07-08 06:00:00,277,187,101,0,1845,1470,3880,21419
2022-07-08 06:00:00,2022-07-08 07:00:00,280,184,108,0,2489,1740,4801,21710
2022-07-08 07:00:00,2022-07-08 08:00:00,279,154,107,0,3284,2204,6028,21867
2022-07-08 08:00:00,2022-07-08 09:00:00,277,17,107,0,3363,2752,6516,21948
2022-07-08 09:00:00,2022-07-08 10:00:00,279,0,100,0,3895,3067,7341,22361
2022-07-08 10:00:00,2022-07-08 11:00:00,278,0,97,0,3513,3467,7355,21608
2022-07-08 11:00:00,2022-07-08 12:00:00,278,0,95,0,3522,3571,7466,21337
2022-07-08 12:00:00,2022-07-08 13:00:00,276,0,95,0,3219,3730,7320,21355
2022-07-08 13:00:00,2022-07-08 14:00:00,276,0,95,0,2505,3765,6641,21104
2022-07-08 14:00:00,2022-07-08 15:00:00,279,0,95,0,1879,3237,5490,20980
2022-07-08 15:00:00,2022-07-08 16:00:00,280,189,100,0,1097,2738,4404,20785
2022-07-08 16:00:00,2022-07-08 17:00:00,283,555,114,35,565,2115,3667,20790
2022-07-08 17:00:00,2022-07-08 18:00:00,285,1115,117,40,158,1658,3373,20635
2022-07-08 18:00:00,2022-07-08 19:00:00,283,1179,119,40,12,1568,3201,20116
2022-07-08 19:00:00,2022-07-08 20:00:00,284,564,123,40,0,1685,2696,19058
2022-07-08 20:00:00,2022-07-08 21:00:00,280,62,99,5,0,1850,2296,17838
2022-07-08 21:00:00,2022-07-08 22:00:00,222,56,96,0,0,2100,2474,16666
2022-07-08 22:00:00,2022-07-08 23:00:00,199,5,95,0,0,2309,2608,15963
2022-07-08 23:00:00,2022-07-09 00:00:00,196,0,95,0,0,2158,2449,15590
2022-07-09 00:00:00,2022-07-09 01:00:00,199,0,95,0,0,2093,2387,15436
2022-07-09 01:00:00,2022-07-09 02:00:00,198,0,95,0,20,2015,2328,15000
2022-07-09 02:00:00,2022-07-09 03:00:00,200,0,95,0,191,2070,2556,14717
2022-07-09 03:00:00,2022-07-09 04:00:00,200,0,97,0,724,1851,2872,15618
2022-07-09 04:00:00,2022-07-09 05:00:00,188,0,99,0,1562,1622,3471,16815
2022-07-09 05:00:00,2022-07-09 06:00:00,186,18,100,0,2559,1658,4521,17799
2022-07-09 06:00:00,2022-07-09 07:00:00,185,231,97,0,3348,1967,5828,18517
2022-07-09 07:00:00,2022-07-09 08:00:00,185,267,98,0,3820,2287,6657,18590
2022-07-09 08:00:00,2022-07-09 09:00:00,186,134,99,0,4173,2608,7200,18708
2022-07-09 09:00:00,2022-07-09 10:00:00,187,0,98,0,4319,3056,7660,18578
2022-07-09 10:00:00,2022-07-09 11:00:00,186,0,97,0,4590,3377,8250,18487
2022-07-09 11:00:00,2022-07-09 12:00:00,185,0,97,0,4367,3562,8211,17954
2022-07-09 12:00:00,2022-07-09 13:00:00,185,0,98,0,3953,3612,7848,17941
2022-07-09 13:00:00,2022-07-09 14:00:00,184,0,97,0,3443,3509,7233,18046
2022-07-09 14:00:00,2022-07-09 15:00:00,186,0,98,0,2481,3190,5955,17776
2022-07-09 15:00:00,2022-07-09 16:00:00,191,51,129,0,1407,3111,4889,17631
2022-07-09 16:00:00,2022-07-09 17:00:00,201,392,133,35,504,2594,3859,17629
2022-07-09 17:00:00,2022-07-09 18:00:00,201,738,144,40,196,2201,3520,17661
2022-07-09 18:00:00,2022-07-09 19:00:00,201,1012,146,40,11,2219,3629,17619
2022-07-09 19:00:00,2022-07-09 20:00:00,202,672,124,40,0,2433,3471,17023
2022-07-09 20:00:00,2022-07-09 21:00:00,203,154,101,5,0,2491,2954,15826
2022-07-09 21:00:00,2022-07-09 22:00:00,191,1,100,0,0,2534,2826,14756
2022-07-09 22:00:00,2022-07-09 23:00:00,184,18,100,0,0,2676,2978,14064
2022-07-09 23:00:00,2022-07-10 00:00:00,185,243,100,0,0,2791,3319,13687
2022-07-10 00:00:00,2022-07-10 01:00:00,185,233,99,0,0,2815,3332,13350
2022-07-10 01:00:00,2022-07-10 02:00:00,185,164,99,0,20,2850,3318,13031
2022-07-10 02:00:00,2022-07-10 03:00:00,185,61,99,0,173,2803,3321,12797
2022-07-10 03:00:00,2022-07-10 04:00:00,187,60,97,0,671,2487,3502,13177
2022-07-10 04:00:00,2022-07-10 05:00:00,184,101,100,0,1491,2426,4302,13857
2022-07-10 05:00:00,2022-07-10 06:00:00,184,0,101,0,2355,2556,5196,14577
2022-07-10 06:00:00,2022-07-10 07:00:00,186,0,107,0,2878,3092,6263,15438
2022-07-10 07:00:00,2022-07-10 08:00:00,185,0,107,0,3230,3326,6848,16035
2022-07-10 08:00:00,2022-07-10 09:00:00,184,0,101,0,3538,3340,7163,16409
2022-07-10 09:00:00,2022-07-10 10:00:00,184,0,99,0,3527,3328,7138,16217
2022-07-10 10:00:00,2022-07-10 11:00:00,185,0,99,0,3845,3279,7408,16238
2022-07-10 11:00:00,2022-07-10 12:00:00,186,0,99,0,3340,3510,7135,15584
2022-07-10 12:00:00,2022-07-10 13:00:00,185,0,100,0,3127,3221,6633,15322
2022-07-10 13:00:00,2022-07-10 14:00:00,184,0,114,0,2956,3207,6461,15664
2022-07-10 14:00:00,2022-07-10 15:00:00,182,109,136,0,2225,2929,5581,15996
2022-07-10 15:00:00,2022-07-10 16:00:00,185,29,146,0,1337,2484,4181,16293
2022-07-10 16:00:00,2022-07-10 17:00:00,190,187,141,35,563,1984,3100,16426
2022-07-10 17:00:00,2022-07-10 18:00:00,194,411,139,40,176,1842,2802,16573
2022-07-10 18:00:00,2022-07-10 19:00:00,204,954,132,40,12,1878,3220,16681
2022-07-10 19:00:00,2022-07-10 20:00:00,202,633,112,40,0,2205,3192,16446
2022-07-10 20:00:00,2022-07-10 21:00:00,202,0,98,5,0,2360,2665,15349
2022-07-10 21:00:00,2022-07-10 22:00:00,202,0,98,0,0,2437,2737,14554
2022-07-10 22:00:00,2022-07-10 23:00:00,204,0,98,0,0,2351,2653,14003
2022-07-10 23:00:00,2022-07-11 00:00:00,204,0,98,0,0,2287,2589,13775
2022-07-11 00:00:00,2022-07-11 01:00:00,201,0,98,0,0,2144,2443,13707
2022-07-11 01:00:00,2022-07-11 02:00:00,203,0,98,0,12,2043,2356,13765
2022-07-11 02:00:00,2022-07-11 03:00:00,203,0,98,0,156,1910,2367,14347
2022-07-11 03:00:00,2022-07-11 04:00:00,202,10,98,0,650,1476,2436,17080
2022-07-11 04:00:00,2022-07-11 05:00:00,202,38,100,0,1593,1096,3029,19358
2022-07-11 05:00:00,2022-07-11 06:00:00,205,0,101,0,2543,1085,3934,20494
2022-07-11 06:00:00,2022-07-11 07:00:00,202,0,101,0,3322,1248,4873,20914
2022-07-11 07:00:00,2022-07-11 08:00:00,202,0,99,0,3819,1531,5651,20782
2022-07-11 08:00:00,2022-07-11 09:00:00,204,0,99,0,3940,1940,6183,20965
2022-07-11 09:00:00,2022-07-11 10:00:00,203,0,100,0,4604,2065,6972,21686
2022-07-11 10:00:00,2022-07-11 11:00:00,203,0,100,0,4102,2183,6588,21156
2022-07-11 11:00:00,2022-07-11 12:00:00,203,0,100,0,3909,2338,6550,20711
2022-07-11 12:00:00,2022-07-11 13:00:00,200,0,99,0,3519,2200,6018,20693
2022-07-11 13:00:00,2022-07-11 14:00:00,203,0,99,0,2755,2220,5277,20305
2022-07-11 14:00:00,2022-07-11 15:00:00,203,0,99,0,2440,2124,4866,20703
2022-07-11 15:00:00,2022-07-11 16:00:00,205,17,105,0,1508,1685,3520,20563
2022-07-11 16:00:00,2022-07-11 17:00:00,205,437,111,35,583,1455,2826,20696
2022-07-11 17:00:00,2022-07-11 18:00:00,205,588,155,40,186,1442,2616,20645
2022-07-11 18:00:00,2022-07-11 19:00:00,204,578,163,40,12,1681,2678,20395
2022-07-11 19:00:00,2022-07-11 20:00:00,204,310,122,40,0,2075,2751,19278
2022-07-11 20:00:00,2022-07-11 21:00:00,205,40,124,5,0,2347,2721,17752
2022-07-11 21:00:00,2022-07-11 22:00:00,203,274,115,0,0,2509,3101,16535
2022-07-11 22:00:00,2022-07-11 23:00:00,201,29,111,0,0,2582,2923,15868
2022-07-11 23:00:00,2022-07-12 00:00:00,202,0,107,0,0,2376,2685,15496
2022-07-12 00:00:00,2022-07-12 01:00:00,203,0,104,0,0,2147,2454,15494
2022-07-12 01:00:00,2022-07-12 02:00:00,203,0,101,0,11,2069,2384,15360
2022-07-12 02:00:00,2022-07-12 03:00:00,202,26,101,0,153,2083,2565,15685
2022-07-12 03:00:00,2022-07-12 04:00:00,202,226,101,0,562,2023,3114,17919
2022-07-12 04:00:00,2022-07-12 05:00:00,202,238,103,0,1479,1831,3853,19896
2022-07-12 05:00:00,2022-07-12 06:00:00,203,221,109,0,2693,2030,5256,20770
2022-07-12 06:00:00,2022-07-12 07:00:00,198,0,113,0,3842,2870,7023,21157
2022-07-12 07:00:00,2022-07-12 08:00:00,194,0,112,0,4236,3671,8213,21001
2022-07-12 08:00:00,2022-07-12 09:00:00,195,0,112,0,4118,4214,8639,21238
2022-07-12 09:00:00,2022-07-12 10:00:00,197,0,108,0,3924,4601,8830,21365
2022-07-12 10:00:00,2022-07-12 11:00:00,194,0,104,0,3794,4796,8888,21012
2022-07-12 11:00:00,2022-07-12 12:00:00,194,0,104,0,3800,4875,8973,20707
2022-07-12 12:00:00,2022-07-12 13:00:00,194,0,104,0,3376,5132,8806,20690
2022-07-12 13:00:00,2022-07-12 14:00:00,194,0,104,0,3225,5256,8779,21060
2022-07-12 14:00:00,2022-07-12 15:00:00,195,0,104,0,2106,5308,7713,20474
2022-07-12 15:00:00,2022-07-12 16:00:00,197,0,108,0,1127,5146,6578,20284
2022-07-12 16:00:00,2022-07-12 17:00:00,203,57,116,35,399,4872,5682,20605
2022-07-12 17:00:00,2022-07-12 18:00:00,202,381,153,40,147,4497,5420,20874
2022-07-12 18:00:00,2022-07-12 19:00:00,202,516,157,40,15,4502,5432,20593
2022-07-12 19:00:00,2022-07-12 20:00:00,202,222,120,40,0,4944,5528,19294
2022-07-12 20:00:00,2022-07-12 21:00:00,203,0,104,5,0,5411,5723,17811
2022-07-12 21:00:00,2022-07-12 22:00:00,206,0,104,0,0,5549,5859,16755
2022-07-12 22:00:00,2022-07-12 23:00:00,205,0,102,0,0,5462,5769,16134
2022-07-12 23:00:00,2022-07-13 00:00:00,205,0,102,0,0,5100,5407,15709
2022-07-13 00:00:00,2022-07-13 01:00:00,203,0,102,0,0,4752,5057,15733
2022-07-13 01:00:00,2022-07-13 02:00:00,203,0,102,0,11,4486,4802,15666
2022-07-13 02:00:00,2022-07-13 03:00:00,204,0,102,0,129,4337,4772,15839
2022-07-13 03:00:00,2022-07-13 04:00:00,206,0,102,0,551,3802,4661,17960
2022-07-13 04:00:00,2022-07-13 05:00:00,199,0,102,0,1523,3075,4899,19913
2022-07-13 05:00:00,2022-07-13 06:00:00,204,0,112,0,2720,2732,5768,20927
2022-07-13 06:00:00,2022-07-13 07:00:00,197,0,113,0,3780,2930,7020,21193
2022-07-13 07:00:00,2022-07-13 08:00:00,196,0,111,0,4452,3068,7827,20899
2022-07-13 08:00:00,2022-07-13 09:00:00,197,0,111,0,4934,3270,8512,21289
2022-07-13 09:00:00,2022-07-13 10:00:00,196,0,104,0,5051,3362,8713,21604
2022-07-13 10:00:00,2022-07-13 11:00:00,197,0,103,0,4855,3278,8433,21593
2022-07-13 11:00:00,2022-07-13 12:00:00,198,2,103,0,4605,3361,8269,21448
2022-07-13 12:00:00,2022-07-13 13:00:00,196,0,103,0,4049,3264,7612,21613
2022-07-13 13:00:00,2022-07-13 14:00:00,197,0,103,0,3238,3165,6703,21541
2022-07-13 14:00:00,2022-07-13 15:00:00,201,0,102,0,2318,2778,5399,21627
2022-07-13 15:00:00,2022-07-13 16:00:00,207,359,133,0,1304,2519,4522,21454
2022-07-13 16:00:00,2022-07-13 17:00:00,204,805,139,35,500,2221,3904,21338
2022-07-13 17:00:00,2022-07-13 18:00:00,206,904,164,40,141,2165,3620,21296
2022-07-13 18:00:00,2022-07-13 19:00:00,204,818,160,40,11,2414,3647,20947
2022-07-13 19:00:00,2022-07-13 20:00:00,206,277,132,40,0,2775,3430,19710
2022-07-13 20:00:00,2022-07-13 21:00:00,205,6,123,5,0,3136,3475,18365
2022-07-13 21:00:00,2022-07-13 22:00:00,200,50,112,0,0,3197,3559,17202
2022-07-13 22:00:00,2022-07-13 23:00:00,187,50,110,0,0,3378,3725,16599
2022-07-13 23:00:00,2022-07-14 00:00:00,188,0,110,0,0,3388,3686,16215
2022-07-14 00:00:00,2022-07-14 01:00:00,188,0,110,0,0,3361,3659,16090
2022-07-14 01:00:00,2022-07-14 02:00:00,187,0,105,0,12,3261,3565,15845
2022-07-14 02:00:00,2022-07-14 03:00:00,189,0,104,0,171,2734,3198,16132
2022-07-14 03:00:00,2022-07-14 04:00:00,204,102,104,0,647,2066,3123,18248
2022-07-14 04:00:00,2022-07-14 05:00:00,197,283,106,0,1750,2009,4345,20176
2022-07-14 05:00:00,2022-07-14 06:00:00,197,17,112,0,3219,2314,5859,21394
2022-07-14 06:00:00,2022-07-14 07:00:00,197,0,115,0,4498,2621,7431,21749
2022-07-14 07:00:00,2022-07-14 08:00:00,197,0,109,0,5344,3070,8720,21574
2022-07-14 08:00:00,2022-07-14 09:00:00,196,0,96,0,5836,3264,9392,21705
2022-07-14 09:00:00,2022-07-14 10:00:00,197,0,95,0,5716,3305,9313,21653
2022-07-14 10:00:00,2022-07-14 11:00:00,198,0,95,0,5823,3250,9366,21969
2022-07-14 11:00:00,2022-07-14 12:00:00,198,0,98,0,5358,3155,8809,21779
2022-07-14 12:00:00,2022-07-14 13:00:00,197,0,98,0,4353,2937,7585,21499
2022-07-14 13:00:00,2022-07-14 14:00:00,197,0,100,0,3797,2484,6578,21919
2022-07-14 14:00:00,2022-07-14 15:00:00,198,49,103,0,2334,2039,4723,21625
2022-07-14 15:00:00,2022-07-14 16:00:00,205,275,113,0,1222,1731,3546,21399
2022-07-14 16:00:00,2022-07-14 17:00:00,203,691,144,35,444,1472,2989,21385
2022-07-14 17:00:00,2022-07-14 18:00:00,204,736,154,40,158,1452,2744,21302
2022-07-14 18:00:00,2022-07-14 19:00:00,206,912,145,40,10,1781,3094,20873
2022-07-14 19:00:00,2022-07-14 20:00:00,205,259,121,40,0,2253,2878,19714
2022-07-14 20:00:00,2022-07-14 21:00:00,205,0,118,5,0,2182,2510,18352
2022-07-14 21:00:00,2022-07-14 22:00:00,201,158,107,0,0,1968,2434,17060
2022-07-14 22:00:00,2022-07-14 23:00:00,191,71,100,0,0,2254,2616,16520
2022-07-14 23:00:00,2022-07-15 00:00:00,192,0,100,0,0,2311,2603,16121
2022-07-15 00:00:00,2022-07-15 01:00:00,191,0,100,0,0,2537,2828,16045
2022-07-15 01:00:00,2022-07-15 02:00:00,190,0,100,0,10,2880,3180,15899
2022-07-15 02:00:00,2022-07-15 03:00:00,194,0,101,0,143,3105,3543,16126
2022-07-15 03:00:00,2022-07-15 04:00:00,205,0,101,0,554,2907,3767,17975
2022-07-15 04:00:00,2022-07-15 05:00:00,199,51,103,0,1588,2871,4812,19747
2022-07-15 05:00:00,2022-07-15 06:00:00,196,51,104,0,3199,3239,6789,20841
2022-07-15 06:00:00,2022-07-15 07:00:00,196,0,109,0,4086,3744,8135,20926
2022-07-15 07:00:00,2022-07-15 08:00:00,193,279,108,0,4100,4419,9099,20662
2022-07-15 08:00:00,2022-07-15 09:00:00,194,210,108,0,4329,4651,9492,21095
2022-07-15 09:00:00,2022-07-15 10:00:00,196,0,102,0,4561,5022,9881,21302
2022-07-15 10:00:00,2022-07-15 11:00:00,196,0,101,0,4511,5134,9942,20955
2022-07-15 11:00:00,2022-07-15 12:00:00,197,0,101,0,4579,5073,9950,20573
2022-07-15 12:00:00,2022-07-15 13:00:00,195,0,101,0,4242,4982,9520,20645
2022-07-15 13:00:00,2022-07-15 14:00:00,195,0,101,0,3559,4751,8606,20510
2022-07-15 14:00:00,2022-07-15 15:00:00,197,0,102,0,2581,4377,7257,20521
2022-07-15 15:00:00,2022-07-15 16:00:00,203,0,106,0,1505,3797,5611,20437
2022-07-15 16:00:00,2022-07-15 17:00:00,205,133,106,35,632,2872,3983,20441
2022-07-15 17:00:00,2022-07-15 18:00:00,205,737,145,40,189,2229,3545,20433
2022-07-15 18:00:00,2022-07-15 19:00:00,205,920,151,40,16,2049,3381,20049
2022-07-15 19:00:00,2022-07-15 20:00:00,207,615,111,40,0,1925,2898,18909
2022-07-15 20:00:00,2022-07-15 21:00:00,204,141,102,5,0,1914,2366,17692
2022-07-15 21:00:00,2022-07-15 22:00:00,205,583,102,0,0,1893,2783,16491
2022-07-15 22:00:00,2022-07-15 23:00:00,203,180,101,0,0,1886,2370,15722
2022-07-15 23:00:00,2022-07-16 00:00:00,204,6,101,0,0,1922,2233,15346
2022-07-16 00:00:00,2022-07-16 01:00:00,204,4,101,0,0,1905,2214,15253
2022-07-16 01:00:00,2022-07-16 02:00:00,193,0,102,0,11,1879,2185,14902
2022-07-16 02:00:00,2022-07-16 03:00:00,189,0,102,0,156,1918,2365,14618
2022-07-16 03:00:00,2022-07-16 04:00:00,189,0,102,0,675,1827,2793,15367
2022-07-16 04:00:00,2022-07-16 05:00:00,197,0,104,0,1697,1483,3481,16774
2022-07-16 05:00:00,2022-07-16 06:00:00,204,0,108,0,2894,1508,4714,17937
2022-07-16 06:00:00,2022-07-16 07:00:00,192,0,111,0,3704,2381,6388,18493
2022-07-16 07:00:00,2022-07-16 08:00:00,185,0,109,0,3868,3092,7254,18673
2022-07-16 08:00:00,2022-07-16 09:00:00,185,0,107,0,3831,3534,7657,18899
2022-07-16 09:00:00,2022-07-16 10:00:00,187,0,99,0,3752,4023,8061,18909
2022-07-16 10:00:00,2022-07-16 11:00:00,184,0,98,0,3495,4216,7993,18473
2022-07-16 11:00:00,2022-07-16 12:00:00,185,0,98,0,3420,4426,8129,18121
2022-07-16 12:00:00,2022-07-16 13:00:00,185,0,98,0,3086,4326,7695,17923
2022-07-16 13:00:00,2022-07-16 14:00:00,186,0,97,0,2728,4448,7459,17871
2022-07-16 14:00:00,2022-07-16 15:00:00,184,40,101,0,2171,4880,7376,18218
2022-07-16 15:00:00,2022-07-16 16:00:00,184,302,104,0,1030,4391,6011,17633
2022-07-16 16:00:00,2022-07-16 17:00:00,196,274,128,35,468,3774,4875,17737
2022-07-16 17:00:00,2022-07-16 18:00:00,206,676,150,40,194,3298,4564,17724
2022-07-16 18:00:00,2022-07-16 19:00:00,204,900,149,39,23,3030,4345,17596
2022-07-16 19:00:00,2022-07-16 20:00:00,205,669,121,39,0,3171,4205,16852
2022-07-16 20:00:00,2022-07-16 21:00:00,193,507,99,5,0,3464,4268,15731
2022-07-16 21:00:00,2022-07-16 22:00:00,188,235,97,0,0,3426,3946,14575
2022-07-16 22:00:00,2022-07-16 23:00:00,188,0,97,0,0,3436,3721,14065
2022-07-16 23:00:00,2022-07-17 00:00:00,188,0,97,0,0,3370,3655,13693
2022-07-17 00:00:00,2022-07-17 01:00:00,187,0,97,0,0,3005,3289,13453
2022-07-17 01:00:00,2022-07-17 02:00:00,188,0,95,0,8,2773,3064,13026
2022-07-17 02:00:00,2022-07-17 03:00:00,186,0,95,0,139,2601,3021,12743
2022-07-17 03:00:00,2022-07-17 04:00:00,188,0,96,0,634,2214,3132,13130
2022-07-17 04:00:00,2022-07-17 05:00:00,187,51,96,0,1885,1614,3833,13869
2022-07-17 05:00:00,2022-07-17 06:00:00,189,129,99,0,3376,1621,5414,14719
2022-07-17 06:00:00,2022-07-17 07:00:00,187,0,105,0,4440,1918,6650,15308
2022-07-17 07:00:00,2022-07-17 08:00:00,186,0,105,0,4829,2203,7323,15541
2022-07-17 08:00:00,2022-07-17 09:00:00,185,0,98,0,5186,2212,7681,15850
2022-07-17 09:00:00,2022-07-17 10:00:00,187,0,98,0,5152,2308,7745,15772
2022-07-17 10:00:00,2022-07-17 11:00:00,187,0,98,0,5432,2488,8205,16059
2022-07-17 11:00:00,2022-07-17 12:00:00,186,0,98,0,5403,2489,8176,15927
2022-07-17 12:00:00,2022-07-17 13:00:00,184,0,98,0,4923,2552,7757,15635
2022-07-17 13:00:00,2022-07-17 14:00:00,184,0,97,0,3942,2409,6632,15456
2022-07-17 14:00:00,2022-07-17 15:00:00,183,0,97,0,2807,2190,5277,15591
2022-07-17 15:00:00,2022-07-17 16:00:00,186,0,103,0,1640,2050,3979,16042
2022-07-17 16:00:00,2022-07-17 17:00:00,197,148,110,35,622,1734,2846,16454
2022-07-17 17:00:00,2022-07-17 18:00:00,203,678,134,40,191,1326,2572,16769
2022-07-17 18:00:00,2022-07-17 19:00:00,204,908,139,40,18,1288,2597,17063
2022-07-17 19:00:00,2022-07-17 20:00:00,203,1021,127,40,0,1410,2801,16684
2022-07-17 20:00:00,2022-07-17 21:00:00,203,312,98,5,0,1213,1831,15605
2022-07-17 21:00:00,2022-07-17 22:00:00,203,52,96,0,0,1092,1443,14715
2022-07-17 22:00:00,2022-07-17 23:00:00,205,218,96,0,0,1138,1657,14276
2022-07-17 23:00:00,2022-07-18 00:00:00,205,222,96,0,0,1212,1735,14043
2022-07-18 00:00:00,2022-07-18 01:00:00,204,149,96,0,0,1269,1718,14091
2022-07-18 01:00:00,2022-07-18 02:00:00,204,31,96,0,11,1310,1652,14109
2022-07-18 02:00:00,2022-07-18 03:00:00,204,2,96,0,165,1394,1861,14635
2022-07-18 03:00:00,2022-07-18 04:00:00,202,0,96,0,730,1281,2309,17209
2022-07-18 04:00:00,2022-07-18 05:00:00,204,0,97,0,1875,811,2987,19307
2022-07-18 05:00:00,2022-07-18 06:00:00,204,0,119,0,3339,489,4151,20746
2022-07-18 06:00:00,2022-07-18 07:00:00,203,0,132,0,4313,692,5340,20983
2022-07-18 07:00:00,2022-07-18 08:00:00,198,0,113,0,5135,1044,6490,20823
2022-07-18 08:00:00,2022-07-18 09:00:00,203,0,109,0,5469,1279,7060,21021
2022-07-18 09:00:00,2022-07-18 10:00:00,203,0,109,0,5586,1143,7041,21116
2022-07-18 10:00:00,2022-07-18 11:00:00,204,0,108,0,5540,1036,6888,21105
2022-07-18 11:00:00,2022-07-18 12:00:00,205,0,104,0,5251,1033,6593,20877
2022-07-18 12:00:00,2022-07-18 13:00:00,205,0,104,0,4521,939,5769,20925
2022-07-18 13:00:00,2022-07-18 14:00:00,204,0,104,0,3488,819,4615,20833
2022-07-18 14:00:00,2022-07-18 15:00:00,203,0,104,0,2423,636,3366,20794
2022-07-18 15:00:00,2022-07-18 16:00:00,204,172,112,0,1354,484,2326,20846
2022-07-18 16:00:00,2022-07-18 17:00:00,203,714,117,35,490,395,1954,20926
2022-07-18 17:00:00,2022-07-18 18:00:00,205,978,126,40,157,320,1826,20996
2022-07-18 18:00:00,2022-07-18 19:00:00,205,684,132,40,7,313,1381,20735
2022-07-18 19:00:00,2022-07-18 20:00:00,205,466,115,40,0,406,1232,19516
2022-07-18 20:00:00,2022-07-18 21:00:00,203,20,104,5,0,517,849,18117
2022-07-18 21:00:00,2022-07-18 22:00:00,203,95,103,0,0,736,1137,16884
2022-07-18 22:00:00,2022-07-18 23:00:00,205,12,103,0,0,970,1290,16333
2022-07-18 23:00:00,2022-07-19 00:00:00,204,0,103,0,0,1123,1430,15923
2022-07-19 00:00:00,2022-07-19 01:00:00,203,0,103,0,0,1255,1561,15840
2022-07-19 01:00:00,2022-07-19 02:00:00,204,0,103,0,8,1351,1666,15737
2022-07-19 02:00:00,2022-07-19 03:00:00,204,0,103,0,106,1436,1849,15958
2022-07-19 03:00:00,2022-07-19 04:00:00,204,0,104,0,483,1372,2163,18038
2022-07-19 04:00:00,2022-07-19 05:00:00,204,0,106,0,1406,998,2714,20047
2022-07-19 05:00:00,2022-07-19 06:00:00,205,117,109,0,2725,481,3637,21347
2022-07-19 06:00:00,2022-07-19 07:00:00,204,50,109,0,3975,334,4672,21826
2022-07-19 07:00:00,2022-07-19 08:00:00,205,0,106,0,5029,421,5761,21843
2022-07-19 08:00:00,2022-07-19 09:00:00,203,0,106,0,5835,596,6740,22112
2022-07-19 09:00:00,2022-07-19 10:00:00,204,0,105,0,6170,688,7167,22268
2022-07-19 10:00:00,2022-07-19 11:00:00,203,0,105,0,6145,595,7048,22059
2022-07-19 11:00:00,2022-07-19 12:00:00,203,0,105,0,5912,563,6783,21844
2022-07-19 12:00:00,2022-07-19 13:00:00,206,0,104,0,5294,509,6113,21883
2022-07-19 13:00:00,2022-07-19 14:00:00,205,0,104,0,4333,459,5101,21748
2022-07-19 14:00:00,2022-07-19 15:00:00,204,0,102,0,3053,436,3795,21694
2022-07-19 15:00:00,2022-07-19 16:00:00,205,374,103,0,1600,378,2660,21531
2022-07-19 16:00:00,2022-07-19 17:00:00,204,1077,108,35,554,371,2349,21606
2022-07-19 17:00:00,2022-07-19 18:00:00,203,942,141,40,175,461,1962,21613
2022-07-19 18:00:00,2022-07-19 19:00:00,203,768,145,40,7,574,1737,21338
2022-07-19 19:00:00,2022-07-19 20:00:00,204,374,115,40,0,634,1367,20075
2022-07-19 20:00:00,2022-07-19 21:00:00,204,0,103,5,0,687,999,18565
2022-07-19 21:00:00,2022-07-19 22:00:00,204,0,103,0,0,647,954,17229
2022-07-19 22:00:00,2022-07-19 23:00:00,206,0,103,0,0,694,1003,16412
2022-07-19 23:00:00,2022-07-20 00:00:00,205,0,103,0,0,751,1059,16127
2022-07-20 00:00:00,2022-07-20 01:00:00,203,0,102,0,0,753,1058,15981
2022-07-20 01:00:00,2022-07-20 02:00:00,204,0,101,0,7,733,1045,15814
2022-07-20 02:00:00,2022-07-20 03:00:00,203,0,101,0,135,691,1130,16088
2022-07-20 03:00:00,2022-07-20 04:00:00,204,0,101,0,632,604,1541,18279
2022-07-20 04:00:00,2022-07-20 05:00:00,201,0,103,0,1884,395,2583,20460
2022-07-20 05:00:00,2022-07-20 06:00:00,167,0,108,0,3445,110,3830,21748
2022-07-20 06:00:00,2022-07-20 07:00:00,203,0,110,0,4742,44,5099,22075
2022-07-20 07:00:00,2022-07-20 08:00:00,205,0,109,0,5652,60,6026,22079
2022-07-20 08:00:00,2022-07-20 09:00:00,204,0,108,0,6251,94,6657,22436
2022-07-20 09:00:00,2022-07-20 10:00:00,204,0,109,0,6540,135,6988,22593
2022-07-20 10:00:00,2022-07-20 11:00:00,196,0,108,0,6499,176,6979,22499
2022-07-20 11:00:00,2022-07-20 12:00:00,198,0,108,0,6135,206,6647,22045
2022-07-20 12:00:00,2022-07-20 13:00:00,204,0,108,0,5446,251,6009,22197
2022-07-20 13:00:00,2022-07-20 14:00:00,205,0,108,0,4435,280,5028,22151
2022-07-20 14:00:00,2022-07-20 15:00:00,204,65,107,0,3087,343,3806,22117
2022-07-20 15:00:00,2022-07-20 16:00:00,204,567,107,0,1601,427,2906,22001
2022-07-20 16:00:00,2022-07-20 17:00:00,203,1078,112,35,546,662,2636,21954
2022-07-20 17:00:00,2022-07-20 18:00:00,204,782,120,40,174,1366,2686,21891
2022-07-20 18:00:00,2022-07-20 19:00:00,202,149,121,39,8,2368,2887,21578
2022-07-20 19:00:00,2022-07-20 20:00:00,203,0,111,39,0,2922,3275,20257
2022-07-20 20:00:00,2022-07-20 21:00:00,203,0,96,5,0,3156,3460,18683
2022-07-20 21:00:00,2022-07-20 22:00:00,223,0,98,0,0,3248,3569,17368
2022-07-20 22:00:00,2022-07-20 23:00:00,233,0,99,0,0,3069,3401,16569
2022-07-20 23:00:00,2022-07-21 00:00:00,231,0,98,0,0,3081,3410,16101
2022-07-21 00:00:00,2022-07-21 01:00:00,229,0,99,0,0,3274,3602,16077
2022-07-21 01:00:00,2022-07-21 02:00:00,229,0,99,0,8,3331,3667,15934
2022-07-21 02:00:00,2022-07-21 03:00:00,229,0,99,0,148,3300,3776,16196
2022-07-21 03:00:00,2022-07-21 04:00:00,232,0,99,0,666,2968,3965,18389
2022-07-21 04:00:00,2022-07-21 05:00:00,230,105,101,0,1942,1907,4285,20673
2022-07-21 05:00:00,2022-07-21 06:00:00,229,147,108,0,3473,1045,5002,21948
2022-07-21 06:00:00,2022-07-21 07:00:00,231,0,110,0,4783,723,5847,22288
2022-07-21 07:00:00,2022-07-21 08:00:00,225,0,108,0,5686,660,6679,22241
2022-07-21 08:00:00,2022-07-21 09:00:00,223,0,102,0,6334,759,7418,22650
2022-07-21 09:00:00,2022-07-21 10:00:00,223,0,102,0,6553,989,7867,22684
2022-07-21 10:00:00,2022-07-21 11:00:00,224,0,101,0,6475,1153,7953,22507
2022-07-21 11:00:00,2022-07-21 12:00:00,226,0,98,0,6062,1243,7629,22390
2022-07-21 12:00:00,2022-07-21 13:00:00,228,0,98,0,5319,1216,6861,22555
2022-07-21 13:00:00,2022-07-21 14:00:00,229,0,95,0,4215,1446,5985,22572
2022-07-21 14:00:00,2022-07-21 15:00:00,231,0,95,0,2911,1401,4638,22422
2022-07-21 15:00:00,2022-07-21 16:00:00,232,209,125,0,1508,1270,3344,22244
2022-07-21 16:00:00,2022-07-21 17:00:00,231,959,135,34,559,1164,3082,22212
2022-07-21 17:00:00,2022-07-21 18:00:00,231,993,144,39,155,1368,2930,22088
2022-07-21 18:00:00,2022-07-21 19:00:00,231,775,136,39,8,1476,2665,21800
2022-07-21 19:00:00,2022-07-21 20:00:00,233,378,111,5,0,1628,2355,20530
2022-07-21 20:00:00,2022-07-21 21:00:00,229,50,93,0,0,1536,1908,18949
2022-07-21 21:00:00,2022-07-21 22:00:00,232,200,91,0,0,1318,1841,17706
2022-07-21 22:00:00,2022-07-21 23:00:00,230,0,91,0,0,983,1304,16841
2022-07-21 23:00:00,2022-07-22 00:00:00,232,6,91,0,0,1024,1353,16516
2022-07-22 00:00:00,2022-07-22 01:00:00,232,4,91,0,0,1216,1543,16388
2022-07-22 01:00:00,2022-07-22 02:00:00,232,0,91,0,7,1127,1457,16373
2022-07-22 02:00:00,2022-07-22 03:00:00,232,0,91,0,151,1084,1558,16536
2022-07-22 03:00:00,2022-07-22 04:00:00,229,0,90,0,623,1107,2049,18763
2022-07-22 04:00:00,2022-07-22 05:00:00,230,0,90,0,1593,693,2606,20803
2022-07-22 05:00:00,2022-07-22 06:00:00,233,0,98,0,2838,404,3573,21957
2022-07-22 06:00:00,2022-07-22 07:00:00,231,0,100,0,3884,374,4589,22292
2022-07-22 07:00:00,2022-07-22 08:00:00,231,0,99,0,5058,333,5721,22443
2022-07-22 08:00:00,2022-07-22 09:00:00,229,0,99,0,5495,374,6197,22749
2022-07-22 09:00:00,2022-07-22 10:00:00,231,0,93,0,5678,506,6508,23078
2022-07-22 10:00:00,2022-07-22 11:00:00,231,0,94,0,5465,629,6419,22921
2022-07-22 11:00:00,2022-07-22 12:00:00,233,0,93,0,5209,689,6224,22713
2022-07-22 12:00:00,2022-07-22 13:00:00,229,0,94,0,4641,679,5643,22723
2022-07-22 13:00:00,2022-07-22 14:00:00,230,0,94,0,3788,758,4870,22594
2022-07-22 14:00:00,2022-07-22 15:00:00,232,0,97,0,2737,741,3807,22456
2022-07-22 15:00:00,2022-07-22 16:00:00,230,88,95,0,1535,621,2569,22178
2022-07-22 16:00:00,2022-07-22 17:00:00,230,419,98,34,548,615,1944,21894
2022-07-22 17:00:00,2022-07-22 18:00:00,232,740,129,39,165,611,1916,21701
2022-07-22 18:00:00,2022-07-22 19:00:00,230,475,144,38,9,649,1545,21400
2022-07-22 19:00:00,2022-07-22 20:00:00,231,133,103,5,0,768,1240,20215
2022-07-22 20:00:00,2022-07-22 21:00:00,230,118,92,0,0,679,1119,18761
2022-07-22 21:00:00,2022-07-22 22:00:00,231,18,88,0,0,584,921,17476
2022-07-22 22:00:00,2022-07-22 23:00:00,231,0,88,0,0,525,844,16631
2022-07-22 23:00:00,2022-07-23 00:00:00,231,0,88,0,0,407,726,16115
2022-07-23 00:00:00,2022-07-23 01:00:00,229,0,88,0,0,331,648,15948
2022-07-23 01:00:00,2022-07-23 02:00:00,233,0,88,0,8,293,622,15579
2022-07-23 02:00:00,2022-07-23 03:00:00,231,0,88,0,143,290,752,15332
2022-07-23 03:00:00,2022-07-23 04:00:00,233,0,88,0,638,260,1219,16174
2022-07-23 04:00:00,2022-07-23 05:00:00,244,0,89,0,1691,176,2200,17541
2022-07-23 05:00:00,2022-07-23 06:00:00,249,0,94,0,2931,131,3405,18796
2022-07-23 06:00:00,2022-07-23 07:00:00,248,0,99,0,3917,181,4445,19608
2022-07-23 07:00:00,2022-07-23 08:00:00,248,0,102,0,4361,259,4970,19857
2022-07-23 08:00:00,2022-07-23 09:00:00,246,0,102,0,4507,317,5172,20097
2022-07-23 09:00:00,2022-07-23 10:00:00,246,0,104,0,4330,494,5174,20086
2022-07-23 10:00:00,2022-07-23 11:00:00,245,0,102,0,3987,758,5092,19835
2022-07-23 11:00:00,2022-07-23 12:00:00,245,0,102,0,3914,967,5228,19653
2022-07-23 12:00:00,2022-07-23 13:00:00,242,0,102,0,3405,1053,4802,19548
2022-07-23 13:00:00,2022-07-23 14:00:00,242,0,102,0,2609,1280,4233,19530
2022-07-23 14:00:00,2022-07-23 15:00:00,243,102,101,0,1601,1235,3282,19112
2022-07-23 15:00:00,2022-07-23 16:00:00,244,547,120,0,1039,1270,3220,19020
2022-07-23 16:00:00,2022-07-23 17:00:00,243,652,123,35,412,1100,2565,18601
2022-07-23 17:00:00,2022-07-23 18:00:00,243,683,137,39,125,1128,2355,18445
2022-07-23 18:00:00,2022-07-23 19:00:00,245,681,135,39,8,1399,2507,18389
2022-07-23 19:00:00,2022-07-23 20:00:00,245,535,97,5,0,1772,2654,17543
2022-07-23 20:00:00,2022-07-23 21:00:00,242,322,91,0,0,1839,2494,16219
2022-07-23 21:00:00,2022-07-23 22:00:00,238,467,89,0,0,1900,2694,15101
2022-07-23 22:00:00,2022-07-23 23:00:00,235,395,88,0,0,1925,2643,14589
2022-07-23 23:00:00,2022-07-24 00:00:00,235,162,88,0,0,1896,2381,14149
2022-07-24 00:00:00,2022-07-24 01:00:00,224,55,88,0,0,1846,2213,14019
2022-07-24 01:00:00,2022-07-24 02:00:00,230,62,88,0,6,1899,2285,13654
2022-07-24 02:00:00,2022-07-24 03:00:00,232,195,88,0,101,1909,2525,13298
2022-07-24 03:00:00,2022-07-24 04:00:00,232,102,88,0,470,1684,2576,13592
2022-07-24 04:00:00,2022-07-24 05:00:00,229,0,89,0,1493,1324,3135,14371
2022-07-24 05:00:00,2022-07-24 06:00:00,229,0,89,0,2681,1311,4310,15160
2022-07-24 06:00:00,2022-07-24 07:00:00,231,0,88,0,3573,1472,5364,15831
2022-07-24 07:00:00,2022-07-24 08:00:00,229,0,87,0,4002,1480,5798,16014
2022-07-24 08:00:00,2022-07-24 09:00:00,228,0,87,0,4626,1386,6327,16398
2022-07-24 09:00:00,2022-07-24 10:00:00,205,0,87,0,5165,1342,6799,16599
2022-07-24 10:00:00,2022-07-24 11:00:00,147,0,87,0,5396,1409,7039,16605
2022-07-24 11:00:00,2022-07-24 12:00:00,141,0,87,0,5346,1369,6943,16398
2022-07-24 12:00:00,2022-07-24 13:00:00,141,0,87,0,5072,1162,6462,16355
2022-07-24 13:00:00,2022-07-24 14:00:00,143,0,86,0,4230,900,5359,16259
2022-07-24 14:00:00,2022-07-24 15:00:00,195,0,86,0,3104,744,4129,16481
2022-07-24 15:00:00,2022-07-24 16:00:00,239,11,87,0,1659,533,2529,16858
2022-07-24 16:00:00,2022-07-24 17:00:00,247,286,105,0,587,333,1558,17183
2022-07-24 17:00:00,2022-07-24 18:00:00,249,602,133,34,175,286,1479,17326
2022-07-24 18:00:00,2022-07-24 19:00:00,247,563,137,39,8,378,1372,17674
2022-07-24 19:00:00,2022-07-24 20:00:00,248,691,127,39,0,424,1529,17151
2022-07-24 20:00:00,2022-07-24 21:00:00,248,129,98,5,0,547,1027,16071
2022-07-24 21:00:00,2022-07-24 22:00:00,247,323,96,0,0,796,1462,14946
2022-07-24 22:00:00,2022-07-24 23:00:00,249,26,96,0,0,1150,1521,14397
2022-07-24 23:00:00,2022-07-25 00:00:00,248,0,96,0,0,1381,1725,14072
2022-07-25 00:00:00,2022-07-25 01:00:00,249,0,96,0,0,1659,2004,14035
2022-07-25 01:00:00,2022-07-25 02:00:00,248,0,96,0,4,1851,2199,14142
2022-07-25 02:00:00,2022-07-25 03:00:00,247,0,96,0,115,1888,2346,14555
2022-07-25 03:00:00,2022-07-25 04:00:00,242,0,95,0,591,1728,2656,16866
2022-07-25 04:00:00,2022-07-25 05:00:00,229,17,95,0,1928,1158,3427,19229
2022-07-25 05:00:00,2022-07-25 06:00:00,228,79,100,0,3498,638,4543,20648
2022-07-25 06:00:00,2022-07-25 07:00:00,228,0,109,0,4746,674,5757,21213
2022-07-25 07:00:00,2022-07-25 08:00:00,228,0,107,0,5646,1063,7044,21167
2022-07-25 08:00:00,2022-07-25 09:00:00,224,0,104,0,6381,1309,8018,21343
2022-07-25 09:00:00,2022-07-25 10:00:00,226,0,97,0,6618,1332,8273,21482
2022-07-25 10:00:00,2022-07-25 11:00:00,223,0,95,0,6526,1316,8160,21373
2022-07-25 11:00:00,2022-07-25 12:00:00,223,0,95,0,6236,1312,7866,21133
2022-07-25 12:00:00,2022-07-25 13:00:00,223,0,95,0,5669,1310,7297,21511
2022-07-25 13:00:00,2022-07-25 14:00:00,230,0,95,0,4633,1271,6229,21496
2022-07-25 14:00:00,2022-07-25 15:00:00,231,0,95,0,3238,1257,4821,21461
2022-07-25 15:00:00,2022-07-25 16:00:00,229,22,95,0,1672,1440,3458,21341
2022-07-25 16:00:00,2022-07-25 17:00:00,228,337,98,34,531,1849,3077,21310
2022-07-25 17:00:00,2022-07-25 18:00:00,230,307,147,39,130,2785,3638,21236
2022-07-25 18:00:00,2022-07-25 19:00:00,229,11,151,39,2,3532,3964,21094
2022-07-25 19:00:00,2022-07-25 20:00:00,230,0,121,5,0,3671,4027,19669
2022-07-25 20:00:00,2022-07-25 21:00:00,235,0,102,0,0,3465,3802,18078
2022-07-25 21:00:00,2022-07-25 22:00:00,234,0,88,0,0,3602,3924,16936
2022-07-25 22:00:00,2022-07-25 23:00:00,232,0,85,0,0,4099,4416,16386
2022-07-25 23:00:00,2022-07-26 00:00:00,232,0,85,0,0,3815,4132,16007
2022-07-26 00:00:00,2022-07-26 01:00:00,230,0,85,0,0,3315,3630,15865
2022-07-26 01:00:00,2022-07-26 02:00:00,230,0,84,0,4,3044,3362,15787
2022-07-26 02:00:00,2022-07-26 03:00:00,228,0,83,0,109,2936,3356,16084
2022-07-26 03:00:00,2022-07-26 04:00:00,230,0,83,0,496,2294,3103,18040
2022-07-26 04:00:00,2022-07-26 05:00:00,228,0,83,0,1234,1770,3315,19867
2022-07-26 05:00:00,2022-07-26 06:00:00,232,0,84,0,2162,1500,3978,21013
2022-07-26 06:00:00,2022-07-26 07:00:00,234,17,84,0,2894,1632,4861,21709
2022-07-26 07:00:00,2022-07-26 08:00:00,231,86,83,0,3096,1697,5193,21545
2022-07-26 08:00:00,2022-07-26 09:00:00,233,0,83,0,3221,1704,5241,21924
2022-07-26 09:00:00,2022-07-26 10:00:00,243,17,86,0,3065,1823,5234,22252
2022-07-26 10:00:00,2022-07-26 11:00:00,243,136,85,0,2885,1899,5248,22286
2022-07-26 11:00:00,2022-07-26 12:00:00,244,211,83,0,2648,2015,5201,22008
2022-07-26 12:00:00,2022-07-26 13:00:00,242,41,84,0,2353,2111,4831,21914
2022-07-26 13:00:00,2022-07-26 14:00:00,244,28,84,0,1883,1913,4152,21523
2022-07-26 14:00:00,2022-07-26 15:00:00,243,356,83,0,1337,1819,3838,21087
2022-07-26 15:00:00,2022-07-26 16:00:00,243,175,83,34,790,2040,3365,20783
2022-07-26 16:00:00,2022-07-26 17:00:00,243,143,98,39,342,1925,2790,20719
2022-07-26 17:00:00,2022-07-26 18:00:00,244,122,101,39,119,1999,2624,20790
2022-07-26 18:00:00,2022-07-26 19:00:00,243,15,93,5,1,1896,2253,20381
2022-07-26 19:00:00,2022-07-26 20:00:00,243,0,108,0,0,2004,2355,19104
2022-07-26 20:00:00,2022-07-26 21:00:00,245,0,94,0,0,2156,2495,17794
2022-07-26 21:00:00,2022-07-26 22:00:00,237,0,82,0,0,2042,2361,16573
2022-07-26 22:00:00,2022-07-26 23:00:00,239,0,82,0,0,1844,2165,15928
2022-07-26 23:00:00,2022-07-27 00:00:00,240,0,82,0,0,1619,1941,15750
2022-07-27 00:00:00,2022-07-27 01:00:00,235,0,82,0,0,1626,1943,15666
2022-07-27 01:00:00,2022-07-27 02:00:00,243,0,83,0,3,1723,2052,15728
2022-07-27 02:00:00,2022-07-27 03:00:00,246,0,83,0,94,1770,2193,15753
2022-07-27 03:00:00,2022-07-27 04:00:00,244,0,83,0,533,1449,2309,17781
2022-07-27 04:00:00,2022-07-27 05:00:00,244,0,83,0,1460,1081,2868,19718
2022-07-27 05:00:00,2022-07-27 06:00:00,245,0,85,0,2494,997,3821,20743
2022-07-27 06:00:00,2022-07-27 07:00:00,244,0,93,0,3599,1377,5313,21121
2022-07-27 07:00:00,2022-07-27 08:00:00,233,0,93,0,4413,1804,6543,21224
2022-07-27 08:00:00,2022-07-27 09:00:00,238,0,91,0,4686,2057,7072,21087
2022-07-27 09:00:00,2022-07-27 10:00:00,236,0,83,0,4654,2046,7019,20923
2022-07-27 10:00:00,2022-07-27 11:00:00,229,0,83,0,4841,2046,7199,21143
2022-07-27 11:00:00,2022-07-27 12:00:00,227,0,83,0,4499,2100,6909,20763
2022-07-27 12:00:00,2022-07-27 13:00:00,228,1,82,0,4008,1928,6247,20747
2022-07-27 13:00:00,2022-07-27 14:00:00,228,0,82,0,3364,1917,5591,20691
2022-07-27 14:00:00,2022-07-27 15:00:00,233,0,82,0,2448,1933,4696,20582
2022-07-27 15:00:00,2022-07-27 16:00:00,231,23,82,0,1355,1982,3673,20356
2022-07-27 16:00:00,2022-07-27 17:00:00,233,253,86,34,485,1851,2942,20484
2022-07-27 17:00:00,2022-07-27 18:00:00,232,488,99,39,119,1518,2495,20557
2022-07-27 18:00:00,2022-07-27 19:00:00,232,519,104,39,4,1513,2411,20410
2022-07-27 19:00:00,2022-07-27 20:00:00,234,208,93,5,0,1266,1806,19087
2022-07-27 20:00:00,2022-07-27 21:00:00,237,10,91,0,0,1205,1543,17651
2022-07-27 21:00:00,2022-07-27 22:00:00,234,7,95,0,0,1121,1457,16406
2022-07-27 22:00:00,2022-07-27 23:00:00,235,0,96,0,0,1208,1539,15777
2022-07-27 23:00:00,2022-07-28 00:00:00,234,0,96,0,0,1174,1504,15529
2022-07-28 00:00:00,2022-07-28 01:00:00,233,0,96,0,0,1053,1382,15418
2022-07-28 01:00:00,2022-07-28 02:00:00,232,0,96,0,2,1028,1358,15452
2022-07-28 02:00:00,2022-07-28 03:00:00,231,0,96,0,94,986,1407,15607
2022-07-28 03:00:00,2022-07-28 04:00:00,234,0,96,0,475,836,1641,17572
2022-07-28 04:00:00,2022-07-28 05:00:00,232,17,97,0,1461,637,2444,19243
2022-07-28 05:00:00,2022-07-28 06:00:00,230,182,93,0,2990,620,4115,20259
2022-07-28 06:00:00,2022-07-28 07:00:00,230,175,92,0,4019,710,5226,20334
2022-07-28 07:00:00,2022-07-28 08:00:00,226,18,86,0,5052,811,6193,20526
2022-07-28 08:00:00,2022-07-28 09:00:00,215,0,84,0,5573,663,6535,20821
2022-07-28 09:00:00,2022-07-28 10:00:00,219,0,84,0,5689,580,6572,20908
2022-07-28 10:00:00,2022-07-28 11:00:00,219,0,86,0,5777,501,6583,20987
2022-07-28 11:00:00,2022-07-28 12:00:00,217,0,85,0,5516,432,6250,20718
2022-07-28 12:00:00,2022-07-28 13:00:00,218,0,85,0,5050,418,5771,20678
2022-07-28 13:00:00,2022-07-28 14:00:00,224,0,85,0,4275,352,4936,20673
2022-07-28 14:00:00,2022-07-28 15:00:00,232,71,85,0,3051,320,3759,20531
2022-07-28 15:00:00,2022-07-28 16:00:00,229,341,114,0,1629,303,2616,20514
2022-07-28 16:00:00,2022-07-28 17:00:00,223,484,122,34,535,372,1770,20610
2022-07-28 17:00:00,2022-07-28 18:00:00,229,602,133,39,134,576,1713,20697
2022-07-28 18:00:00,2022-07-28 19:00:00,229,424,138,39,3,1054,1887,20453
2022-07-28 19:00:00,2022-07-28 20:00:00,229,26,104,5,0,1499,1863,19025
2022-07-28 20:00:00,2022-07-28 21:00:00,196,0,91,0,0,1844,2131,17551
2022-07-28 21:00:00,2022-07-28 22:00:00,106,0,88,0,0,2036,2230,16295
2022-07-28 22:00:00,2022-07-28 23:00:00,46,0,86,0,0,2160,2292,15794
2022-07-28 23:00:00,2022-07-29 00:00:00,46,0,86,0,0,2221,2353,15375
2022-07-29 00:00:00,2022-07-29 01:00:00,46,0,86,0,0,2251,2383,15293
2022-07-29 01:00:00,2022-07-29 02:00:00,47,0,86,0,3,2274,2410,15270
2022-07-29 02:00:00,2022-07-29 03:00:00,46,0,86,0,108,2289,2529,15335
2022-07-29 03:00:00,2022-07-29 04:00:00,46,0,85,0,609,1986,2726,17267
2022-07-29 04:00:00,2022-07-29 05:00:00,46,0,85,0,1859,1093,3083,19331
2022-07-29 05:00:00,2022-07-29 06:00:00,46,0,90,0,3319,565,4020,20480
2022-07-29 06:00:00,2022-07-29 07:00:00,34,0,97,0,4347,503,4981,20877
2022-07-29 07:00:00,2022-07-29 08:00:00,31,0,94,0,4790,560,5475,20678
2022-07-29 08:00:00,2022-07-29 09:00:00,31,0,93,0,5396,643,6163,21238
2022-07-29 09:00:00,2022-07-29 10:00:00,35,0,88,0,5499,764,6386,21347
2022-07-29 10:00:00,2022-07-29 11:00:00,42,0,88,0,5267,781,6178,21208
2022-07-29 11:00:00,2022-07-29 12:00:00,34,0,88,0,4862,849,5833,20744
2022-07-29 12:00:00,2022-07-29 13:00:00,46,0,89,0,4549,862,5546,21007
2022-07-29 13:00:00,2022-07-29 14:00:00,47,0,88,0,3593,1028,4756,20837
2022-07-29 14:00:00,2022-07-29 15:00:00,47,73,88,0,2240,1166,3614,20437
2022-07-29 15:00:00,2022-07-29 16:00:00,47,399,120,0,1186,1362,3114,20371
2022-07-29 16:00:00,2022-07-29 17:00:00,47,899,131,34,565,1577,3253,20493
2022-07-29 17:00:00,2022-07-29 18:00:00,47,852,144,39,135,2045,3262,20359
2022-07-29 18:00:00,2022-07-29 19:00:00,46,659,148,39,3,2802,3697,20115
2022-07-29 19:00:00,2022-07-29 20:00:00,46,67,131,5,0,3229,3478,18800
2022-07-29 20:00:00,2022-07-29 21:00:00,46,0,123,0,0,3188,3357,17511
2022-07-29 21:00:00,2022-07-29 22:00:00,46,0,123,0,0,3047,3216,16394
2022-07-29 22:00:00,2022-07-29 23:00:00,46,0,123,0,0,2874,3043,15560
2022-07-29 23:00:00,2022-07-30 00:00:00,46,0,123,0,0,2720,2889,15041
2022-07-30 00:00:00,2022-07-30 01:00:00,46,0,123,0,0,2599,2768,14918
2022-07-30 01:00:00,2022-07-30 02:00:00,46,0,123,0,3,2401,2573,14812
2022-07-30 02:00:00,2022-07-30 03:00:00,47,0,123,0,95,2198,2463,14376
2022-07-30 03:00:00,2022-07-30 04:00:00,46,0,123,0,439,1903,2511,15282
2022-07-30 04:00:00,2022-07-30 05:00:00,46,0,122,0,985,1145,2298,16361
2022-07-30 05:00:00,2022-07-30 06:00:00,45,0,112,0,1780,644,2581,17636
2022-07-30 06:00:00,2022-07-30 07:00:00,46,120,94,0,2641,575,3476,18591
2022-07-30 07:00:00,2022-07-30 08:00:00,46,75,94,0,3125,796,4136,18994
2022-07-30 08:00:00,2022-07-30 09:00:00,46,11,87,0,3384,940,4468,19266
2022-07-30 09:00:00,2022-07-30 10:00:00,45,0,85,0,2962,1060,4152,19051
2022-07-30 10:00:00,2022-07-30 11:00:00,45,0,85,0,2683,1214,4027,19008
2022-07-30 11:00:00,2022-07-30 12:00:00,46,0,86,0,2259,1415,3806,18718
2022-07-30 12:00:00,2022-07-30 13:00:00,45,0,88,0,1870,1492,3495,18433
2022-07-30 13:00:00,2022-07-30 14:00:00,46,19,88,0,1489,1574,3216,18360
2022-07-30 14:00:00,2022-07-30 15:00:00,46,0,88,0,986,1731,2851,18248
2022-07-30 15:00:00,2022-07-30 16:00:00,47,221,102,0,547,1731,2648,18044
2022-07-30 16:00:00,2022-07-30 17:00:00,47,685,128,34,212,1841,2947,18017
2022-07-30 17:00:00,2022-07-30 18:00:00,46,777,142,39,73,2067,3144,18109
2022-07-30 18:00:00,2022-07-30 19:00:00,46,537,128,39,2,2285,3037,17850
2022-07-30 19:00:00,2022-07-30 20:00:00,46,6,92,5,0,2356,2505,16930
2022-07-30 20:00:00,2022-07-30 21:00:00,46,0,88,0,0,2352,2486,15713
2022-07-30 21:00:00,2022-07-30 22:00:00,47,0,85,0,0,2373,2505,14669
2022-07-30 22:00:00,2022-07-30 23:00:00,46,0,84,0,0,2305,2435,14148
2022-07-30 23:00:00,2022-07-31 00:00:00,37,0,86,0,0,2211,2334,13771
2022-07-31 00:00:00,2022-07-31 01:00:00,27,0,90,0,0,2175,2292,13548
2022-07-31 01:00:00,2022-07-31 02:00:00,27,0,90,0,2,2181,2300,13438
2022-07-31 02:00:00,2022-07-31 03:00:00,27,0,90,0,61,2133,2311,13052
2022-07-31 03:00:00,2022-07-31 04:00:00,27,0,90,0,196,2117,2430,13364
2022-07-31 04:00:00,2022-07-31 05:00:00,27,0,91,0,492,2168,2778,13957
2022-07-31 05:00:00,2022-07-31 06:00:00,27,0,95,0,1013,1965,3100,14740
2022-07-31 06:00:00,2022-07-31 07:00:00,27,0,103,0,1577,2014,3721,15733
2022-07-31 07:00:00,2022-07-31 08:00:00,27,0,102,0,2175,2136,4440,16379
2022-07-31 08:00:00,2022-07-31 09:00:00,27,0,103,0,2584,2278,4992,16691
2022-07-31 09:00:00,2022-07-31 10:00:00,27,0,94,0,2859,2379,5359,16741
2022-07-31 10:00:00,2022-07-31 11:00:00,27,0,94,0,2818,2336,5275,16542
2022-07-31 11:00:00,2022-07-31 12:00:00,27,0,99,0,2745,2253,5124,16296
2022-07-31 12:00:00,2022-07-31 13:00:00,26,0,104,0,2560,2152,4842,16153
2022-07-31 13:00:00,2022-07-31 14:00:00,26,0,110,0,2198,1962,4296,16123
2022-07-31 14:00:00,2022-07-31 15:00:00,32,24,111,0,1714,1676,3557,16256
2022-07-31 15:00:00,2022-07-31 16:00:00,46,272,118,0,949,1377,2762,16552
2022-07-31 16:00:00,2022-07-31 17:00:00,51,324,133,35,359,1073,1975,16722
2022-07-31 17:00:00,2022-07-31 18:00:00,57,538,162,39,157,989,1942,17016
2022-07-31 18:00:00,2022-07-31 19:00:00,64,728,168,39,14,1029,2042,17147
2022-07-31 19:00:00,2022-07-31 20:00:00,67,546,134,5,0,1108,1860,16475
2022-07-31 20:00:00,2022-07-31 21:00:00,69,69,129,0,0,1095,1362,15335
2022-07-31 21:00:00,2022-07-31 22:00:00,70,1,106,0,0,968,1145,14429
2022-07-31 22:00:00,2022-07-31 23:00:00,70,0,102,0,0,863,1035,13920
2022-07-31 23:00:00,2022-08-01 00:00:00,70,0,97,0,0,780,947,13630
2022-08-01 00:00:00,2022-08-01 01:00:00,71,0,92,0,0,807,970,13771
2022-08-01 01:00:00,2022-08-01 02:00:00,76,0,92,0,1,787,956,13888
2022-08-01 02:00:00,2022-08-01 03:00:00,82,0,92,0,98,756,1028,14261
2022-08-01 03:00:00,2022-08-01 04:00:00,86,17,109,0,426,723,1361,16704
2022-08-01 04:00:00,2022-08-01 05:00:00,89,292,112,0,1153,530,2176,18814
2022-08-01 05:00:00,2022-08-01 06:00:00,91,247,122,0,2032,412,2904,19950
2022-08-01 06:00:00,2022-08-01 07:00:00,91,66,128,0,2953,348,3586,20476
2022-08-01 07:00:00,2022-08-01 08:00:00,91,0,127,0,3762,315,4295,20514
2022-08-01 08:00:00,2022-08-01 09:00:00,91,0,125,0,4127,348,4691,20519
2022-08-01 09:00:00,2022-08-01 10:00:00,91,0,115,0,4413,380,4999,20631
2022-08-01 10:00:00,2022-08-01 11:00:00,91,0,113,0,4578,428,5210,20691
2022-08-01 11:00:00,2022-08-01 12:00:00,91,0,113,0,4291,514,5009,20304
2022-08-01 12:00:00,2022-08-01 13:00:00,91,58,113,0,3874,608,4744,20503
2022-08-01 13:00:00,2022-08-01 14:00:00,91,338,114,0,3239,733,4515,20569
2022-08-01 14:00:00,2022-08-01 15:00:00,91,415,114,0,2140,795,3555,20377
2022-08-01 15:00:00,2022-08-01 16:00:00,91,648,115,0,1094,662,2610,20132
2022-08-01 16:00:00,2022-08-01 17:00:00,91,976,114,35,427,641,2284,20294
2022-08-01 17:00:00,2022-08-01 18:00:00,91,872,148,40,92,636,1879,20531
2022-08-01 18:00:00,2022-08-01 19:00:00,91,729,150,40,0,639,1649,20216
2022-08-01 19:00:00,2022-08-01 20:00:00,91,467,133,5,0,711,1407,18798
2022-08-01 20:00:00,2022-08-01 21:00:00,91,33,112,0,0,753,989,17366
2022-08-01 21:00:00,2022-08-01 22:00:00,93,0,94,0,0,794,981,16219
2022-08-01 22:00:00,2022-08-01 23:00:00,93,0,91,0,0,791,975,15584
2022-08-01 23:00:00,2022-08-02 00:00:00,93,0,91,0,0,847,1031,15258
2022-08-02 00:00:00,2022-08-02 01:00:00,93,0,91,0,0,897,1081,15266
2022-08-02 01:00:00,2022-08-02 02:00:00,93,0,91,0,1,672,857,15223
2022-08-02 02:00:00,2022-08-02 03:00:00,93,0,91,0,75,637,896,15404
2022-08-02 03:00:00,2022-08-02 04:00:00,93,0,91,0,413,570,1167,17579
2022-08-02 04:00:00,2022-08-02 05:00:00,93,0,92,0,1294,333,1812,19537
2022-08-02 05:00:00,2022-08-02 06:00:00,93,117,99,0,2465,242,3016,20751
2022-08-02 06:00:00,2022-08-02 07:00:00,93,58,105,0,3469,234,3959,20953
2022-08-02 07:00:00,2022-08-02 08:00:00,93,0,105,0,4631,231,5060,21079
2022-08-02 08:00:00,2022-08-02 09:00:00,93,0,109,0,5315,210,5727,21431
2022-08-02 09:00:00,2022-08-02 10:00:00,93,0,108,0,5188,219,5608,21205
2022-08-02 10:00:00,2022-08-02 11:00:00,93,0,108,0,5317,212,5730,21221
2022-08-02 11:00:00,2022-08-02 12:00:00,90,0,120,0,5167,205,5582,20976
2022-08-02 12:00:00,2022-08-02 13:00:00,78,0,117,0,4822,213,5230,21037
2022-08-02 13:00:00,2022-08-02 14:00:00,92,0,118,0,3901,212,4323,20857
2022-08-02 14:00:00,2022-08-02 15:00:00,93,0,119,0,2811,231,3254,20809
2022-08-02 15:00:00,2022-08-02 16:00:00,93,34,119,35,1369,187,1837,20497
2022-08-02 16:00:00,2022-08-02 17:00:00,93,464,128,40,414,133,1272,20540
2022-08-02 17:00:00,2022-08-02 18:00:00,93,512,141,40,89,204,1079,20868
2022-08-02 18:00:00,2022-08-02 19:00:00,93,428,144,40,0,363,1068,20595
2022-08-02 19:00:00,2022-08-02 20:00:00,90,9,132,40,0,481,752,19087
2022-08-02 20:00:00,2022-08-02 21:00:00,93,0,129,5,0,596,823,17554
2022-08-02 21:00:00,2022-08-02 22:00:00,93,0,101,0,0,759,953,16324
2022-08-02 22:00:00,2022-08-02 23:00:00,93,0,97,0,0,853,1043,15622
2022-08-02 23:00:00,2022-08-03 00:00:00,93,0,97,0,0,812,1002,15297
2022-08-03 00:00:00,2022-08-03 01:00:00,93,0,97,0,0,680,870,15226
2022-08-03 01:00:00,2022-08-03 02:00:00,93,0,99,0,3,637,832,15342
2022-08-03 02:00:00,2022-08-03 03:00:00,93,0,99,0,95,647,934,15484
2022-08-03 03:00:00,2022-08-03 04:00:00,93,0,99,0,563,572,1327,17697
2022-08-03 04:00:00,2022-08-03 05:00:00,93,33,99,0,1509,367,2101,19548
2022-08-03 05:00:00,2022-08-03 06:00:00,93,297,100,0,2876,144,3510,20783
2022-08-03 06:00:00,2022-08-03 07:00:00,93,108,100,0,4331,66,4698,21292
2022-08-03 07:00:00,2022-08-03 08:00:00,93,0,102,0,5395,134,5724,21211
2022-08-03 08:00:00,2022-08-03 09:00:00,93,0,98,0,6019,198,6408,21634
2022-08-03 09:00:00,2022-08-03 10:00:00,93,0,99,0,6142,200,6534,21726
2022-08-03 10:00:00,2022-08-03 11:00:00,93,0,97,0,6081,186,6457,21692
2022-08-03 11:00:00,2022-08-03 12:00:00,93,0,98,0,5696,173,6060,21268
2022-08-03 12:00:00,2022-08-03 13:00:00,93,0,97,0,5113,170,5473,21213
2022-08-03 13:00:00,2022-08-03 14:00:00,93,0,97,0,4254,150,4594,21382
2022-08-03 14:00:00,2022-08-03 15:00:00,93,0,97,0,3009,134,3333,21323
2022-08-03 15:00:00,2022-08-03 16:00:00,93,338,101,35,1467,147,2181,21194
2022-08-03 16:00:00,2022-08-03 17:00:00,93,845,117,40,405,241,1741,21089
2022-08-03 17:00:00,2022-08-03 18:00:00,93,944,129,40,97,575,1878,21276
2022-08-03 18:00:00,2022-08-03 19:00:00,92,1294,134,40,0,1031,2591,20826
2022-08-03 19:00:00,2022-08-03 20:00:00,92,176,144,5,0,1616,2033,19313
2022-08-03 20:00:00,2022-08-03 21:00:00,92,0,134,0,0,2204,2430,17726
2022-08-03 21:00:00,2022-08-03 22:00:00,92,0,127,0,0,2640,2859,16539
2022-08-03 22:00:00,2022-08-03 23:00:00,92,0,126,0,0,2564,2782,15803
2022-08-03 23:00:00,2022-08-04 00:00:00,92,0,126,0,0,2322,2540,15491
2022-08-04 00:00:00,2022-08-04 01:00:00,92,0,126,0,0,2140,2358,15391
2022-08-04 01:00:00,2022-08-04 02:00:00,92,0,126,0,1,1875,2094,15442
2022-08-04 02:00:00,2022-08-04 03:00:00,92,0,126,0,79,1681,1978,15514
2022-08-04 03:00:00,2022-08-04 04:00:00,92,0,126,0,518,1426,2162,17632
2022-08-04 04:00:00,2022-08-04 05:00:00,92,0,126,0,1776,862,2856,19903
2022-08-04 05:00:00,2022-08-04 06:00:00,91,125,127,0,3357,254,3954,21167
2022-08-04 06:00:00,2022-08-04 07:00:00,92,368,127,0,4654,127,5368,21531
2022-08-04 07:00:00,2022-08-04 08:00:00,92,80,126,0,5651,287,6236,21463
2022-08-04 08:00:00,2022-08-04 09:00:00,91,0,125,0,6237,627,7080,21621
2022-08-04 09:00:00,2022-08-04 10:00:00,81,0,101,0,6489,768,7439,21715
2022-08-04 10:00:00,2022-08-04 11:00:00,87,0,96,0,6411,779,7373,21706
2022-08-04 11:00:00,2022-08-04 12:00:00,91,0,96,0,6055,737,6979,21356
2022-08-04 12:00:00,2022-08-04 13:00:00,92,0,96,0,5340,666,6194,21522
2022-08-04 13:00:00,2022-08-04 14:00:00,92,0,96,0,4284,664,5136,21525
2022-08-04 14:00:00,2022-08-04 15:00:00,92,153,96,0,2926,714,3981,21572
2022-08-04 15:00:00,2022-08-04 16:00:00,92,608,96,35,1365,854,3050,21347
2022-08-04 16:00:00,2022-08-04 17:00:00,92,866,110,40,443,1252,2803,21304
2022-08-04 17:00:00,2022-08-04 18:00:00,92,662,114,40,96,2241,3245,21200
2022-08-04 18:00:00,2022-08-04 19:00:00,92,136,119,40,0,3470,3857,20877
2022-08-04 19:00:00,2022-08-04 20:00:00,91,0,107,5,0,4152,4355,19351
2022-08-04 20:00:00,2022-08-04 21:00:00,92,0,99,0,0,4221,4412,17852
2022-08-04 21:00:00,2022-08-04 22:00:00,91,0,96,0,0,4054,4241,16600
2022-08-04 22:00:00,2022-08-04 23:00:00,91,0,95,0,0,3826,4012,15939
2022-08-04 23:00:00,2022-08-05 00:00:00,91,0,95,0,0,3416,3602,15684
2022-08-05 00:00:00,2022-08-05 01:00:00,91,0,95,0,0,3083,3269,15502
2022-08-05 01:00:00,2022-08-05 02:00:00,91,0,95,0,1,2911,3098,15581
2022-08-05 02:00:00,2022-08-05 03:00:00,91,0,95,0,70,2618,2874,15655
2022-08-05 03:00:00,2022-08-05 04:00:00,91,0,95,0,472,2170,2828,17639
2022-08-05 04:00:00,2022-08-05 05:00:00,91,0,95,0,1781,1339,3306,19922
2022-08-05 05:00:00,2022-08-05 06:00:00,91,0,96,0,3374,682,4243,21192
2022-08-05 06:00:00,2022-08-05 07:00:00,91,0,97,0,4658,791,5637,21583
2022-08-05 07:00:00,2022-08-05 08:00:00,91,0,97,0,5619,1342,7149,21547
2022-08-05 08:00:00,2022-08-05 09:00:00,91,0,97,0,6149,1614,7951,21857
2022-08-05 09:00:00,2022-08-05 10:00:00,91,0,96,0,6233,1556,7976,21904
2022-08-05 10:00:00,2022-08-05 11:00:00,91,0,96,0,6269,1397,7853,21885
2022-08-05 11:00:00,2022-08-05 12:00:00,91,0,97,0,5768,1324,7280,21499
2022-08-05 12:00:00,2022-08-05 13:00:00,90,0,96,0,4999,1165,6350,21695
2022-08-05 13:00:00,2022-08-05 14:00:00,90,0,96,0,4011,1012,5209,21779
2022-08-05 14:00:00,2022-08-05 15:00:00,90,246,97,0,2621,946,4000,21744
2022-08-05 15:00:00,2022-08-05 16:00:00,90,718,112,35,1191,1186,3332,21518
2022-08-05 16:00:00,2022-08-05 17:00:00,90,884,128,40,340,1684,3166,21372
2022-08-05 17:00:00,2022-08-05 18:00:00,90,950,127,40,73,2128,3408,21235
2022-08-05 18:00:00,2022-08-05 19:00:00,90,606,147,40,0,2269,3152,20878
2022-08-05 19:00:00,2022-08-05 20:00:00,90,174,136,5,0,2268,2673,19443
2022-08-05 20:00:00,2022-08-05 21:00:00,90,22,134,0,0,2295,2541,18114
2022-08-05 21:00:00,2022-08-05 22:00:00,90,107,135,0,0,2083,2415,16819
2022-08-05 22:00:00,2022-08-05 23:00:00,90,14,133,0,0,2091,2328,16098
2022-08-05 23:00:00,2022-08-06 00:00:00,90,0,134,0,0,2220,2444,15595
2022-08-06 00:00:00,2022-08-06 01:00:00,90,0,132,0,0,2489,2711,15482
2022-08-06 01:00:00,2022-08-06 02:00:00,90,0,132,0,1,2679,2902,15289
2022-08-06 02:00:00,2022-08-06 03:00:00,90,0,131,0,62,2486,2769,14916
2022-08-06 03:00:00,2022-08-06 04:00:00,90,0,101,0,313,2575,3079,15526
2022-08-06 04:00:00,2022-08-06 05:00:00,90,0,96,0,829,2536,3551,16565
2022-08-06 05:00:00,2022-08-06 06:00:00,90,0,95,0,1334,2543,4062,17714
2022-08-06 06:00:00,2022-08-06 07:00:00,90,0,101,0,1917,2533,4641,18552
2022-08-06 07:00:00,2022-08-06 08:00:00,90,50,99,0,2438,2721,5398,18955
2022-08-06 08:00:00,2022-08-06 09:00:00,90,69,97,0,2835,2635,5726,18900
2022-08-06 09:00:00,2022-08-06 10:00:00,90,0,91,0,3175,2820,6176,18769
2022-08-06 10:00:00,2022-08-06 11:00:00,90,0,91,0,3375,2846,6402,18461
2022-08-06 11:00:00,2022-08-06 12:00:00,90,0,90,0,3530,2732,6442,17964
2022-08-06 12:00:00,2022-08-06 13:00:00,90,0,90,0,3446,2641,6267,17770
2022-08-06 13:00:00,2022-08-06 14:00:00,90,0,92,0,2922,2523,5627,17578
2022-08-06 14:00:00,2022-08-06 15:00:00,90,0,93,0,2011,2395,4589,17548
2022-08-06 15:00:00,2022-08-06 16:00:00,90,17,93,0,1111,2177,3488,17585
2022-08-06 16:00:00,2022-08-06 17:00:00,90,706,108,0,380,1722,3006,17594
2022-08-06 17:00:00,2022-08-06 18:00:00,90,1281,110,35,79,1469,3064,17759
2022-08-06 18:00:00,2022-08-06 19:00:00,90,1291,102,40,0,1619,3142,17777
2022-08-06 19:00:00,2022-08-06 20:00:00,90,690,93,40,0,1749,2662,16558
2022-08-06 20:00:00,2022-08-06 21:00:00,89,342,90,5,0,1702,2228,15510
2022-08-06 21:00:00,2022-08-06 22:00:00,75,82,90,0,0,1630,1877,14431
2022-08-06 22:00:00,2022-08-06 23:00:00,73,7,90,0,0,1458,1628,13938
2022-08-06 23:00:00,2022-08-07 00:00:00,73,0,90,0,0,1276,1439,13646
2022-08-07 00:00:00,2022-08-07 01:00:00,73,0,90,0,0,1118,1281,13468
2022-08-07 01:00:00,2022-08-07 02:00:00,73,0,90,0,1,850,1014,13195
2022-08-07 02:00:00,2022-08-07 03:00:00,73,49,90,0,68,721,1001,12760
2022-08-07 03:00:00,2022-08-07 04:00:00,73,179,90,0,422,581,1345,13014
2022-08-07 04:00:00,2022-08-07 05:00:00,73,413,91,0,1672,335,2584,13784
2022-08-07 05:00:00,2022-08-07 06:00:00,73,220,97,0,3415,128,3933,14884
2022-08-07 06:00:00,2022-08-07 07:00:00,73,0,103,0,4468,220,4864,15331
2022-08-07 07:00:00,2022-08-07 08:00:00,73,0,105,0,4904,318,5400,15384
2022-08-07 08:00:00,2022-08-07 09:00:00,73,0,105,0,5062,351,5591,15504
2022-08-07 09:00:00,2022-08-07 10:00:00,73,0,104,0,5289,391,5857,15840
2022-08-07 10:00:00,2022-08-07 11:00:00,73,0,104,0,5340,377,5894,15786
2022-08-07 11:00:00,2022-08-07 12:00:00,73,0,102,0,5270,319,5764,15507
2022-08-07 12:00:00,2022-08-07 13:00:00,73,0,97,0,4724,299,5193,15421
2022-08-07 13:00:00,2022-08-07 14:00:00,73,0,97,0,3709,274,4153,15217
2022-08-07 14:00:00,2022-08-07 15:00:00,74,0,99,0,2692,265,3130,15690
2022-08-07 15:00:00,2022-08-07 16:00:00,78,28,100,0,1433,261,1900,16245
2022-08-07 16:00:00,2022-08-07 17:00:00,78,606,132,35,423,312,1586,16441
2022-08-07 17:00:00,2022-08-07 18:00:00,78,831,136,40,90,472,1647,16878
2022-08-07 18:00:00,2022-08-07 19:00:00,78,935,123,40,0,698,1874,17107
2022-08-07 19:00:00,2022-08-07 20:00:00,78,317,103,39,0,857,1394,16481
2022-08-07 20:00:00,2022-08-07 21:00:00,79,0,101,5,0,914,1099,15351
2022-08-07 21:00:00,2022-08-07 22:00:00,90,0,100,0,0,860,1050,14449
2022-08-07 22:00:00,2022-08-07 23:00:00,91,1,103,0,0,810,1005,13937
2022-08-07 23:00:00,2022-08-08 00:00:00,91,59,103,0,0,672,925,13693
2022-08-08 00:00:00,2022-08-08 01:00:00,91,8,103,0,0,603,805,13723
2022-08-08 01:00:00,2022-08-08 02:00:00,91,0,103,0,0,511,705,13992
2022-08-08 02:00:00,2022-08-08 03:00:00,91,0,103,0,61,382,637,14382
2022-08-08 03:00:00,2022-08-08 04:00:00,91,0,103,0,439,301,934,16855
2022-08-08 04:00:00,2022-08-08 05:00:00,91,17,103,0,1436,213,1860,18957
2022-08-08 05:00:00,2022-08-08 06:00:00,91,163,120,0,2810,101,3285,20249
2022-08-08 06:00:00,2022-08-08 07:00:00,93,51,129,0,4185,66,4524,20892
2022-08-08 07:00:00,2022-08-08 08:00:00,93,0,127,0,5006,99,5325,20890
2022-08-08 08:00:00,2022-08-08 09:00:00,93,0,126,0,4982,107,5308,21167
2022-08-08 09:00:00,2022-08-08 10:00:00,93,0,125,0,4851,117,5186,21333
2022-08-08 10:00:00,2022-08-08 11:00:00,93,0,104,0,4583,139,4919,21130
2022-08-08 11:00:00,2022-08-08 12:00:00,93,0,101,0,4382,180,4756,20967
2022-08-08 12:00:00,2022-08-08 13:00:00,88,0,101,0,3637,236,4062,20812
2022-08-08 13:00:00,2022-08-08 14:00:00,93,0,101,0,2996,277,3467,20811
2022-08-08 14:00:00,2022-08-08 15:00:00,93,25,101,0,2109,328,2656,20727
2022-08-08 15:00:00,2022-08-08 16:00:00,93,350,102,35,1003,387,1970,20446
2022-08-08 16:00:00,2022-08-08 17:00:00,93,653,116,40,352,416,1670,20672
2022-08-08 17:00:00,2022-08-08 18:00:00,93,736,127,39,65,529,1589,21028
2022-08-08 18:00:00,2022-08-08 19:00:00,93,717,145,39,0,718,1712,20548
2022-08-08 19:00:00,2022-08-08 20:00:00,93,49,137,5,0,867,1151,18880
2022-08-08 20:00:00,2022-08-08 21:00:00,92,0,117,0,0,902,1111,17495
2022-08-08 21:00:00,2022-08-08 22:00:00,54,0,99,0,0,839,992,16351
2022-08-08 22:00:00,2022-08-08 23:00:00,48,0,98,0,0,738,884,15722
2022-08-08 23:00:00,2022-08-09 00:00:00,48,0,98,0,0,590,736,15372
2022-08-09 00:00:00,2022-08-09 01:00:00,48,0,98,0,0,446,592,15367
2022-08-09 01:00:00,2022-08-09 02:00:00,48,0,98,0,0,342,488,15461
2022-08-09 02:00:00,2022-08-09 03:00:00,48,0,98,0,41,288,475,15612
2022-08-09 03:00:00,2022-08-09 04:00:00,48,0,98,0,328,264,738,17711
2022-08-09 04:00:00,2022-08-09 05:00:00,48,83,97,0,1153,198,1579,19678
2022-08-09 05:00:00,2022-08-09 06:00:00,48,168,101,0,2261,96,2674,20676
2022-08-09 06:00:00,2022-08-09 07:00:00,48,9,105,0,3445,101,3708,21132
2022-08-09 07:00:00,2022-08-09 08:00:00,49,0,97,0,4732,143,5021,21281
2022-08-09 08:00:00,2022-08-09 09:00:00,49,0,96,0,5186,137,5468,21490
2022-08-09 09:00:00,2022-08-09 10:00:00,49,0,95,0,4889,171,5204,21449
2022-08-09 10:00:00,2022-08-09 11:00:00,49,0,95,0,4304,277,4725,21236
2022-08-09 11:00:00,2022-08-09 12:00:00,49,0,95,0,4225,463,4832,21058
2022-08-09 12:00:00,2022-08-09 13:00:00,49,0,95,0,3942,590,4676,21203
2022-08-09 13:00:00,2022-08-09 14:00:00,49,0,94,0,3236,621,4000,20991
2022-08-09 14:00:00,2022-08-09 15:00:00,49,0,94,0,2220,732,3095,20877
2022-08-09 15:00:00,2022-08-09 16:00:00,49,260,97,0,1170,715,2291,20666
2022-08-09 16:00:00,2022-08-09 17:00:00,49,679,112,34,375,640,1889,20702
2022-08-09 17:00:00,2022-08-09 18:00:00,49,859,114,39,55,728,1844,21081
2022-08-09 18:00:00,2022-08-09 19:00:00,49,675,105,39,0,904,1772,20596
2022-08-09 19:00:00,2022-08-09 20:00:00,49,68,98,5,0,967,1187,19018
2022-08-09 20:00:00,2022-08-09 21:00:00,49,0,97,0,0,934,1080,17470
2022-08-09 21:00:00,2022-08-09 22:00:00,49,0,95,0,0,821,965,16375
2022-08-09 22:00:00,2022-08-09 23:00:00,49,0,93,0,0,737,879,15769
2022-08-09 23:00:00,2022-08-10 00:00:00,49,0,93,0,0,573,715,15433
2022-08-10 00:00:00,2022-08-10 01:00:00,49,0,93,0,0,444,586,15378
2022-08-10 01:00:00,2022-08-10 02:00:00,49,0,93,0,0,405,547,15606
2022-08-10 02:00:00,2022-08-10 03:00:00,49,0,93,0,52,422,616,15687
2022-08-10 03:00:00,2022-08-10 04:00:00,49,17,93,0,432,386,977,17701
2022-08-10 04:00:00,2022-08-10 05:00:00,49,277,92,0,1696,205,2319,19687
2022-08-10 05:00:00,2022-08-10 06:00:00,49,484,94,0,3406,41,4074,20873
2022-08-10 06:00:00,2022-08-10 07:00:00,49,107,98,0,4737,77,5068,21137
2022-08-10 07:00:00,2022-08-10 08:00:00,49,0,93,0,5560,148,5850,21248
2022-08-10 08:00:00,2022-08-10 09:00:00,49,0,93,0,5579,187,5908,21355
2022-08-10 09:00:00,2022-08-10 10:00:00,49,0,93,0,5517,246,5905,21439
2022-08-10 10:00:00,2022-08-10 11:00:00,49,0,93,0,5460,300,5902,21243
2022-08-10 11:00:00,2022-08-10 12:00:00,49,0,93,0,5186,379,5707,20813
2022-08-10 12:00:00,2022-08-10 13:00:00,49,0,93,0,4753,478,5373,20963
2022-08-10 13:00:00,2022-08-10 14:00:00,49,0,94,0,3942,540,4625,20903
2022-08-10 14:00:00,2022-08-10 15:00:00,49,0,94,0,2629,665,3437,20689
2022-08-10 15:00:00,2022-08-10 16:00:00,49,41,99,0,1166,702,2057,20541
2022-08-10 16:00:00,2022-08-10 17:00:00,49,398,113,34,293,734,1621,20729
2022-08-10 17:00:00,2022-08-10 18:00:00,49,590,113,39,51,1143,1985,21207
2022-08-10 18:00:00,2022-08-10 19:00:00,49,355,114,39,0,1470,2027,20717
2022-08-10 19:00:00,2022-08-10 20:00:00,49,0,114,5,0,1592,1760,19027
2022-08-10 20:00:00,2022-08-10 21:00:00,49,0,107,0,0,1668,1824,17524
2022-08-10 21:00:00,2022-08-10 22:00:00,49,0,92,0,0,1520,1661,16468
2022-08-10 22:00:00,2022-08-10 23:00:00,49,0,92,0,0,1405,1546,15773
2022-08-10 23:00:00,2022-08-11 00:00:00,49,0,92,0,0,1202,1343,15531
2022-08-11 00:00:00,2022-08-11 01:00:00,49,0,92,0,0,915,1056,15457
2022-08-11 01:00:00,2022-08-11 02:00:00,49,0,92,0,0,689,830,15583
2022-08-11 02:00:00,2022-08-11 03:00:00,49,0,92,0,47,596,784,15635
2022-08-11 03:00:00,2022-08-11 04:00:00,49,0,92,0,391,537,1069,17637
2022-08-11 04:00:00,2022-08-11 05:00:00,49,0,92,0,1605,382,2128,19608
2022-08-11 05:00:00,2022-08-11 06:00:00,49,0,92,0,3241,93,3475,20769
2022-08-11 06:00:00,2022-08-11 07:00:00,50,0,92,0,4524,98,4764,21033
2022-08-11 07:00:00,2022-08-11 08:00:00,50,0,90,0,5321,262,5723,20938
2022-08-11 08:00:00,2022-08-11 09:00:00,49,0,90,0,5552,386,6077,21301
2022-08-11 09:00:00,2022-08-11 10:00:00,49,0,90,0,5368,406,5913,21338
2022-08-11 10:00:00,2022-08-11 11:00:00,49,0,90,0,5118,419,5676,21178
2022-08-11 11:00:00,2022-08-11 12:00:00,49,0,90,0,5202,500,5841,21302
2022-08-11 12:00:00,2022-08-11 13:00:00,50,0,94,0,4640,604,5388,21374
2022-08-11 13:00:00,2022-08-11 14:00:00,49,0,95,0,3213,782,4139,20725
2022-08-11 14:00:00,2022-08-11 15:00:00,49,0,95,0,2078,896,3118,20595
2022-08-11 15:00:00,2022-08-11 16:00:00,49,101,102,0,927,864,2043,20511
2022-08-11 16:00:00,2022-08-11 17:00:00,49,611,136,34,272,831,1933,20752
2022-08-11 17:00:00,2022-08-11 18:00:00,49,840,135,39,44,1220,2327,21142
2022-08-11 18:00:00,2022-08-11 19:00:00,49,580,127,39,0,1478,2273,20615
2022-08-11 19:00:00,2022-08-11 20:00:00,49,0,122,5,0,1643,1819,19010
2022-08-11 20:00:00,2022-08-11 21:00:00,49,0,121,0,0,1675,1845,17658
2022-08-11 21:00:00,2022-08-11 22:00:00,49,0,117,0,0,1677,1843,16540
2022-08-11 22:00:00,2022-08-11 23:00:00,49,0,116,0,0,1591,1756,15879
2022-08-11 23:00:00,2022-08-12 00:00:00,49,0,116,0,0,1479,1644,15579
2022-08-12 00:00:00,2022-08-12 01:00:00,49,0,116,0,0,1386,1551,15593
2022-08-12 01:00:00,2022-08-12 02:00:00,49,0,116,0,0,1162,1327,15598
2022-08-12 02:00:00,2022-08-12 03:00:00,49,0,116,0,41,1039,1245,15707
2022-08-12 03:00:00,2022-08-12 04:00:00,49,0,115,0,344,999,1507,17769
2022-08-12 04:00:00,2022-08-12 05:00:00,49,17,116,0,1366,578,2126,19652
2022-08-12 05:00:00,2022-08-12 06:00:00,50,140,103,0,2763,183,3239,20862
2022-08-12 06:00:00,2022-08-12 07:00:00,50,17,95,0,4123,161,4446,21291
2022-08-12 07:00:00,2022-08-12 08:00:00,43,0,95,0,5004,362,5504,21203
2022-08-12 08:00:00,2022-08-12 09:00:00,41,0,95,0,5435,659,6230,21491
2022-08-12 09:00:00,2022-08-12 10:00:00,41,0,95,0,5347,812,6295,21384
2022-08-12 10:00:00,2022-08-12 11:00:00,41,0,89,0,5111,855,6096,21305
2022-08-12 11:00:00,2022-08-12 12:00:00,43,0,88,0,4629,949,5709,20973
2022-08-12 12:00:00,2022-08-12 13:00:00,50,0,88,0,4007,1034,5179,21077
2022-08-12 13:00:00,2022-08-12 14:00:00,50,0,88,0,3265,1055,4458,21041
2022-08-12 14:00:00,2022-08-12 15:00:00,50,0,88,0,2285,1195,3618,20985
2022-08-12 15:00:00,2022-08-12 16:00:00,50,152,89,0,1130,1213,2634,20800
2022-08-12 16:00:00,2022-08-12 17:00:00,50,597,104,34,287,1172,2244,20673
2022-08-12 17:00:00,2022-08-12 18:00:00,50,938,113,39,52,1470,2662,20985
2022-08-12 18:00:00,2022-08-12 19:00:00,50,547,124,39,0,1875,2635,20319
2022-08-12 19:00:00,2022-08-12 20:00:00,49,9,95,5,0,1982,2140,18847
2022-08-12 20:00:00,2022-08-12 21:00:00,49,0,87,0,0,1995,2131,17576
2022-08-12 21:00:00,2022-08-12 22:00:00,49,0,81,0,0,1746,1876,16429
2022-08-12 22:00:00,2022-08-12 23:00:00,49,0,80,0,0,1423,1552,15688
2022-08-12 23:00:00,2022-08-13 00:00:00,50,178,80,0,0,1146,1454,15297
2022-08-13 00:00:00,2022-08-13 01:00:00,50,17,80,0,0,994,1141,15186
2022-08-13 01:00:00,2022-08-13 02:00:00,50,55,80,0,0,985,1170,15036
2022-08-13 02:00:00,2022-08-13 03:00:00,50,47,80,0,49,1090,1316,14654
2022-08-13 03:00:00,2022-08-13 04:00:00,49,7,80,0,250,1170,1556,15364
2022-08-13 04:00:00,2022-08-13 05:00:00,50,0,80,0,766,885,1781,16655
2022-08-13 05:00:00,2022-08-13 06:00:00,49,0,86,0,1454,598,2187,18049
2022-08-13 06:00:00,2022-08-13 07:00:00,50,33,90,0,2330,702,3205,19099
2022-08-13 07:00:00,2022-08-13 08:00:00,50,29,93,0,2861,1089,4122,19303
2022-08-13 08:00:00,2022-08-13 09:00:00,50,0,98,0,3370,1052,4570,19262
2022-08-13 09:00:00,2022-08-13 10:00:00,50,0,94,0,3600,927,4671,19236
2022-08-13 10:00:00,2022-08-13 11:00:00,50,0,89,0,3568,874,4581,19017
2022-08-13 11:00:00,2022-08-13 12:00:00,50,0,85,0,3454,1050,4639,18573
2022-08-13 12:00:00,2022-08-13 13:00:00,50,0,86,0,2947,1315,4398,18315
2022-08-13 13:00:00,2022-08-13 14:00:00,50,0,86,0,2343,1591,4070,18242
2022-08-13 14:00:00,2022-08-13 15:00:00,50,34,86,0,1656,1720,3546,18476
2022-08-13 15:00:00,2022-08-13 16:00:00,50,371,86,0,710,1632,2849,18378
2022-08-13 16:00:00,2022-08-13 17:00:00,50,630,101,46,242,1541,2610,18333
2022-08-13 17:00:00,2022-08-13 18:00:00,50,741,105,52,49,1842,2839,18623
2022-08-13 18:00:00,2022-08-13 19:00:00,50,545,99,6,0,2073,2773,18274
2022-08-13 19:00:00,2022-08-13 20:00:00,50,184,87,0,0,1756,2077,17036
2022-08-13 20:00:00,2022-08-13 21:00:00,38,22,85,0,0,1670,1815,15839
2022-08-13 21:00:00,2022-08-13 22:00:00,30,0,85,0,0,1686,1801,14732
2022-08-13 22:00:00,2022-08-13 23:00:00,30,0,85,0,0,1700,1815,14113
2022-08-13 23:00:00,2022-08-14 00:00:00,30,0,85,0,0,1670,1785,13726
2022-08-14 00:00:00,2022-08-14 01:00:00,30,0,85,0,0,1501,1616,13486
2022-08-14 01:00:00,2022-08-14 02:00:00,30,0,85,0,0,1339,1454,13324
2022-08-14 02:00:00,2022-08-14 03:00:00,30,0,85,0,45,1300,1460,12977
2022-08-14 03:00:00,2022-08-14 04:00:00,30,0,85,0,291,1193,1599,13163
2022-08-14 04:00:00,2022-08-14 05:00:00,30,0,85,0,957,818,1890,14079
2022-08-14 05:00:00,2022-08-14 06:00:00,30,0,90,0,1810,388,2318,15154
2022-08-14 06:00:00,2022-08-14 07:00:00,30,0,94,0,2817,372,3313,16028
2022-08-14 07:00:00,2022-08-14 08:00:00,30,0,94,0,3770,833,4727,16624
2022-08-14 08:00:00,2022-08-14 09:00:00,30,0,94,0,4400,1200,5724,16791
2022-08-14 09:00:00,2022-08-14 10:00:00,30,0,94,0,4571,1277,5972,16526
2022-08-14 10:00:00,2022-08-14 11:00:00,30,0,94,0,4763,1292,6179,16537
2022-08-14 11:00:00,2022-08-14 12:00:00,30,0,93,0,4373,1283,5779,15954
2022-08-14 12:00:00,2022-08-14 13:00:00,30,0,85,0,3932,1366,5413,15924
2022-08-14 13:00:00,2022-08-14 14:00:00,30,0,85,0,3038,1539,4692,15989
2022-08-14 14:00:00,2022-08-14 15:00:00,38,0,85,0,1927,1711,3761,16163
2022-08-14 15:00:00,2022-08-14 16:00:00,49,75,85,0,946,1489,2644,16359
2022-08-14 16:00:00,2022-08-14 17:00:00,49,345,104,31,276,1426,2231,16496
2022-08-14 17:00:00,2022-08-14 18:00:00,49,496,136,40,63,1642,2426,17070
2022-08-14 18:00:00,2022-08-14 19:00:00,49,453,110,40,0,1379,2031,16965
2022-08-14 19:00:00,2022-08-14 20:00:00,49,121,90,5,0,1417,1682,16194
2022-08-14 20:00:00,2022-08-14 21:00:00,49,10,89,0,0,1632,1780,15162
2022-08-14 21:00:00,2022-08-14 22:00:00,49,288,86,0,0,1667,2090,14180
2022-08-14 22:00:00,2022-08-14 23:00:00,49,256,85,0,0,1754,2144,13549
2022-08-14 23:00:00,2022-08-15 00:00:00,49,300,85,0,0,1801,2235,13325
2022-08-15 00:00:00,2022-08-15 01:00:00,49,249,84,0,0,1855,2237,13141
2022-08-15 01:00:00,2022-08-15 02:00:00,49,334,84,0,0,1679,2146,13130
2022-08-15 02:00:00,2022-08-15 03:00:00,49,315,84,0,35,1513,1996,12749
2022-08-15 03:00:00,2022-08-15 04:00:00,49,0,85,0,345,1452,1931,13105
2022-08-15 04:00:00,2022-08-15 05:00:00,43,0,84,0,1299,1020,2446,13956
2022-08-15 05:00:00,2022-08-15 06:00:00,30,0,89,0,2691,476,3286,15158
2022-08-15 06:00:00,2022-08-15 07:00:00,30,0,91,0,3948,350,4419,15991
2022-08-15 07:00:00,2022-08-15 08:00:00,30,0,91,0,4858,629,5608,16180
2022-08-15 08:00:00,2022-08-15 09:00:00,30,0,92,0,5249,1272,6643,16128
2022-08-15 09:00:00,2022-08-15 10:00:00,30,0,87,0,5170,1722,7009,16013
2022-08-15 10:00:00,2022-08-15 11:00:00,30,0,88,0,4902,1848,6868,16036
2022-08-15 11:00:00,2022-08-15 12:00:00,30,0,87,0,4664,1948,6729,16040
2022-08-15 12:00:00,2022-08-15 13:00:00,30,0,87,0,3864,2177,6158,16004
2022-08-15 13:00:00,2022-08-15 14:00:00,30,0,87,0,3040,2453,5610,16320
2022-08-15 14:00:00,2022-08-15 15:00:00,37,0,87,0,2179,2136,4439,16781
2022-08-15 15:00:00,2022-08-15 16:00:00,49,56,91,0,1073,1789,3058,16935
2022-08-15 16:00:00,2022-08-15 17:00:00,49,352,104,35,292,1933,2765,17046
2022-08-15 17:00:00,2022-08-15 18:00:00,49,419,106,40,39,2359,3012,17704
2022-08-15 18:00:00,2022-08-15 19:00:00,49,258,97,40,0,2496,2940,17475
2022-08-15 19:00:00,2022-08-15 20:00:00,49,0,90,5,0,2445,2589,16524
2022-08-15 20:00:00,2022-08-15 21:00:00,49,0,89,0,0,2299,2437,15361
2022-08-15 21:00:00,2022-08-15 22:00:00,49,0,82,0,0,2071,2202,14498
2022-08-15 22:00:00,2022-08-15 23:00:00,49,0,81,0,0,1967,2097,14154
2022-08-15 23:00:00,2022-08-16 00:00:00,49,0,81,0,0,1661,1791,13953
2022-08-16 00:00:00,2022-08-16 01:00:00,49,0,81,0,0,1581,1711,13892
2022-08-16 01:00:00,2022-08-16 02:00:00,49,0,81,0,0,1492,1622,14228
2022-08-16 02:00:00,2022-08-16 03:00:00,49,0,81,0,27,1312,1469,14655
2022-08-16 03:00:00,2022-08-16 04:00:00,49,0,81,0,304,1057,1491,17158
2022-08-16 04:00:00,2022-08-16 05:00:00,49,24,82,0,1176,668,1999,19598
2022-08-16 05:00:00,2022-08-16 06:00:00,49,129,89,0,2492,257,3016,21300
2022-08-16 06:00:00,2022-08-16 07:00:00,49,129,89,0,3764,153,4184,22079
2022-08-16 07:00:00,2022-08-16 08:00:00,49,17,90,0,4685,118,4959,22233
2022-08-16 08:00:00,2022-08-16 09:00:00,49,0,88,0,5239,185,5561,22633
2022-08-16 09:00:00,2022-08-16 10:00:00,49,0,83,0,5159,297,5588,22711
2022-08-16 10:00:00,2022-08-16 11:00:00,49,0,82,0,4835,370,5336,22711
2022-08-16 11:00:00,2022-08-16 12:00:00,49,0,82,0,4482,332,4945,22305
2022-08-16 12:00:00,2022-08-16 13:00:00,49,0,82,0,3963,431,4525,22359
2022-08-16 13:00:00,2022-08-16 14:00:00,49,0,82,0,2756,463,3350,21879
2022-08-16 14:00:00,2022-08-16 15:00:00,49,25,84,0,1874,675,2707,22066
2022-08-16 15:00:00,2022-08-16 16:00:00,49,559,90,0,930,529,2157,21967
2022-08-16 16:00:00,2022-08-16 17:00:00,49,1104,131,35,270,406,1995,21932
2022-08-16 17:00:00,2022-08-16 18:00:00,49,1334,134,40,46,371,1974,22442
2022-08-16 18:00:00,2022-08-16 19:00:00,49,1201,105,40,0,423,1818,21622
2022-08-16 19:00:00,2022-08-16 20:00:00,49,428,88,5,0,360,930,19868
2022-08-16 20:00:00,2022-08-16 21:00:00,49,50,87,0,0,299,485,18425
2022-08-16 21:00:00,2022-08-16 22:00:00,49,25,86,0,0,300,460,17255
2022-08-16 22:00:00,2022-08-16 23:00:00,49,19,84,0,0,240,392,16716
2022-08-16 23:00:00,2022-08-17 00:00:00,49,0,84,0,0,177,310,16313
2022-08-17 00:00:00,2022-08-17 01:00:00,49,0,84,0,0,153,286,16320
2022-08-17 01:00:00,2022-08-17 02:00:00,49,0,84,0,0,123,256,16471
2022-08-17 02:00:00,2022-08-17 03:00:00,49,11,82,0,27,100,269,16727
2022-08-17 03:00:00,2022-08-17 04:00:00,49,24,79,0,310,116,578,18732
2022-08-17 04:00:00,2022-08-17 05:00:00,50,43,79,0,1318,76,1566,20818
2022-08-17 05:00:00,2022-08-17 06:00:00,49,5,80,0,2835,21,2990,22123
2022-08-17 06:00:00,2022-08-17 07:00:00,50,0,87,0,4252,21,4410,22679
2022-08-17 07:00:00,2022-08-17 08:00:00,50,0,87,0,5153,44,5334,22678
2022-08-17 08:00:00,2022-08-17 09:00:00,50,0,83,0,5617,81,5831,23141
2022-08-17 09:00:00,2022-08-17 10:00:00,50,0,81,0,5626,118,5875,23375
2022-08-17 10:00:00,2022-08-17 11:00:00,48,0,81,0,5372,163,5664,23255
2022-08-17 11:00:00,2022-08-17 12:00:00,50,0,81,0,4919,255,5305,22889
2022-08-17 12:00:00,2022-08-17 13:00:00,50,0,82,0,4211,342,4685,22839
2022-08-17 13:00:00,2022-08-17 14:00:00,50,0,85,0,3469,398,4002,22806
2022-08-17 14:00:00,2022-08-17 15:00:00,50,187,83,0,2252,432,3004,22793
2022-08-17 15:00:00,2022-08-17 16:00:00,50,798,87,0,959,380,2274,22395
2022-08-17 16:00:00,2022-08-17 17:00:00,50,966,101,35,276,418,1846,22424
2022-08-17 17:00:00,2022-08-17 18:00:00,50,915,103,40,36,676,1820,22837
2022-08-17 18:00:00,2022-08-17 19:00:00,50,768,94,40,0,989,1941,21992
2022-08-17 19:00:00,2022-08-17 20:00:00,50,209,88,5,0,1175,1527,20240
2022-08-17 20:00:00,2022-08-17 21:00:00,50,0,87,0,0,1289,1426,18790
2022-08-17 21:00:00,2022-08-17 22:00:00,49,9,86,0,0,1160,1304,17488
2022-08-17 22:00:00,2022-08-17 23:00:00,49,1,86,0,0,938,1074,16830
2022-08-17 23:00:00,2022-08-18 00:00:00,49,0,86,0,0,906,1041,16414
2022-08-18 00:00:00,2022-08-18 01:00:00,49,0,86,0,0,790,925,16376
2022-08-18 01:00:00,2022-08-18 02:00:00,49,0,86,0,0,721,856,16512
2022-08-18 02:00:00,2022-08-18 03:00:00,49,2,86,0,31,693,861,16608
2022-08-18 03:00:00,2022-08-18 04:00:00,49,83,90,0,369,704,1295,18670
2022-08-18 04:00:00,2022-08-18 05:00:00,50,18,92,0,1383,539,2082,20798
2022-08-18 05:00:00,2022-08-18 06:00:00,50,84,95,0,2814,274,3317,22121
2022-08-18 06:00:00,2022-08-18 07:00:00,50,5,100,0,4178,146,4479,22664
2022-08-18 07:00:00,2022-08-18 08:00:00,50,0,94,0,5190,209,5543,22650
2022-08-18 08:00:00,2022-08-18 09:00:00,50,0,93,0,5790,263,6196,23083
2022-08-18 09:00:00,2022-08-18 10:00:00,50,0,90,0,5908,281,6329,23132
2022-08-18 10:00:00,2022-08-18 11:00:00,50,0,89,0,5798,299,6236,23186
2022-08-18 11:00:00,2022-08-18 12:00:00,50,0,89,0,5236,358,5733,22929
2022-08-18 12:00:00,2022-08-18 13:00:00,50,0,89,0,4457,408,5004,23048
2022-08-18 13:00:00,2022-08-18 14:00:00,50,44,89,0,3453,587,4223,22912
2022-08-18 14:00:00,2022-08-18 15:00:00,50,544,89,0,2204,852,3739,22800
2022-08-18 15:00:00,2022-08-18 16:00:00,50,728,98,35,919,1124,2954,22540
2022-08-18 16:00:00,2022-08-18 17:00:00,50,805,138,40,238,1344,2615,22581
2022-08-18 17:00:00,2022-08-18 18:00:00,50,971,142,40,45,1667,2915,22899
2022-08-18 18:00:00,2022-08-18 19:00:00,50,645,121,5,0,2166,2987,21948
2022-08-18 19:00:00,2022-08-18 20:00:00,50,65,98,0,0,2548,2761,20295
2022-08-18 20:00:00,2022-08-18 21:00:00,50,0,94,0,0,2486,2630,18732
2022-08-18 21:00:00,2022-08-18 22:00:00,49,0,94,0,0,2318,2461,17479
2022-08-18 22:00:00,2022-08-18 23:00:00,49,0,94,0,0,2075,2218,16843
2022-08-18 23:00:00,2022-08-19 00:00:00,49,0,94,0,0,2117,2260,16468
2022-08-19 00:00:00,2022-08-19 01:00:00,49,0,94,0,0,1939,2082,16406
2022-08-19 01:00:00,2022-08-19 02:00:00,50,0,94,0,0,2077,2221,16436
2022-08-19 02:00:00,2022-08-19 03:00:00,50,0,84,0,29,2253,2416,16672
2022-08-19 03:00:00,2022-08-19 04:00:00,50,0,77,0,355,2338,2820,18689
2022-08-19 04:00:00,2022-08-19 05:00:00,50,43,78,0,1294,1914,3379,20788
2022-08-19 05:00:00,2022-08-19 06:00:00,50,97,90,0,2737,1379,4353,22268
2022-08-19 06:00:00,2022-08-19 07:00:00,50,13,94,0,3878,1347,5382,22938
2022-08-19 07:00:00,2022-08-19 08:00:00,50,0,97,0,4499,1635,6281,22867
2022-08-19 08:00:00,2022-08-19 09:00:00,50,0,93,0,4844,1916,6903,22964
2022-08-19 09:00:00,2022-08-19 10:00:00,50,0,92,0,5202,2035,7379,23113
2022-08-19 10:00:00,2022-08-19 11:00:00,50,0,92,0,5244,2150,7536,23116
2022-08-19 11:00:00,2022-08-19 12:00:00,50,0,92,0,4775,2156,7073,22838
2022-08-19 12:00:00,2022-08-19 13:00:00,50,0,92,0,3959,2174,6275,22968
2022-08-19 13:00:00,2022-08-19 14:00:00,50,13,88,0,3134,2244,5529,23086
2022-08-19 14:00:00,2022-08-19 15:00:00,50,382,87,0,1806,2221,4546,22835
2022-08-19 15:00:00,2022-08-19 16:00:00,50,545,102,35,701,2106,3539,22351
2022-08-19 16:00:00,2022-08-19 17:00:00,50,684,133,40,235,1885,3027,22344
2022-08-19 17:00:00,2022-08-19 18:00:00,50,663,136,40,31,2216,3136,22646
2022-08-19 18:00:00,2022-08-19 19:00:00,50,472,110,5,0,2246,2883,21611
2022-08-19 19:00:00,2022-08-19 20:00:00,50,24,100,0,0,2271,2445,19995
2022-08-19 20:00:00,2022-08-19 21:00:00,50,0,100,0,0,2221,2371,18648
2022-08-19 21:00:00,2022-08-19 22:00:00,50,0,86,0,0,1999,2135,17468
2022-08-19 22:00:00,2022-08-19 23:00:00,50,193,84,0,0,1825,2152,16783
2022-08-19 23:00:00,2022-08-20 00:00:00,50,93,84,0,0,1251,1478,16434
2022-08-20 00:00:00,2022-08-20 01:00:00,50,7,84,0,0,967,1108,16313
2022-08-20 01:00:00,2022-08-20 02:00:00,50,15,84,0,0,768,917,16176
2022-08-20 02:00:00,2022-08-20 03:00:00,50,5,84,0,38,797,974,15806
2022-08-20 03:00:00,2022-08-20 04:00:00,50,0,84,0,252,771,1157,16535
2022-08-20 04:00:00,2022-08-20 05:00:00,50,0,84,0,836,592,1562,17747
2022-08-20 05:00:00,2022-08-20 06:00:00,50,20,90,0,1686,433,2279,18977
2022-08-20 06:00:00,2022-08-20 07:00:00,50,189,92,0,2479,412,3222,19702
2022-08-20 07:00:00,2022-08-20 08:00:00,50,18,89,0,3209,410,3776,20106
2022-08-20 08:00:00,2022-08-20 09:00:00,50,0,84,0,3521,401,4056,20220
2022-08-20 09:00:00,2022-08-20 10:00:00,50,94,85,0,3574,393,4196,20178
2022-08-20 10:00:00,2022-08-20 11:00:00,50,46,82,0,3566,429,4173,20004
2022-08-20 11:00:00,2022-08-20 12:00:00,50,16,83,0,3381,399,3929,19724
2022-08-20 12:00:00,2022-08-20 13:00:00,50,41,83,0,3082,517,3773,19830
2022-08-20 13:00:00,2022-08-20 14:00:00,50,343,82,0,2104,703,3282,19549
2022-08-20 14:00:00,2022-08-20 15:00:00,50,569,83,0,1114,796,2612,19210
2022-08-20 15:00:00,2022-08-20 16:00:00,50,666,87,0,512,882,2197,19088
2022-08-20 16:00:00,2022-08-20 17:00:00,50,616,114,35,167,1113,2095,19116
2022-08-20 17:00:00,2022-08-20 18:00:00,50,601,127,40,36,1155,2009,19484
2022-08-20 18:00:00,2022-08-20 19:00:00,50,475,123,40,0,1322,2010,18721
2022-08-20 19:00:00,2022-08-20 20:00:00,50,60,119,5,0,1461,1695,17532
2022-08-20 20:00:00,2022-08-20 21:00:00,50,0,120,0,0,1351,1521,16246
2022-08-20 21:00:00,2022-08-20 22:00:00,50,11,116,0,0,1309,1486,15202
2022-08-20 22:00:00,2022-08-20 23:00:00,50,115,103,0,0,1246,1514,14671
2022-08-20 23:00:00,2022-08-21 00:00:00,50,35,111,0,0,1083,1279,14203
2022-08-21 00:00:00,2022-08-21 01:00:00,50,0,108,0,0,1070,1228,14016
2022-08-21 01:00:00,2022-08-21 02:00:00,50,0,98,0,0,1146,1294,13982
2022-08-21 02:00:00,2022-08-21 03:00:00,50,0,92,0,41,1253,1436,13665
2022-08-21 03:00:00,2022-08-21 04:00:00,50,0,88,0,245,1381,1764,13883
2022-08-21 04:00:00,2022-08-21 05:00:00,49,0,88,0,723,1179,2039,14553
2022-08-21 05:00:00,2022-08-21 06:00:00,49,0,85,0,1292,985,2411,15322
2022-08-21 06:00:00,2022-08-21 07:00:00,49,0,91,0,1909,937,2986,16254
2022-08-21 07:00:00,2022-08-21 08:00:00,49,0,92,0,2312,863,3316,16811
2022-08-21 08:00:00,2022-08-21 09:00:00,49,0,92,0,2553,836,3530,17155
2022-08-21 09:00:00,2022-08-21 10:00:00,49,0,99,0,2635,979,3762,17352
2022-08-21 10:00:00,2022-08-21 11:00:00,49,0,100,0,2428,946,3523,17107
2022-08-21 11:00:00,2022-08-21 12:00:00,49,0,96,0,2203,1184,3532,16946
2022-08-21 12:00:00,2022-08-21 13:00:00,49,0,94,0,1844,1263,3250,16702
2022-08-21 13:00:00,2022-08-21 14:00:00,49,0,94,0,1336,1419,2898,16618
2022-08-21 14:00:00,2022-08-21 15:00:00,49,25,96,0,775,1457,2402,16586
2022-08-21 15:00:00,2022-08-21 16:00:00,50,398,103,0,368,1551,2470,16931
2022-08-21 16:00:00,2022-08-21 17:00:00,50,504,129,35,165,1440,2323,17295
2022-08-21 17:00:00,2022-08-21 18:00:00,50,584,140,40,26,1468,2308,17806
2022-08-21 18:00:00,2022-08-21 19:00:00,50,514,138,40,0,1493,2235,17426
2022-08-21 19:00:00,2022-08-21 20:00:00,50,536,112,5,0,1391,2094,16634
2022-08-21 20:00:00,2022-08-21 21:00:00,50,96,103,0,0,1275,1524,15649
2022-08-21 21:00:00,2022-08-21 22:00:00,50,0,96,0,0,1217,1363,14812
2022-08-21 22:00:00,2022-08-21 23:00:00,50,0,97,0,0,1142,1289,14392
2022-08-21 23:00:00,2022-08-22 00:00:00,50,0,97,0,0,1082,1229,14129
2022-08-22 00:00:00,2022-08-22 01:00:00,50,0,96,0,0,1176,1322,14318
2022-08-22 01:00:00,2022-08-22 02:00:00,50,21,96,0,0,1230,1397,14530
2022-08-22 02:00:00,2022-08-22 03:00:00,50,17,96,0,14,1161,1338,15056
2022-08-22 03:00:00,2022-08-22 04:00:00,50,0,96,0,184,1135,1465,17619
2022-08-22 04:00:00,2022-08-22 05:00:00,50,34,109,0,611,1045,1849,19801
2022-08-22 05:00:00,2022-08-22 06:00:00,50,305,141,0,1204,949,2649,21183
2022-08-22 06:00:00,2022-08-22 07:00:00,50,78,146,0,1742,858,2874,21827
2022-08-22 07:00:00,2022-08-22 08:00:00,50,0,145,0,2117,747,3059,21920
2022-08-22 08:00:00,2022-08-22 09:00:00,50,0,135,0,2430,695,3310,22347
2022-08-22 09:00:00,2022-08-22 10:00:00,50,0,123,0,2742,755,3670,22707
2022-08-22 10:00:00,2022-08-22 11:00:00,50,0,119,0,2669,858,3696,22588
2022-08-22 11:00:00,2022-08-22 12:00:00,50,0,119,0,2421,993,3583,22021
2022-08-22 12:00:00,2022-08-22 13:00:00,50,0,118,0,2092,1108,3368,21881
2022-08-22 13:00:00,2022-08-22 14:00:00,50,31,125,0,1668,1258,3132,21559
2022-08-22 14:00:00,2022-08-22 15:00:00,50,279,130,0,1007,1391,2857,21360
2022-08-22 15:00:00,2022-08-22 16:00:00,50,499,140,0,380,1440,2509,21238
2022-08-22 16:00:00,2022-08-22 17:00:00,50,574,163,35,133,1442,2397,21539
2022-08-22 17:00:00,2022-08-22 18:00:00,50,622,166,40,9,1661,2548,22050
2022-08-22 18:00:00,2022-08-22 19:00:00,50,504,147,40,0,1811,2552,20840
2022-08-22 19:00:00,2022-08-22 20:00:00,50,321,128,5,0,1699,2203,19107
2022-08-22 20:00:00,2022-08-22 21:00:00,50,2,125,0,0,1684,1861,17847
2022-08-22 21:00:00,2022-08-22 22:00:00,50,0,103,0,0,1734,1887,16880
2022-08-22 22:00:00,2022-08-22 23:00:00,50,0,99,0,0,1633,1782,16347
2022-08-22 23:00:00,2022-08-23 00:00:00,50,0,99,0,0,1581,1730,16085
2022-08-23 00:00:00,2022-08-23 01:00:00,50,0,96,0,0,1435,1581,16002
2022-08-23 01:00:00,2022-08-23 02:00:00,50,0,96,0,0,1318,1464,16267
2022-08-23 02:00:00,2022-08-23 03:00:00,50,0,95,0,19,1356,1520,16622
2022-08-23 03:00:00,2022-08-23 04:00:00,50,0,104,0,237,1347,1738,18713
2022-08-23 04:00:00,2022-08-23 05:00:00,50,0,112,0,809,1109,2080,20689
2022-08-23 05:00:00,2022-08-23 06:00:00,50,0,119,0,1545,878,2592,21849
2022-08-23 06:00:00,2022-08-23 07:00:00,50,0,124,35,2214,831,3254,22356
2022-08-23 07:00:00,2022-08-23 08:00:00,50,0,125,40,2787,862,3864,22489
2022-08-23 08:00:00,2022-08-23 09:00:00,50,0,122,5,3211,799,4187,22820
2022-08-23 09:00:00,2022-08-23 10:00:00,50,0,123,0,3529,717,4419,23070
2022-08-23 10:00:00,2022-08-23 11:00:00,50,0,125,0,3444,651,4270,22864
2022-08-23 11:00:00,2022-08-23 12:00:00,50,0,124,0,3399,676,4249,22648
2022-08-23 12:00:00,2022-08-23 13:00:00,50,17,123,0,2903,820,3913,22587
2022-08-23 13:00:00,2022-08-23 14:00:00,50,238,122,0,2189,1123,3722,22469
2022-08-23 14:00:00,2022-08-23 15:00:00,50,369,127,0,1176,1061,2783,22114
2022-08-23 15:00:00,2022-08-23 16:00:00,50,521,138,0,590,975,2274,21883
2022-08-23 16:00:00,2022-08-23 17:00:00,50,870,140,35,173,1077,2345,22088
2022-08-23 17:00:00,2022-08-23 18:00:00,50,922,159,40,9,1219,2399,22591
2022-08-23 18:00:00,2022-08-23 19:00:00,50,587,157,40,0,1113,1947,21311
2022-08-23 19:00:00,2022-08-23 20:00:00,49,380,125,5,0,901,1460,19641
2022-08-23 20:00:00,2022-08-23 21:00:00,48,44,124,0,0,772,988,18324
2022-08-23 21:00:00,2022-08-23 22:00:00,48,0,94,0,0,694,836,17350
2022-08-23 22:00:00,2022-08-23 23:00:00,48,0,94,0,0,599,741,16813
2022-08-23 23:00:00,2022-08-24 00:00:00,50,0,94,0,0,586,730,16379
2022-08-24 00:00:00,2022-08-24 01:00:00,50,0,94,0,0,503,647,16419
2022-08-24 01:00:00,2022-08-24 02:00:00,50,0,93,0,0,476,619,16640
2022-08-24 02:00:00,2022-08-24 03:00:00,50,0,93,0,16,509,668,16913
2022-08-24 03:00:00,2022-08-24 04:00:00,49,39,93,0,219,437,837,18927
2022-08-24 04:00:00,2022-08-24 05:00:00,49,310,108,0,737,247,1451,20999
2022-08-24 05:00:00,2022-08-24 06:00:00,49,465,118,35,1577,175,2419,22202
2022-08-24 06:00:00,2022-08-24 07:00:00,49,89,132,40,2514,175,2999,22752
2022-08-24 07:00:00,2022-08-24 08:00:00,50,0,136,5,3283,212,3686,22634
2022-08-24 08:00:00,2022-08-24 09:00:00,50,0,134,0,3825,217,4226,22778
2022-08-24 09:00:00,2022-08-24 10:00:00,50,0,134,0,4362,222,4768,23134
2022-08-24 10:00:00,2022-08-24 11:00:00,50,0,134,0,4223,249,4656,22958
2022-08-24 11:00:00,2022-08-24 12:00:00,50,0,119,0,3938,316,4423,22669
2022-08-24 12:00:00,2022-08-24 13:00:00,50,0,119,0,3544,417,4130,22962
2022-08-24 13:00:00,2022-08-24 14:00:00,50,11,123,0,2776,565,3525,22763
2022-08-24 14:00:00,2022-08-24 15:00:00,50,89,124,0,1673,684,2620,22386
2022-08-24 15:00:00,2022-08-24 16:00:00,50,577,141,35,706,718,2227,22019
2022-08-24 16:00:00,2022-08-24 17:00:00,50,915,170,40,184,763,2122,22275
2022-08-24 17:00:00,2022-08-24 18:00:00,50,1045,174,40,7,1134,2450,22874
2022-08-24 18:00:00,2022-08-24 19:00:00,49,574,154,40,0,1223,2040,21560
2022-08-24 19:00:00,2022-08-24 20:00:00,47,86,125,40,0,1372,1670,19800
2022-08-24 20:00:00,2022-08-24 21:00:00,47,0,124,5,0,1182,1358,18391
2022-08-24 21:00:00,2022-08-24 22:00:00,47,0,100,0,0,1116,1263,17441
2022-08-24 22:00:00,2022-08-24 23:00:00,50,0,94,0,0,967,1111,16795
2022-08-24 23:00:00,2022-08-25 00:00:00,50,0,94,0,0,934,1078,16485
2022-08-25 00:00:00,2022-08-25 01:00:00,50,0,94,0,0,920,1064,16375
2022-08-25 01:00:00,2022-08-25 02:00:00,61,0,94,0,0,910,1065,16588
2022-08-25 02:00:00,2022-08-25 03:00:00,78,0,94,0,15,820,1007,16903
2022-08-25 03:00:00,2022-08-25 04:00:00,78,0,94,0,217,790,1179,18955
2022-08-25 04:00:00,2022-08-25 05:00:00,81,89,96,0,891,728,1885,20817
2022-08-25 05:00:00,2022-08-25 06:00:00,83,598,115,0,1846,521,3163,21945
2022-08-25 06:00:00,2022-08-25 07:00:00,84,60,129,0,2771,442,3486,22264
2022-08-25 07:00:00,2022-08-25 08:00:00,94,3,129,0,3751,482,4459,22252
2022-08-25 08:00:00,2022-08-25 09:00:00,52,0,127,0,4599,430,5208,22583
2022-08-25 09:00:00,2022-08-25 10:00:00,46,0,100,0,5390,453,5989,22919
2022-08-25 10:00:00,2022-08-25 11:00:00,46,0,99,0,5609,479,6233,22964
2022-08-25 11:00:00,2022-08-25 12:00:00,46,0,100,0,5368,573,6087,22689
2022-08-25 12:00:00,2022-08-25 13:00:00,46,0,115,0,4695,611,5467,22907
2022-08-25 13:00:00,2022-08-25 14:00:00,46,0,125,0,3625,677,4473,22890
2022-08-25 14:00:00,2022-08-25 15:00:00,46,80,133,0,2194,710,3163,22654
2022-08-25 15:00:00,2022-08-25 16:00:00,46,679,135,35,822,775,2492,22222
2022-08-25 16:00:00,2022-08-25 17:00:00,46,900,135,40,191,1060,2372,22467
2022-08-25 17:00:00,2022-08-25 18:00:00,46,941,160,40,10,1431,2628,23058
2022-08-25 18:00:00,2022-08-25 19:00:00,46,352,155,40,0,1491,2084,21799
2022-08-25 19:00:00,2022-08-25 20:00:00,46,8,127,40,0,1484,1705,20037
2022-08-25 20:00:00,2022-08-25 21:00:00,46,0,106,5,0,1267,1424,18534
2022-08-25 21:00:00,2022-08-25 22:00:00,46,0,99,0,0,1125,1270,17424
2022-08-25 22:00:00,2022-08-25 23:00:00,46,0,99,0,0,977,1122,16788
2022-08-25 23:00:00,2022-08-26 00:00:00,45,0,99,0,0,781,925,16416
2022-08-26 00:00:00,2022-08-26 01:00:00,46,0,99,0,0,653,798,16416
2022-08-26 01:00:00,2022-08-26 02:00:00,46,0,99,0,0,650,795,16544
2022-08-26 02:00:00,2022-08-26 03:00:00,46,0,99,0,14,626,785,16864
2022-08-26 03:00:00,2022-08-26 04:00:00,46,109,100,0,238,578,1071,18688
2022-08-26 04:00:00,2022-08-26 05:00:00,46,272,103,0,1133,596,2150,20648
2022-08-26 05:00:00,2022-08-26 06:00:00,46,329,107,0,2599,430,3511,21871
2022-08-26 06:00:00,2022-08-26 07:00:00,46,34,118,0,4115,219,4532,22537
2022-08-26 07:00:00,2022-08-26 08:00:00,46,0,107,0,5289,186,5628,22481
2022-08-26 08:00:00,2022-08-26 09:00:00,46,0,107,0,6031,300,6484,22872
2022-08-26 09:00:00,2022-08-26 10:00:00,35,0,107,0,6260,468,6870,23082
2022-08-26 10:00:00,2022-08-26 11:00:00,31,0,107,0,6175,647,6960,22923
2022-08-26 11:00:00,2022-08-26 12:00:00,31,0,108,0,5812,759,6710,22606
2022-08-26 12:00:00,2022-08-26 13:00:00,35,0,107,0,4997,858,5997,22608
2022-08-26 13:00:00,2022-08-26 14:00:00,46,0,117,0,3860,887,4910,22612
2022-08-26 14:00:00,2022-08-26 15:00:00,46,134,126,0,2277,801,3384,22366
2022-08-26 15:00:00,2022-08-26 16:00:00,46,762,136,35,822,745,2546,21965
2022-08-26 16:00:00,2022-08-26 17:00:00,46,903,156,40,183,999,2327,22142
2022-08-26 17:00:00,2022-08-26 18:00:00,46,903,167,40,13,1510,2679,22501
2022-08-26 18:00:00,2022-08-26 19:00:00,46,523,152,40,0,2074,2835,20960
2022-08-26 19:00:00,2022-08-26 20:00:00,46,40,132,5,0,2617,2840,19219
2022-08-26 20:00:00,2022-08-26 21:00:00,46,393,111,0,0,2785,3335,17865
2022-08-26 21:00:00,2022-08-26 22:00:00,46,214,96,0,0,2773,3129,16841
2022-08-26 22:00:00,2022-08-26 23:00:00,46,64,95,0,0,2567,2772,16156
2022-08-26 23:00:00,2022-08-27 00:00:00,46,0,95,0,0,2332,2473,15759
2022-08-27 00:00:00,2022-08-27 01:00:00,46,0,96,0,0,2051,2193,15523
2022-08-27 01:00:00,2022-08-27 02:00:00,46,0,96,0,0,1613,1755,15501
2022-08-27 02:00:00,2022-08-27 03:00:00,46,0,96,0,19,1420,1581,15361
2022-08-27 03:00:00,2022-08-27 04:00:00,46,0,96,0,274,1292,1708,15860
2022-08-27 04:00:00,2022-08-27 05:00:00,35,0,95,0,1289,1019,2438,17177
2022-08-27 05:00:00,2022-08-27 06:00:00,31,0,100,0,2868,443,3442,18496
2022-08-27 06:00:00,2022-08-27 07:00:00,31,0,99,0,4177,134,4441,19313
2022-08-27 07:00:00,2022-08-27 08:00:00,31,0,100,0,5078,116,5325,19443
2022-08-27 08:00:00,2022-08-27 09:00:00,31,0,101,0,5664,258,6054,19629
2022-08-27 09:00:00,2022-08-27 10:00:00,31,0,101,0,5764,443,6339,19403
2022-08-27 10:00:00,2022-08-27 11:00:00,31,0,100,0,5532,458,6121,19039
2022-08-27 11:00:00,2022-08-27 12:00:00,31,0,96,0,5202,369,5698,18885
2022-08-27 12:00:00,2022-08-27 13:00:00,35,0,95,0,4484,346,4960,18905
2022-08-27 13:00:00,2022-08-27 14:00:00,46,138,96,0,3247,307,3834,18853
2022-08-27 14:00:00,2022-08-27 15:00:00,46,520,106,0,1993,330,2995,18972
2022-08-27 15:00:00,2022-08-27 16:00:00,46,664,127,0,716,395,1948,18925
2022-08-27 16:00:00,2022-08-27 17:00:00,46,781,141,35,156,570,1729,18953
2022-08-27 17:00:00,2022-08-27 18:00:00,46,778,157,40,16,875,1912,19444
2022-08-27 18:00:00,2022-08-27 19:00:00,46,553,156,40,0,1061,1856,18490
2022-08-27 19:00:00,2022-08-27 20:00:00,46,721,136,5,0,1223,2131,17301
2022-08-27 20:00:00,2022-08-27 21:00:00,46,150,129,0,0,1273,1598,16140
2022-08-27 21:00:00,2022-08-27 22:00:00,46,27,99,0,0,1068,1240,15078
2022-08-27 22:00:00,2022-08-27 23:00:00,46,3,100,0,0,815,964,14542
2022-08-27 23:00:00,2022-08-28 00:00:00,46,0,100,0,0,662,808,14120
2022-08-28 00:00:00,2022-08-28 01:00:00,46,0,100,0,0,579,725,13919
2022-08-28 01:00:00,2022-08-28 02:00:00,46,21,100,0,0,530,697,13968
2022-08-28 02:00:00,2022-08-28 03:00:00,46,55,100,0,17,496,714,13717
2022-08-28 03:00:00,2022-08-28 04:00:00,46,5,100,0,245,504,900,13874
2022-08-28 04:00:00,2022-08-28 05:00:00,46,0,100,0,1083,483,1712,14741
2022-08-28 05:00:00,2022-08-28 06:00:00,35,0,102,0,2183,480,2800,15782
2022-08-28 06:00:00,2022-08-28 07:00:00,31,0,111,0,3103,500,3745,16674
2022-08-28 07:00:00,2022-08-28 08:00:00,31,0,113,0,3827,504,4475,17251
2022-08-28 08:00:00,2022-08-28 09:00:00,31,0,113,0,4347,660,5151,17674
2022-08-28 09:00:00,2022-08-28 10:00:00,31,0,112,0,4261,748,5152,17742
2022-08-28 10:00:00,2022-08-28 11:00:00,31,0,103,0,3793,797,4724,17612
2022-08-28 11:00:00,2022-08-28 12:00:00,31,0,108,0,3208,826,4173,17502
2022-08-28 12:00:00,2022-08-28 13:00:00,35,0,109,0,2590,1127,3861,17384
2022-08-28 13:00:00,2022-08-28 14:00:00,46,0,112,0,1901,1407,3466,17452
2022-08-28 14:00:00,2022-08-28 15:00:00,46,0,123,0,1199,1614,2982,17626
2022-08-28 15:00:00,2022-08-28 16:00:00,46,88,144,0,558,1970,2806,17855
2022-08-28 16:00:00,2022-08-28 17:00:00,46,576,167,35,142,1972,2938,18034
2022-08-28 17:00:00,2022-08-28 18:00:00,46,964,177,40,8,1794,3029,18362
2022-08-28 18:00:00,2022-08-28 19:00:00,46,696,160,40,0,1913,2855,17522
2022-08-28 19:00:00,2022-08-28 20:00:00,46,349,131,5,0,1775,2306,16751
2022-08-28 20:00:00,2022-08-28 21:00:00,46,72,125,0,0,1780,2023,15740
2022-08-28 21:00:00,2022-08-28 22:00:00,46,0,107,0,0,2023,2176,15048
2022-08-28 22:00:00,2022-08-28 23:00:00,46,0,104,0,0,2167,2317,14631
2022-08-28 23:00:00,2022-08-29 00:00:00,47,0,104,0,0,1841,1992,14266
2022-08-29 00:00:00,2022-08-29 01:00:00,64,0,104,0,0,1716,1884,14238
2022-08-29 01:00:00,2022-08-29 02:00:00,78,0,104,0,0,1758,1940,14581
2022-08-29 02:00:00,2022-08-29 03:00:00,78,0,101,0,13,1774,1966,15275
2022-08-29 03:00:00,2022-08-29 04:00:00,78,0,102,0,150,1646,1976,17692
2022-08-29 04:00:00,2022-08-29 05:00:00,78,337,104,0,675,1359,2553,19920
2022-08-29 05:00:00,2022-08-29 06:00:00,78,851,125,0,1655,1077,3786,21244
2022-08-29 06:00:00,2022-08-29 07:00:00,79,597,128,0,2668,1183,4655,21716
2022-08-29 07:00:00,2022-08-29 08:00:00,63,38,128,0,3260,1514,5003,21563
2022-08-29 08:00:00,2022-08-29 09:00:00,45,0,114,0,3846,1699,5704,21618
2022-08-29 09:00:00,2022-08-29 10:00:00,40,0,107,0,4434,1754,6335,21830
2022-08-29 10:00:00,2022-08-29 11:00:00,36,0,106,0,4641,1890,6673,21648
2022-08-29 11:00:00,2022-08-29 12:00:00,36,0,104,0,4583,1960,6683,21293
2022-08-29 12:00:00,2022-08-29 13:00:00,36,0,104,0,4066,2091,6297,21380
2022-08-29 13:00:00,2022-08-29 14:00:00,43,0,112,0,3251,2144,5550,21319
2022-08-29 14:00:00,2022-08-29 15:00:00,50,0,114,0,2038,2029,4231,21171
2022-08-29 15:00:00,2022-08-29 16:00:00,50,384,136,35,755,1747,3107,20989
2022-08-29 16:00:00,2022-08-29 17:00:00,50,829,153,40,135,1667,2874,21543
2022-08-29 17:00:00,2022-08-29 18:00:00,50,904,162,40,0,1659,2815,22149
2022-08-29 18:00:00,2022-08-29 19:00:00,50,579,162,5,0,1791,2587,20652
2022-08-29 19:00:00,2022-08-29 20:00:00,50,27,139,0,0,1898,2114,19091
2022-08-29 20:00:00,2022-08-29 21:00:00,50,0,118,0,0,1927,2095,17799
2022-08-29 21:00:00,2022-08-29 22:00:00,50,0,106,0,0,1722,1878,16799
2022-08-29 22:00:00,2022-08-29 23:00:00,50,0,105,0,0,1649,1804,16264
2022-08-29 23:00:00,2022-08-30 00:00:00,50,0,104,0,0,1587,1741,15915
2022-08-30 00:00:00,2022-08-30 01:00:00,50,0,104,0,0,1549,1703,16004
2022-08-30 01:00:00,2022-08-30 02:00:00,50,0,104,0,0,1409,1563,16174
2022-08-30 02:00:00,2022-08-30 03:00:00,50,0,104,0,8,1334,1496,16589
2022-08-30 03:00:00,2022-08-30 04:00:00,50,0,104,0,184,1353,1691,18396
2022-08-30 04:00:00,2022-08-30 05:00:00,50,30,107,0,905,1223,2315,20276
2022-08-30 05:00:00,2022-08-30 06:00:00,49,25,117,0,1956,1165,3312,21323
2022-08-30 06:00:00,2022-08-30 07:00:00,48,0,129,0,2901,1224,4302,21598
2022-08-30 07:00:00,2022-08-30 08:00:00,48,0,127,0,3607,1227,5009,21690
2022-08-30 08:00:00,2022-08-30 09:00:00,48,5,119,0,3786,1212,5170,22000
2022-08-30 09:00:00,2022-08-30 10:00:00,48,0,113,0,3865,1166,5192,22058
2022-08-30 10:00:00,2022-08-30 11:00:00,48,0,110,0,4105,1064,5327,22160
2022-08-30 11:00:00,2022-08-30 12:00:00,48,0,111,0,4103,1145,5407,21900
2022-08-30 12:00:00,2022-08-30 13:00:00,48,0,110,0,3568,1256,4982,21744
2022-08-30 13:00:00,2022-08-30 14:00:00,48,0,110,0,2545,1282,3985,21129
2022-08-30 14:00:00,2022-08-30 15:00:00,48,55,110,0,1670,1310,3193,21161
2022-08-30 15:00:00,2022-08-30 16:00:00,48,430,152,35,633,1207,2505,21020
2022-08-30 16:00:00,2022-08-30 17:00:00,48,777,172,40,113,1137,2287,21532
2022-08-30 17:00:00,2022-08-30 18:00:00,48,1017,177,40,0,1268,2550,22245
2022-08-30 18:00:00,2022-08-30 19:00:00,47,603,168,5,0,1306,2129,20686
2022-08-30 19:00:00,2022-08-30 20:00:00,34,260,115,0,0,1287,1696,19017
2022-08-30 20:00:00,2022-08-30 21:00:00,33,0,112,0,0,1224,1369,17713
2022-08-30 21:00:00,2022-08-30 22:00:00,33,0,106,0,0,1071,1210,16655
2022-08-30 22:00:00,2022-08-30 23:00:00,33,0,105,0,0,998,1136,16090
2022-08-30 23:00:00,2022-08-31 00:00:00,33,0,105,0,0,950,1088,15756
2022-08-31 00:00:00,2022-08-31 01:00:00,33,0,105,0,0,900,1038,15760
2022-08-31 01:00:00,2022-08-31 02:00:00,33,0,105,0,0,856,994,15949
2022-08-31 02:00:00,2022-08-31 03:00:00,35,0,105,0,9,907,1056,16321
2022-08-31 03:00:00,2022-08-31 04:00:00,48,0,105,0,205,972,1330,18191
2022-08-31 04:00:00,2022-08-31 05:00:00,48,221,105,0,1135,761,2270,20296
2022-08-31 05:00:00,2022-08-31 06:00:00,48,444,119,0,2487,430,3528,21325
2022-08-31 06:00:00,2022-08-31 07:00:00,48,56,127,0,3866,471,4568,21689
2022-08-31 07:00:00,2022-08-31 08:00:00,35,35,127,0,4588,626,5411,21617
2022-08-31 08:00:00,2022-08-31 09:00:00,32,55,118,0,4826,672,5703,21944
2022-08-31 09:00:00,2022-08-31 10:00:00,32,50,109,0,4746,984,5921,22029
2022-08-31 10:00:00,2022-08-31 11:00:00,32,6,109,0,4477,1223,5847,21704
2022-08-31 11:00:00,2022-08-31 12:00:00,37,0,109,0,4046,1378,5570,21345
2022-08-31 12:00:00,2022-08-31 13:00:00,48,0,108,0,3454,1404,5014,21455
2022-08-31 13:00:00,2022-08-31 14:00:00,48,0,107,0,2469,1437,4061,21202
2022-08-31 14:00:00,2022-08-31 15:00:00,48,41,121,0,1469,1248,2927,21142
2022-08-31 15:00:00,2022-08-31 16:00:00,48,400,129,0,571,1199,2347,20980
2022-08-31 16:00:00,2022-08-31 17:00:00,48,794,155,35,101,1193,2326,21619
2022-08-31 17:00:00,2022-08-31 18:00:00,48,1112,165,40,0,1410,2775,22211
2022-08-31 18:00:00,2022-08-31 19:00:00,48,643,158,40,0,1657,2546,20796
2022-08-31 19:00:00,2022-08-31 20:00:00,38,78,125,5,0,1673,1919,18888
2022-08-31 20:00:00,2022-08-31 21:00:00,33,0,120,0,0,1482,1635,17545
2022-08-31 21:00:00,2022-08-31 22:00:00,33,0,107,0,0,1285,1425,16484
2022-08-31 22:00:00,2022-08-31 23:00:00,33,0,105,0,0,1115,1253,15932
2022-08-31 23:00:00,2022-09-01 00:00:00,33,0,104,0,0,988,1125,15591
2022-09-01 00:00:00,2022-09-01 01:00:00,33,0,104,0,0,1019,1156,15600
2022-09-01 01:00:00,2022-09-01 02:00:00,33,0,104,0,0,1031,1168,15835
2022-09-01 02:00:00,2022-09-01 03:00:00,33,0,103,0,8,1019,1163,16272
2022-09-01 03:00:00,2022-09-01 04:00:00,39,0,106,0,188,921,1254,18243
2022-09-01 04:00:00,2022-09-01 05:00:00,45,0,104,0,1123,752,2024,20253
2022-09-01 05:00:00,2022-09-01 06:00:00,45,0,118,0,2693,435,3291,20960
2022-09-01 06:00:00,2022-09-01 07:00:00,45,0,123,0,4243,332,4743,20763
2022-09-01 07:00:00,2022-09-01 08:00:00,45,135,118,0,5071,444,5813,20524
2022-09-01 08:00:00,2022-09-01 09:00:00,45,238,111,0,5394,545,6333,20974
2022-09-01 09:00:00,2022-09-01 10:00:00,45,0,102,0,4949,636,5732,21076
2022-09-01 10:00:00,2022-09-01 11:00:00,45,0,101,0,4448,768,5362,20965
2022-09-01 11:00:00,2022-09-01 12:00:00,45,0,101,0,4226,809,5181,20825
2022-09-01 12:00:00,2022-09-01 13:00:00,45,0,101,0,3638,935,4719,20759
2022-09-01 13:00:00,2022-09-01 14:00:00,45,2,102,0,2949,954,4052,20691
2022-09-01 14:00:00,2022-09-01 15:00:00,45,0,114,0,1865,997,3021,20767
2022-09-01 15:00:00,2022-09-01 16:00:00,45,244,127,0,695,884,1995,20773
2022-09-01 16:00:00,2022-09-01 17:00:00,45,858,143,35,109,958,2148,21454
2022-09-01 17:00:00,2022-09-01 18:00:00,45,899,149,40,0,1089,2222,21967
2022-09-01 18:00:00,2022-09-01 19:00:00,45,346,142,40,0,1125,1698,20519
2022-09-01 19:00:00,2022-09-01 20:00:00,45,9,113,5,0,1094,1266,18715
2022-09-01 20:00:00,2022-09-01 21:00:00,45,0,109,0,0,1087,1241,17397
2022-09-01 21:00:00,2022-09-01 22:00:00,45,0,98,0,0,984,1127,16362
2022-09-01 22:00:00,2022-09-01 23:00:00,45,0,96,0,0,819,960,15771
2022-09-01 23:00:00,2022-09-02 00:00:00,45,0,96,0,0,667,808,15475
2022-09-02 00:00:00,2022-09-02 01:00:00,45,0,96,0,0,536,677,15498
2022-09-02 01:00:00,2022-09-02 02:00:00,45,0,97,0,0,536,678,15814
2022-09-02 02:00:00,2022-09-02 03:00:00,45,18,97,0,7,459,626,16358
2022-09-02 03:00:00,2022-09-02 04:00:00,45,249,97,0,200,419,1010,18352
2022-09-02 04:00:00,2022-09-02 05:00:00,45,596,97,0,1371,346,2455,20235
2022-09-02 05:00:00,2022-09-02 06:00:00,49,206,104,0,3231,168,3758,21100
2022-09-02 06:00:00,2022-09-02 07:00:00,46,0,112,0,4679,85,4922,21166
2022-09-02 07:00:00,2022-09-02 08:00:00,45,0,108,0,5829,176,6158,20934
2022-09-02 08:00:00,2022-09-02 09:00:00,45,0,107,0,5983,259,6394,21060
2022-09-02 09:00:00,2022-09-02 10:00:00,45,0,106,0,5624,263,6038,21154
2022-09-02 10:00:00,2022-09-02 11:00:00,45,0,109,0,5003,361,5518,21001
2022-09-02 11:00:00,2022-09-02 12:00:00,45,0,109,0,4676,456,5286,20999
2022-09-02 12:00:00,2022-09-02 13:00:00,45,0,110,0,3885,605,4645,20937
2022-09-02 13:00:00,2022-09-02 14:00:00,46,0,119,0,2892,784,3841,20838
2022-09-02 14:00:00,2022-09-02 15:00:00,50,105,119,0,1836,907,3017,20837
2022-09-02 15:00:00,2022-09-02 16:00:00,50,517,131,35,769,994,2496,20650
2022-09-02 16:00:00,2022-09-02 17:00:00,50,705,147,40,128,1336,2406,20985
2022-09-02 17:00:00,2022-09-02 18:00:00,50,833,158,40,0,2006,3087,21380
2022-09-02 18:00:00,2022-09-02 19:00:00,46,464,143,40,0,2681,3374,19982
2022-09-02 19:00:00,2022-09-02 20:00:00,45,268,108,5,0,2981,3407,18358
2022-09-02 20:00:00,2022-09-02 21:00:00,45,111,105,0,0,3051,3312,17092
2022-09-02 21:00:00,2022-09-02 22:00:00,45,97,96,0,0,2955,3193,16077
2022-09-02 22:00:00,2022-09-02 23:00:00,45,0,94,0,0,2818,2957,15372
2022-09-02 23:00:00,2022-09-03 00:00:00,45,0,97,0,0,2692,2834,14991
2022-09-03 00:00:00,2022-09-03 01:00:00,45,0,97,0,0,2652,2794,14936
2022-09-03 01:00:00,2022-09-03 02:00:00,45,0,97,0,0,2530,2672,14943
2022-09-03 02:00:00,2022-09-03 03:00:00,45,0,97,0,7,2385,2534,14896
2022-09-03 03:00:00,2022-09-03 04:00:00,43,0,96,0,176,2113,2428,15117
2022-09-03 04:00:00,2022-09-03 05:00:00,35,0,96,0,1213,1719,3063,16394
2022-09-03 05:00:00,2022-09-03 06:00:00,35,0,112,0,2927,938,4012,17900
2022-09-03 06:00:00,2022-09-03 07:00:00,35,1,120,0,4388,690,5234,18574
2022-09-03 07:00:00,2022-09-03 08:00:00,35,1,113,0,5434,885,6468,18656
2022-09-03 08:00:00,2022-09-03 09:00:00,36,0,103,0,6021,1149,7309,18751
2022-09-03 09:00:00,2022-09-03 10:00:00,36,0,101,0,5946,1360,7443,18609
2022-09-03 10:00:00,2022-09-03 11:00:00,36,0,101,0,5528,1489,7154,18361
2022-09-03 11:00:00,2022-09-03 12:00:00,38,0,101,0,4934,1554,6627,17918
2022-09-03 12:00:00,2022-09-03 13:00:00,45,0,101,0,4057,1615,5818,17622
2022-09-03 13:00:00,2022-09-03 14:00:00,45,0,111,0,3119,1761,5036,17702
2022-09-03 14:00:00,2022-09-03 15:00:00,45,285,113,0,1993,1756,4192,17782
2022-09-03 15:00:00,2022-09-03 16:00:00,45,469,123,0,674,1785,3096,17630
2022-09-03 16:00:00,2022-09-03 17:00:00,45,905,132,35,95,2241,3453,18069
2022-09-03 17:00:00,2022-09-03 18:00:00,45,847,130,40,0,3175,4237,18486
2022-09-03 18:00:00,2022-09-03 19:00:00,45,301,115,5,0,3643,4109,17467
2022-09-03 19:00:00,2022-09-03 20:00:00,45,0,99,0,0,3552,3696,16325
2022-09-03 20:00:00,2022-09-03 21:00:00,45,0,92,0,0,3433,3570,15129
2022-09-03 21:00:00,2022-09-03 22:00:00,45,0,93,0,0,3160,3298,14266
2022-09-03 22:00:00,2022-09-03 23:00:00,45,0,94,0,0,2881,3020,13706
2022-09-03 23:00:00,2022-09-04 00:00:00,45,0,94,0,0,2722,2861,13214
2022-09-04 00:00:00,2022-09-04 01:00:00,45,0,94,0,0,2634,2773,13024
2022-09-04 01:00:00,2022-09-04 02:00:00,45,0,94,0,0,2565,2704,13092
2022-09-04 02:00:00,2022-09-04 03:00:00,45,0,94,0,7,2491,2637,12998
2022-09-04 03:00:00,2022-09-04 04:00:00,42,0,94,0,165,2533,2834,12987
2022-09-04 04:00:00,2022-09-04 05:00:00,35,0,95,0,1092,2126,3348,13709
2022-09-04 05:00:00,2022-09-04 06:00:00,35,0,93,0,2603,1072,3803,14781
2022-09-04 06:00:00,2022-09-04 07:00:00,35,0,97,0,3987,806,4925,15551
2022-09-04 07:00:00,2022-09-04 08:00:00,35,0,99,0,4814,1244,6192,15769
2022-09-04 08:00:00,2022-09-04 09:00:00,35,0,99,0,5340,1239,6713,15797
2022-09-04 09:00:00,2022-09-04 10:00:00,35,0,99,0,5497,1201,6832,16149
2022-09-04 10:00:00,2022-09-04 11:00:00,35,0,99,0,5254,1120,6508,16122
2022-09-04 11:00:00,2022-09-04 12:00:00,35,0,98,0,4664,1058,5855,15736
2022-09-04 12:00:00,2022-09-04 13:00:00,35,0,98,0,3795,1052,4980,15557
2022-09-04 13:00:00,2022-09-04 14:00:00,36,0,98,0,2926,1138,4198,15755
2022-09-04 14:00:00,2022-09-04 15:00:00,45,0,98,0,1634,1265,3042,15928
2022-09-04 15:00:00,2022-09-04 16:00:00,45,221,105,0,540,1329,2240,16315
2022-09-04 16:00:00,2022-09-04 17:00:00,45,815,115,35,95,1754,2859,17259
2022-09-04 17:00:00,2022-09-04 18:00:00,45,888,131,40,0,2629,3733,17813
2022-09-04 18:00:00,2022-09-04 19:00:00,45,154,126,40,0,3255,3620,16927
2022-09-04 19:00:00,2022-09-04 20:00:00,45,0,120,5,0,3464,3634,15862
2022-09-04 20:00:00,2022-09-04 21:00:00,45,0,98,0,0,3402,3545,14920
2022-09-04 21:00:00,2022-09-04 22:00:00,45,0,95,0,0,3222,3362,14155
2022-09-04 22:00:00,2022-09-04 23:00:00,45,0,94,0,0,3043,3182,13823
2022-09-04 23:00:00,2022-09-05 00:00:00,45,0,94,0,0,2732,2871,13542
2022-09-05 00:00:00,2022-09-05 01:00:00,45,0,94,0,0,2481,2620,13621
2022-09-05 01:00:00,2022-09-05 02:00:00,45,0,94,0,0,2238,2377,13926
2022-09-05 02:00:00,2022-09-05 03:00:00,45,0,93,0,3,2067,2208,14763
2022-09-05 03:00:00,2022-09-05 04:00:00,45,0,93,0,168,1954,2260,17393
2022-09-05 04:00:00,2022-09-05 05:00:00,45,0,95,0,1224,1612,2976,19563
2022-09-05 05:00:00,2022-09-05 06:00:00,45,0,116,0,3065,764,3990,20719
2022-09-05 06:00:00,2022-09-05 07:00:00,45,0,112,0,4623,487,5267,20647
2022-09-05 07:00:00,2022-09-05 08:00:00,45,0,96,0,5760,656,6557,20280
2022-09-05 08:00:00,2022-09-05 09:00:00,45,0,95,0,6014,883,7037,20312
2022-09-05 09:00:00,2022-09-05 10:00:00,45,0,95,0,5876,1011,7027,20214
2022-09-05 10:00:00,2022-09-05 11:00:00,45,0,96,0,5776,961,6878,20181
2022-09-05 11:00:00,2022-09-05 12:00:00,45,0,96,0,5459,994,6594,20034
2022-09-05 12:00:00,2022-09-05 13:00:00,45,52,95,0,4668,1087,5947,20236
2022-09-05 13:00:00,2022-09-05 14:00:00,45,120,95,0,3532,1218,5010,20317
2022-09-05 14:00:00,2022-09-05 15:00:00,45,30,96,0,1953,1294,3418,20343
2022-09-05 15:00:00,2022-09-05 16:00:00,45,508,122,35,642,1534,2886,20450
2022-09-05 16:00:00,2022-09-05 17:00:00,45,817,133,40,124,2116,3275,21394
2022-09-05 17:00:00,2022-09-05 18:00:00,45,686,148,40,0,3056,3975,21667
2022-09-05 18:00:00,2022-09-05 19:00:00,45,26,125,5,0,3441,3642,20032
2022-09-05 19:00:00,2022-09-05 20:00:00,45,0,99,0,0,3377,3521,18238
2022-09-05 20:00:00,2022-09-05 21:00:00,45,0,91,0,0,3155,3291,16810
2022-09-05 21:00:00,2022-09-05 22:00:00,45,0,91,0,0,2956,3092,15932
2022-09-05 22:00:00,2022-09-05 23:00:00,45,0,91,0,0,2716,2852,15493
2022-09-05 23:00:00,2022-09-06 00:00:00,45,0,91,0,0,2499,2635,15206
2022-09-06 00:00:00,2022-09-06 01:00:00,45,0,91,0,0,2211,2347,15254
2022-09-06 01:00:00,2022-09-06 02:00:00,45,0,89,0,0,1892,2026,15517
2022-09-06 02:00:00,2022-09-06 03:00:00,45,0,91,0,2,1759,1897,16096
2022-09-06 03:00:00,2022-09-06 04:00:00,45,55,89,0,165,1635,1989,18242
2022-09-06 04:00:00,2022-09-06 05:00:00,45,303,89,0,1152,1439,3028,20091
2022-09-06 05:00:00,2022-09-06 06:00:00,45,165,103,0,2929,850,4092,21039
2022-09-06 06:00:00,2022-09-06 07:00:00,45,0,111,0,4536,596,5288,21217
2022-09-06 07:00:00,2022-09-06 08:00:00,45,0,95,0,5395,776,6311,20650
2022-09-06 08:00:00,2022-09-06 09:00:00,45,0,93,0,6071,1006,7215,20739
2022-09-06 09:00:00,2022-09-06 10:00:00,35,0,94,0,5923,991,7043,20572
2022-09-06 10:00:00,2022-09-06 11:00:00,32,0,94,0,5823,921,6870,20579
2022-09-06 11:00:00,2022-09-06 12:00:00,42,0,94,0,5412,819,6367,20585
2022-09-06 12:00:00,2022-09-06 13:00:00,45,0,94,0,4645,754,5538,20993
2022-09-06 13:00:00,2022-09-06 14:00:00,45,0,105,0,3414,681,4245,21004
2022-09-06 14:00:00,2022-09-06 15:00:00,45,71,107,0,1744,707,2674,20884
2022-09-06 15:00:00,2022-09-06 16:00:00,45,513,121,35,534,867,2115,20810
2022-09-06 16:00:00,2022-09-06 17:00:00,45,832,121,40,65,1420,2523,21658
2022-09-06 17:00:00,2022-09-06 18:00:00,45,842,127,40,0,2299,3353,21902
2022-09-06 18:00:00,2022-09-06 19:00:00,45,62,113,5,0,3006,3231,20213
2022-09-06 19:00:00,2022-09-06 20:00:00,45,0,113,0,0,3272,3430,18396
2022-09-06 20:00:00,2022-09-06 21:00:00,45,0,94,0,0,3387,3526,17061
2022-09-06 21:00:00,2022-09-06 22:00:00,45,0,91,0,0,3412,3548,15991
2022-09-06 22:00:00,2022-09-06 23:00:00,45,0,88,0,0,3431,3564,15529
2022-09-06 23:00:00,2022-09-07 00:00:00,45,0,88,0,0,3177,3310,15226
2022-09-07 00:00:00,2022-09-07 01:00:00,45,0,88,0,0,2857,2990,15186
2022-09-07 01:00:00,2022-09-07 02:00:00,45,0,88,0,0,2493,2626,15407
2022-09-07 02:00:00,2022-09-07 03:00:00,45,0,88,0,2,2168,2303,15943
2022-09-07 03:00:00,2022-09-07 04:00:00,45,0,88,0,167,2042,2342,18070
2022-09-07 04:00:00,2022-09-07 05:00:00,45,43,89,0,1239,1781,3197,20038
2022-09-07 05:00:00,2022-09-07 06:00:00,45,14,96,0,3104,889,4148,21000
2022-09-07 06:00:00,2022-09-07 07:00:00,45,0,110,0,4622,514,5291,20884
2022-09-07 07:00:00,2022-09-07 08:00:00,44,8,95,0,5804,768,6719,20386
2022-09-07 08:00:00,2022-09-07 09:00:00,33,75,98,0,6482,1003,7691,20446
2022-09-07 09:00:00,2022-09-07 10:00:00,33,10,102,0,6711,1044,7900,20536
2022-09-07 10:00:00,2022-09-07 11:00:00,33,0,103,0,6531,858,7525,20471
2022-09-07 11:00:00,2022-09-07 12:00:00,33,0,103,0,5934,746,6816,20293
2022-09-07 12:00:00,2022-09-07 13:00:00,33,0,102,0,5054,788,5977,20670
2022-09-07 13:00:00,2022-09-07 14:00:00,44,29,102,0,3701,839,4715,20916
2022-09-07 14:00:00,2022-09-07 15:00:00,45,586,101,0,1879,898,3509,20846
2022-09-07 15:00:00,2022-09-07 16:00:00,45,811,102,35,518,1162,2673,20779
2022-09-07 16:00:00,2022-09-07 17:00:00,45,809,112,40,59,1937,3002,21744
2022-09-07 17:00:00,2022-09-07 18:00:00,45,712,118,40,0,2791,3706,21948
2022-09-07 18:00:00,2022-09-07 19:00:00,34,45,115,5,0,3053,3252,20297
2022-09-07 19:00:00,2022-09-07 20:00:00,33,0,111,0,0,3099,3243,18526
2022-09-07 20:00:00,2022-09-07 21:00:00,33,0,91,0,0,3086,3210,17105
2022-09-07 21:00:00,2022-09-07 22:00:00,33,0,90,0,0,3031,3154,16183
2022-09-07 22:00:00,2022-09-07 23:00:00,33,0,90,0,0,2923,3046,15671
2022-09-07 23:00:00,2022-09-08 00:00:00,33,0,90,0,0,2875,2998,15391
2022-09-08 00:00:00,2022-09-08 01:00:00,33,0,90,0,0,2900,3023,15380
2022-09-08 01:00:00,2022-09-08 02:00:00,33,0,90,0,0,3064,3187,15579
2022-09-08 02:00:00,2022-09-08 03:00:00,36,0,90,0,2,3360,3488,16233
2022-09-08 03:00:00,2022-09-08 04:00:00,45,12,90,0,158,3673,3978,18330
2022-09-08 04:00:00,2022-09-08 05:00:00,45,47,90,0,1099,3303,4584,20203
2022-09-08 05:00:00,2022-09-08 06:00:00,45,0,98,0,2685,2298,5126,21057
2022-09-08 06:00:00,2022-09-08 07:00:00,41,0,110,0,4175,2132,6458,21128
2022-09-08 07:00:00,2022-09-08 08:00:00,33,1,110,0,5084,2978,8206,20559
2022-09-08 08:00:00,2022-09-08 09:00:00,33,0,115,0,5603,3763,9514,20733
2022-09-08 09:00:00,2022-09-08 10:00:00,33,0,101,0,5537,4125,9796,20968
2022-09-08 10:00:00,2022-09-08 11:00:00,33,0,98,0,5120,4071,9322,20870
2022-09-08 11:00:00,2022-09-08 12:00:00,33,0,99,0,4641,4338,9111,20807
2022-09-08 12:00:00,2022-09-08 13:00:00,44,99,98,0,3755,4747,8743,21269
2022-09-08 13:00:00,2022-09-08 14:00:00,45,145,99,0,2344,4841,7474,21266
2022-09-08 14:00:00,2022-09-08 15:00:00,45,301,108,0,873,4746,6073,21027
2022-09-08 15:00:00,2022-09-08 16:00:00,45,486,112,0,245,4571,5459,21141
2022-09-08 16:00:00,2022-09-08 17:00:00,45,626,122,35,49,4429,5306,21933
2022-09-08 17:00:00,2022-09-08 18:00:00,45,754,134,40,0,4674,5647,22128
2022-09-08 18:00:00,2022-09-08 19:00:00,45,364,122,5,0,4623,5159,20482
2022-09-08 19:00:00,2022-09-08 20:00:00,45,155,91,0,0,4452,4743,18851
2022-09-08 20:00:00,2022-09-08 21:00:00,45,68,90,0,0,4183,4386,17627
2022-09-08 21:00:00,2022-09-08 22:00:00,45,51,89,0,0,3891,4076,16628
2022-09-08 22:00:00,2022-09-08 23:00:00,45,33,89,0,0,3331,3498,16011
2022-09-08 23:00:00,2022-09-09 00:00:00,45,0,89,0,0,3037,3171,15747
2022-09-09 00:00:00,2022-09-09 01:00:00,45,0,89,0,0,2764,2898,15741
2022-09-09 01:00:00,2022-09-09 02:00:00,45,0,89,0,0,2489,2623,16100
2022-09-09 02:00:00,2022-09-09 03:00:00,45,0,89,0,2,2053,2189,16632
2022-09-09 03:00:00,2022-09-09 04:00:00,45,24,89,0,58,1754,1970,18714
2022-09-09 04:00:00,2022-09-09 05:00:00,45,313,91,0,442,1486,2377,20594
2022-09-09 05:00:00,2022-09-09 06:00:00,45,396,94,0,1281,1208,3024,21575
2022-09-09 06:00:00,2022-09-09 07:00:00,45,369,100,0,2117,996,3627,21792
2022-09-09 07:00:00,2022-09-09 08:00:00,45,99,99,0,2805,871,3919,21572
2022-09-09 08:00:00,2022-09-09 09:00:00,45,8,93,0,3484,752,4382,21897
2022-09-09 09:00:00,2022-09-09 10:00:00,45,16,103,0,3658,706,4528,21948
2022-09-09 10:00:00,2022-09-09 11:00:00,45,3,104,0,3687,675,4514,21787
2022-09-09 11:00:00,2022-09-09 12:00:00,45,8,105,0,3311,623,4092,21385
2022-09-09 12:00:00,2022-09-09 13:00:00,45,4,105,0,2822,556,3532,21396
2022-09-09 13:00:00,2022-09-09 14:00:00,45,129,106,0,1988,542,2810,21204
2022-09-09 14:00:00,2022-09-09 15:00:00,45,244,104,0,1142,666,2201,21102
2022-09-09 15:00:00,2022-09-09 16:00:00,45,499,113,34,304,866,1861,20801
2022-09-09 16:00:00,2022-09-09 17:00:00,45,859,123,39,43,1084,2193,21477
2022-09-09 17:00:00,2022-09-09 18:00:00,45,984,142,39,0,1576,2786,21436
2022-09-09 18:00:00,2022-09-09 19:00:00,45,528,132,5,0,2054,2764,20039
2022-09-09 19:00:00,2022-09-09 20:00:00,45,154,103,0,0,1939,2241,18552
2022-09-09 20:00:00,2022-09-09 21:00:00,45,0,94,0,0,1794,1933,17249
2022-09-09 21:00:00,2022-09-09 22:00:00,45,0,92,0,0,1705,1842,16282
2022-09-09 22:00:00,2022-09-09 23:00:00,45,0,90,0,0,1512,1647,15731
2022-09-09 23:00:00,2022-09-10 00:00:00,45,0,90,0,0,1300,1435,15382
2022-09-10 00:00:00,2022-09-10 01:00:00,45,0,90,0,0,1094,1229,15317
2022-09-10 01:00:00,2022-09-10 02:00:00,45,0,90,0,0,928,1063,15303
2022-09-10 02:00:00,2022-09-10 03:00:00,45,0,90,0,2,692,829,15235
2022-09-10 03:00:00,2022-09-10 04:00:00,45,0,90,0,43,569,747,15679
2022-09-10 04:00:00,2022-09-10 05:00:00,46,0,91,0,214,444,795,16833
2022-09-10 05:00:00,2022-09-10 06:00:00,49,327,97,0,574,273,1320,18092
2022-09-10 06:00:00,2022-09-10 07:00:00,50,547,106,0,1146,198,2047,19097
2022-09-10 07:00:00,2022-09-10 08:00:00,50,512,101,0,1750,169,2582,19568
2022-09-10 08:00:00,2022-09-10 09:00:00,50,292,100,0,1923,143,2508,19686
2022-09-10 09:00:00,2022-09-10 10:00:00,50,83,93,0,2289,114,2629,19797
2022-09-10 10:00:00,2022-09-10 11:00:00,50,147,92,0,2112,123,2524,19212
2022-09-10 11:00:00,2022-09-10 12:00:00,46,0,92,0,1919,131,2188,18665
2022-09-10 12:00:00,2022-09-10 13:00:00,50,0,92,0,1802,144,2088,18662
2022-09-10 13:00:00,2022-09-10 14:00:00,50,0,100,0,1108,150,1408,18190
2022-09-10 14:00:00,2022-09-10 15:00:00,50,51,107,0,779,154,1141,18404
2022-09-10 15:00:00,2022-09-10 16:00:00,50,398,116,0,243,169,976,18406
2022-09-10 16:00:00,2022-09-10 17:00:00,50,631,128,34,30,248,1121,19073
2022-09-10 17:00:00,2022-09-10 18:00:00,50,671,131,39,0,171,1062,18921
2022-09-10 18:00:00,2022-09-10 19:00:00,50,301,110,5,0,165,631,17852
2022-09-10 19:00:00,2022-09-10 20:00:00,50,0,95,0,0,138,283,16609
2022-09-10 20:00:00,2022-09-10 21:00:00,46,10,91,0,0,126,273,15515
2022-09-10 21:00:00,2022-09-10 22:00:00,45,4,90,0,0,140,279,14401
2022-09-10 22:00:00,2022-09-10 23:00:00,45,0,90,0,0,223,358,13761
2022-09-10 23:00:00,2022-09-11 00:00:00,45,0,90,0,0,361,496,13402
2022-09-11 00:00:00,2022-09-11 01:00:00,45,0,90,0,0,514,649,13276
2022-09-11 01:00:00,2022-09-11 02:00:00,45,7,90,0,0,674,816,13157
2022-09-11 02:00:00,2022-09-11 03:00:00,45,4,90,0,2,827,968,13174
2022-09-11 03:00:00,2022-09-11 04:00:00,45,0,90,0,35,943,1113,13191
2022-09-11 04:00:00,2022-09-11 05:00:00,45,0,89,0,204,1030,1368,13796
2022-09-11 05:00:00,2022-09-11 06:00:00,45,0,98,0,566,1106,1815,14891
2022-09-11 06:00:00,2022-09-11 07:00:00,45,65,105,0,1064,1247,2526,15980
2022-09-11 07:00:00,2022-09-11 08:00:00,45,253,104,0,1547,1616,3565,16451
2022-09-11 08:00:00,2022-09-11 09:00:00,45,30,103,0,2166,2116,4460,16761
2022-09-11 09:00:00,2022-09-11 10:00:00,45,0,91,0,2482,2561,5179,16709
2022-09-11 10:00:00,2022-09-11 11:00:00,45,0,89,0,2549,2998,5681,16496
2022-09-11 11:00:00,2022-09-11 12:00:00,45,0,89,0,2426,3241,5801,16185
2022-09-11 12:00:00,2022-09-11 13:00:00,45,0,89,0,2160,3484,5778,15852
2022-09-11 13:00:00,2022-09-11 14:00:00,45,0,90,0,1633,3576,5344,15773
2022-09-11 14:00:00,2022-09-11 15:00:00,45,0,97,0,934,3484,4560,16003
2022-09-11 15:00:00,2022-09-11 16:00:00,45,17,106,0,269,2931,3368,16574
2022-09-11 16:00:00,2022-09-11 17:00:00,45,302,119,34,38,2780,3318,17663
2022-09-11 17:00:00,2022-09-11 18:00:00,45,362,123,39,0,2934,3503,17907
2022-09-11 18:00:00,2022-09-11 19:00:00,45,119,127,5,0,2934,3230,16809
2022-09-11 19:00:00,2022-09-11 20:00:00,45,0,115,0,0,2776,2936,15905
2022-09-11 20:00:00,2022-09-11 21:00:00,45,0,101,0,0,2570,2716,14923
2022-09-11 21:00:00,2022-09-11 22:00:00,45,0,93,0,0,2433,2571,14064
2022-09-11 22:00:00,2022-09-11 23:00:00,45,0,90,0,0,2499,2634,13674
2022-09-11 23:00:00,2022-09-12 00:00:00,45,0,90,0,0,2511,2646,13586
2022-09-12 00:00:00,2022-09-12 01:00:00,45,0,90,0,0,2401,2536,13519
2022-09-12 01:00:00,2022-09-12 02:00:00,45,0,90,0,0,2255,2390,13807
2022-09-12 02:00:00,2022-09-12 03:00:00,45,0,90,0,0,2144,2279,14780
2022-09-12 03:00:00,2022-09-12 04:00:00,45,6,90,0,65,1909,2115,17507
2022-09-12 04:00:00,2022-09-12 05:00:00,46,120,90,0,541,1538,2335,19717
2022-09-12 05:00:00,2022-09-12 06:00:00,49,382,104,0,1484,1004,3023,20930
2022-09-12 06:00:00,2022-09-12 07:00:00,46,179,111,0,2396,845,3577,21111
2022-09-12 07:00:00,2022-09-12 08:00:00,45,0,105,0,2852,1182,4184,20789
2022-09-12 08:00:00,2022-09-12 09:00:00,45,0,95,0,3112,1233,4485,20864
2022-09-12 09:00:00,2022-09-12 10:00:00,45,0,94,0,3491,1144,4774,21080
2022-09-12 10:00:00,2022-09-12 11:00:00,45,0,94,0,3720,1093,4952,21164
2022-09-12 11:00:00,2022-09-12 12:00:00,45,0,93,0,3403,1091,4632,20686
2022-09-12 12:00:00,2022-09-12 13:00:00,45,0,96,0,3159,1021,4321,21098
2022-09-12 13:00:00,2022-09-12 14:00:00,46,0,103,0,2417,815,3381,20994
2022-09-12 14:00:00,2022-09-12 15:00:00,48,0,103,0,1217,602,1970,20836
2022-09-12 15:00:00,2022-09-12 16:00:00,48,277,118,34,295,452,1224,20867
2022-09-12 16:00:00,2022-09-12 17:00:00,48,1047,144,39,28,376,1682,21978
2022-09-12 17:00:00,2022-09-12 18:00:00,48,1186,150,39,0,333,1756,22014
2022-09-12 18:00:00,2022-09-12 19:00:00,48,539,148,5,0,304,1044,20325
2022-09-12 19:00:00,2022-09-12 20:00:00,48,0,120,0,0,348,516,18742
2022-09-12 20:00:00,2022-09-12 21:00:00,46,0,104,0,0,465,615,17365
2022-09-12 21:00:00,2022-09-12 22:00:00,45,108,101,0,0,640,894,16283
2022-09-12 22:00:00,2022-09-12 23:00:00,45,24,99,0,0,816,984,15661
2022-09-12 23:00:00,2022-09-13 00:00:00,45,0,99,0,0,1059,1203,15381
2022-09-13 00:00:00,2022-09-13 01:00:00,45,0,99,0,0,1320,1464,15389
2022-09-13 01:00:00,2022-09-13 02:00:00,45,0,94,0,0,1520,1659,15659
2022-09-13 02:00:00,2022-09-13 03:00:00,45,0,94,0,0,1661,1800,16344
2022-09-13 03:00:00,2022-09-13 04:00:00,49,219,97,0,110,1812,2287,18381
2022-09-13 04:00:00,2022-09-13 05:00:00,50,400,96,0,907,1940,3393,20206
2022-09-13 05:00:00,2022-09-13 06:00:00,49,178,94,0,2299,1823,4443,21162
2022-09-13 06:00:00,2022-09-13 07:00:00,46,15,100,0,3391,1370,4922,21185
2022-09-13 07:00:00,2022-09-13 08:00:00,45,0,111,0,3965,1188,5309,20835
2022-09-13 08:00:00,2022-09-13 09:00:00,45,0,97,0,3909,1167,5218,21180
2022-09-13 09:00:00,2022-09-13 10:00:00,45,0,96,0,3827,1219,5187,21271
2022-09-13 10:00:00,2022-09-13 11:00:00,45,0,96,0,3592,1409,5142,21322
2022-09-13 11:00:00,2022-09-13 12:00:00,45,0,96,0,3047,1569,4757,21141
2022-09-13 12:00:00,2022-09-13 13:00:00,45,48,99,0,2059,1694,3945,21090
2022-09-13 13:00:00,2022-09-13 14:00:00,45,104,105,0,1366,1749,3369,20990
2022-09-13 14:00:00,2022-09-13 15:00:00,45,136,105,0,759,1765,2810,20968
2022-09-13 15:00:00,2022-09-13 16:00:00,46,678,125,34,277,1826,2986,20956
2022-09-13 16:00:00,2022-09-13 17:00:00,49,1023,128,39,34,1873,3146,22097
2022-09-13 17:00:00,2022-09-13 18:00:00,49,993,137,39,0,2071,3289,22053
2022-09-13 18:00:00,2022-09-13 19:00:00,46,261,132,5,0,2192,2636,20349
2022-09-13 19:00:00,2022-09-13 20:00:00,36,0,112,0,0,2524,2672,18641
2022-09-13 20:00:00,2022-09-13 21:00:00,32,0,105,0,0,2763,2900,17147
2022-09-13 21:00:00,2022-09-13 22:00:00,32,0,90,0,0,2778,2900,16121
2022-09-13 22:00:00,2022-09-13 23:00:00,32,0,89,0,0,2822,2943,15672
2022-09-13 23:00:00,2022-09-14 00:00:00,32,0,89,0,0,2791,2912,15351
2022-09-14 00:00:00,2022-09-14 01:00:00,32,0,89,0,0,2767,2888,15350
2022-09-14 01:00:00,2022-09-14 02:00:00,32,0,89,0,0,2828,2949,15701
2022-09-14 02:00:00,2022-09-14 03:00:00,32,0,89,0,0,2887,3008,16430
2022-09-14 03:00:00,2022-09-14 04:00:00,43,0,89,0,75,2949,3156,18515
2022-09-14 04:00:00,2022-09-14 05:00:00,45,24,88,0,631,2656,3444,20266
2022-09-14 05:00:00,2022-09-14 06:00:00,45,141,95,0,1580,2070,3931,21115
2022-09-14 06:00:00,2022-09-14 07:00:00,45,91,107,0,2612,1901,4756,21361
2022-09-14 07:00:00,2022-09-14 08:00:00,45,0,98,0,3189,2023,5355,20952
2022-09-14 08:00:00,2022-09-14 09:00:00,43,0,98,0,3446,2308,5895,21159
2022-09-14 09:00:00,2022-09-14 10:00:00,36,49,98,0,3400,2460,6043,21141
2022-09-14 10:00:00,2022-09-14 11:00:00,35,35,98,0,3354,2346,5868,21073
2022-09-14 11:00:00,2022-09-14 12:00:00,37,101,98,0,2856,2171,5263,20895
2022-09-14 12:00:00,2022-09-14 13:00:00,45,42,97,0,2228,2009,4421,21211
2022-09-14 13:00:00,2022-09-14 14:00:00,45,0,96,0,1580,1648,3369,21279
2022-09-14 14:00:00,2022-09-14 15:00:00,46,161,96,0,686,1136,2125,21136
2022-09-14 15:00:00,2022-09-14 16:00:00,49,587,109,34,171,894,1844,21106
2022-09-14 16:00:00,2022-09-14 17:00:00,49,1033,123,39,22,947,2213,22188
2022-09-14 17:00:00,2022-09-14 18:00:00,49,1022,124,39,0,1004,2238,22084
2022-09-14 18:00:00,2022-09-14 19:00:00,46,395,110,5,0,1068,1624,20531
2022-09-14 19:00:00,2022-09-14 20:00:00,45,0,111,0,0,1135,1291,18929
2022-09-14 20:00:00,2022-09-14 21:00:00,45,0,110,0,0,1188,1343,17542
2022-09-14 21:00:00,2022-09-14 22:00:00,45,0,99,0,0,1189,1333,16458
2022-09-14 22:00:00,2022-09-14 23:00:00,45,0,97,0,0,1279,1421,15979
2022-09-14 23:00:00,2022-09-15 00:00:00,45,0,97,0,0,1409,1551,15779
2022-09-15 00:00:00,2022-09-15 01:00:00,45,56,97,0,0,1513,1711,15825
2022-09-15 01:00:00,2022-09-15 02:00:00,45,9,97,0,0,1631,1782,15969
2022-09-15 02:00:00,2022-09-15 03:00:00,45,0,97,0,0,1752,1894,16818
2022-09-15 03:00:00,2022-09-15 04:00:00,46,189,97,0,42,1924,2298,18829
2022-09-15 04:00:00,2022-09-15 05:00:00,50,574,95,0,401,2160,3280,20722
2022-09-15 05:00:00,2022-09-15 06:00:00,50,643,96,0,1242,2026,4057,21634
2022-09-15 06:00:00,2022-09-15 07:00:00,46,287,115,0,2277,2141,4866,21671
2022-09-15 07:00:00,2022-09-15 08:00:00,45,0,117,0,2876,2853,5891,21213
2022-09-15 08:00:00,2022-09-15 09:00:00,45,0,116,0,2997,3630,6788,21400
2022-09-15 09:00:00,2022-09-15 10:00:00,45,0,96,0,2993,4074,7208,21616
2022-09-15 10:00:00,2022-09-15 11:00:00,45,0,91,0,2847,4348,7331,21553
2022-09-15 11:00:00,2022-09-15 12:00:00,45,0,93,0,2684,4533,7355,21224
2022-09-15 12:00:00,2022-09-15 13:00:00,45,0,92,0,2061,4608,6806,21170
2022-09-15 13:00:00,2022-09-15 14:00:00,45,0,92,0,1412,4337,5886,21073
2022-09-15 14:00:00,2022-09-15 15:00:00,45,0,92,0,765,3711,4613,20807
2022-09-15 15:00:00,2022-09-15 16:00:00,45,90,113,34,236,3315,3833,20943
2022-09-15 16:00:00,2022-09-15 17:00:00,45,755,130,39,17,3137,4123,22042
2022-09-15 17:00:00,2022-09-15 18:00:00,45,961,130,39,0,3555,4730,21963
2022-09-15 18:00:00,2022-09-15 19:00:00,45,797,112,5,0,4143,5102,20340
2022-09-15 19:00:00,2022-09-15 20:00:00,45,714,108,0,0,4345,5212,18599
2022-09-15 20:00:00,2022-09-15 21:00:00,45,423,105,0,0,4363,4936,17249
2022-09-15 21:00:00,2022-09-15 22:00:00,45,14,109,0,0,4489,4657,16292
2022-09-15 22:00:00,2022-09-15 23:00:00,45,0,110,0,0,4685,4840,15692
2022-09-15 23:00:00,2022-09-16 00:00:00,45,0,110,0,0,4758,4913,15490
2022-09-16 00:00:00,2022-09-16 01:00:00,45,0,110,0,0,4878,5033,15424
2022-09-16 01:00:00,2022-09-16 02:00:00,45,0,110,0,0,4997,5152,15656
2022-09-16 02:00:00,2022-09-16 03:00:00,45,0,110,0,0,4990,5145,16359
2022-09-16 03:00:00,2022-09-16 04:00:00,45,284,110,0,77,4939,5455,18321
2022-09-16 04:00:00,2022-09-16 05:00:00,36,412,113,0,872,4715,6148,20161
2022-09-16 05:00:00,2022-09-16 06:00:00,33,170,114,0,2225,4853,7395,21146
2022-09-16 06:00:00,2022-09-16 07:00:00,33,0,115,0,3478,5294,8920,21221
2022-09-16 07:00:00,2022-09-16 08:00:00,33,0,101,0,4107,5728,9969,21047
2022-09-16 08:00:00,2022-09-16 09:00:00,33,0,95,0,4051,5992,10171,21245
2022-09-16 09:00:00,2022-09-16 10:00:00,33,0,95,0,3819,5899,9846,21173
2022-09-16 10:00:00,2022-09-16 11:00:00,33,0,94,0,3989,5684,9800,20965
2022-09-16 11:00:00,2022-09-16 12:00:00,33,0,94,0,3955,5419,9501,20574
2022-09-16 12:00:00,2022-09-16 13:00:00,33,0,95,0,3433,5071,8632,20684
2022-09-16 13:00:00,2022-09-16 14:00:00,35,0,94,0,2515,4831,7475,20666
2022-09-16 14:00:00,2022-09-16 15:00:00,45,0,103,0,1183,4304,5635,20495
2022-09-16 15:00:00,2022-09-16 16:00:00,45,415,125,0,275,3831,4691,20673
2022-09-16 16:00:00,2022-09-16 17:00:00,45,864,139,35,43,3897,5023,21678
2022-09-16 17:00:00,2022-09-16 18:00:00,45,783,151,40,0,4344,5363,21408
2022-09-16 18:00:00,2022-09-16 19:00:00,45,487,150,5,0,4692,5379,19897
2022-09-16 19:00:00,2022-09-16 20:00:00,45,75,123,0,0,4517,4760,18277
2022-09-16 20:00:00,2022-09-16 21:00:00,45,2,111,0,0,4504,4662,17048
2022-09-16 21:00:00,2022-09-16 22:00:00,36,0,106,0,0,4413,4555,16030
2022-09-16 22:00:00,2022-09-16 23:00:00,33,0,105,0,0,4340,4478,15277
2022-09-16 23:00:00,2022-09-17 00:00:00,33,0,105,0,0,4341,4479,15011
2022-09-17 00:00:00,2022-09-17 01:00:00,33,0,105,0,0,4003,4141,14792
2022-09-17 01:00:00,2022-09-17 02:00:00,33,0,105,0,0,3785,3923,14926
2022-09-17 02:00:00,2022-09-17 03:00:00,33,0,105,0,0,3689,3827,15158
2022-09-17 03:00:00,2022-09-17 04:00:00,33,0,105,0,63,3476,3677,15528
2022-09-17 04:00:00,2022-09-17 05:00:00,33,0,105,0,672,3079,3889,16807
2022-09-17 05:00:00,2022-09-17 06:00:00,33,0,105,0,1601,2663,4402,17999
2022-09-17 06:00:00,2022-09-17 07:00:00,33,0,100,0,2294,2534,4961,18797
2022-09-17 07:00:00,2022-09-17 08:00:00,33,56,95,0,2786,2620,5590,19104
2022-09-17 08:00:00,2022-09-17 09:00:00,33,82,95,0,3069,2517,5796,19322
2022-09-17 09:00:00,2022-09-17 10:00:00,33,113,95,0,3214,2357,5812,19274
2022-09-17 10:00:00,2022-09-17 11:00:00,33,33,96,0,3061,2477,5700,19083
2022-09-17 11:00:00,2022-09-17 12:00:00,33,0,96,0,2713,2561,5403,18343
2022-09-17 12:00:00,2022-09-17 13:00:00,34,0,96,0,2478,2339,4947,18313
2022-09-17 13:00:00,2022-09-17 14:00:00,37,17,96,0,1668,2060,3878,17954
2022-09-17 14:00:00,2022-09-17 15:00:00,45,233,100,0,845,1700,2923,17977
2022-09-17 15:00:00,2022-09-17 16:00:00,46,603,120,35,205,1596,2605,18307
2022-09-17 16:00:00,2022-09-17 17:00:00,49,837,123,40,29,1770,2848,19269
2022-09-17 17:00:00,2022-09-17 18:00:00,49,820,121,40,0,1915,2945,18984
2022-09-17 18:00:00,2022-09-17 19:00:00,49,340,121,5,0,2113,2628,17665
2022-09-17 19:00:00,2022-09-17 20:00:00,38,15,109,0,0,2232,2394,16474
2022-09-17 20:00:00,2022-09-17 21:00:00,33,0,105,0,0,2362,2500,15265
2022-09-17 21:00:00,2022-09-17 22:00:00,33,0,94,0,0,2327,2454,14209
2022-09-17 22:00:00,2022-09-17 23:00:00,33,0,93,0,0,2166,2292,13549
2022-09-17 23:00:00,2022-09-18 00:00:00,33,0,93,0,0,2033,2159,13357
2022-09-18 00:00:00,2022-09-18 01:00:00,33,0,93,0,0,1881,2007,13293
2022-09-18 01:00:00,2022-09-18 02:00:00,32,0,93,0,0,1735,1860,13332
2022-09-18 02:00:00,2022-09-18 03:00:00,33,0,93,0,0,1619,1745,13336
2022-09-18 03:00:00,2022-09-18 04:00:00,33,0,93,0,29,1586,1741,13305
2022-09-18 04:00:00,2022-09-18 05:00:00,33,0,92,0,270,1523,1918,13981
2022-09-18 05:00:00,2022-09-18 06:00:00,33,0,104,0,803,1571,2511,15130
2022-09-18 06:00:00,2022-09-18 07:00:00,33,0,103,0,1437,1644,3217,16139
2022-09-18 07:00:00,2022-09-18 08:00:00,33,0,104,0,1952,1881,3970,16688
2022-09-18 08:00:00,2022-09-18 09:00:00,33,0,98,0,2407,2137,4675,16933
2022-09-18 09:00:00,2022-09-18 10:00:00,33,0,98,0,2708,2360,5199,16944
2022-09-18 10:00:00,2022-09-18 11:00:00,33,0,98,0,2565,2569,5265,16632
2022-09-18 11:00:00,2022-09-18 12:00:00,33,0,98,0,2665,2441,5237,16513
2022-09-18 12:00:00,2022-09-18 13:00:00,33,0,97,0,2350,2337,4817,16165
2022-09-18 13:00:00,2022-09-18 14:00:00,33,17,107,0,1688,2307,4152,16093
2022-09-18 14:00:00,2022-09-18 15:00:00,38,151,112,0,849,2020,3170,16515
2022-09-18 15:00:00,2022-09-18 16:00:00,49,702,144,0,256,1682,2833,17098
2022-09-18 16:00:00,2022-09-18 17:00:00,49,934,149,35,30,1829,3026,18321
2022-09-18 17:00:00,2022-09-18 18:00:00,49,880,156,40,0,1973,3098,18153
2022-09-18 18:00:00,2022-09-18 19:00:00,48,416,159,5,0,2261,2889,17112
2022-09-18 19:00:00,2022-09-18 20:00:00,46,18,123,0,0,2224,2411,16116
2022-09-18 20:00:00,2022-09-18 21:00:00,36,0,116,0,0,2221,2373,15046
2022-09-18 21:00:00,2022-09-18 22:00:00,33,0,103,0,0,2179,2315,14239
2022-09-18 22:00:00,2022-09-18 23:00:00,33,0,101,0,0,2058,2192,13921
2022-09-18 23:00:00,2022-09-19 00:00:00,32,0,101,0,0,1871,2004,13684
2022-09-19 00:00:00,2022-09-19 01:00:00,33,0,101,0,0,1605,1739,13690
2022-09-19 01:00:00,2022-09-19 02:00:00,33,0,101,0,0,1452,1586,14164
2022-09-19 02:00:00,2022-09-19 03:00:00,35,0,101,0,0,1320,1456,15259
2022-09-19 03:00:00,2022-09-19 04:00:00,48,184,102,0,23,1289,1646,18020
2022-09-19 04:00:00,2022-09-19 05:00:00,46,489,105,0,255,1303,2198,20290
2022-09-19 05:00:00,2022-09-19 06:00:00,45,637,115,0,741,1328,2866,21569
2022-09-19 06:00:00,2022-09-19 07:00:00,45,598,128,0,1363,1234,3368,21998
2022-09-19 07:00:00,2022-09-19 08:00:00,45,0,118,0,2078,1213,3454,22025
2022-09-19 08:00:00,2022-09-19 09:00:00,45,0,111,0,2378,1479,4013,22006
2022-09-19 09:00:00,2022-09-19 10:00:00,45,0,116,0,2509,1826,4496,21899
2022-09-19 10:00:00,2022-09-19 11:00:00,45,0,117,0,2515,1806,4483,21650
2022-09-19 11:00:00,2022-09-19 12:00:00,45,0,121,0,2452,1906,4524,21182
2022-09-19 12:00:00,2022-09-19 13:00:00,45,0,126,0,2367,2101,4639,21542
2022-09-19 13:00:00,2022-09-19 14:00:00,45,244,140,0,1675,1703,3807,21422
2022-09-19 14:00:00,2022-09-19 15:00:00,45,152,142,0,741,1365,2445,21206
2022-09-19 15:00:00,2022-09-19 16:00:00,45,190,143,35,183,1428,2024,21541
2022-09-19 16:00:00,2022-09-19 17:00:00,47,897,162,40,7,1816,2969,22638
2022-09-19 17:00:00,2022-09-19 18:00:00,47,695,175,40,0,2136,3093,22254
2022-09-19 18:00:00,2022-09-19 19:00:00,46,183,168,5,0,2403,2805,20684
2022-09-19 19:00:00,2022-09-19 20:00:00,45,0,152,0,0,2491,2688,19099
2022-09-19 20:00:00,2022-09-19 21:00:00,45,0,146,0,0,2408,2599,17702
2022-09-19 21:00:00,2022-09-19 22:00:00,45,0,132,0,0,2185,2362,16550
2022-09-19 22:00:00,2022-09-19 23:00:00,45,0,132,0,0,1998,2175,15889
2022-09-19 23:00:00,2022-09-20 00:00:00,45,0,128,0,0,1868,2041,15611
2022-09-20 00:00:00,2022-09-20 01:00:00,45,0,126,0,0,1665,1836,15530
2022-09-20 01:00:00,2022-09-20 02:00:00,45,0,123,0,0,1679,1847,15893
2022-09-20 02:00:00,2022-09-20 03:00:00,45,0,121,0,0,1683,1849,16639
2022-09-20 03:00:00,2022-09-20 04:00:00,48,24,127,0,24,1554,1777,18999
2022-09-20 04:00:00,2022-09-20 05:00:00,48,460,129,0,319,1465,2421,21032
2022-09-20 05:00:00,2022-09-20 06:00:00,48,979,143,0,890,1115,3175,22081
2022-09-20 06:00:00,2022-09-20 07:00:00,47,844,133,0,1592,822,3438,22357
2022-09-20 07:00:00,2022-09-20 08:00:00,46,217,134,0,2484,915,3796,22081
2022-09-20 08:00:00,2022-09-20 09:00:00,45,0,134,0,3050,1106,4335,22020
2022-09-20 09:00:00,2022-09-20 10:00:00,45,0,126,0,3293,1202,4666,21505
2022-09-20 10:00:00,2022-09-20 11:00:00,45,0,124,0,3628,1273,5070,21399
2022-09-20 11:00:00,2022-09-20 12:00:00,45,0,124,0,3359,1578,5106,20746
2022-09-20 12:00:00,2022-09-20 13:00:00,45,0,128,0,3127,1725,5025,21124
2022-09-20 13:00:00,2022-09-20 14:00:00,45,0,127,0,2224,1690,4086,21270
2022-09-20 14:00:00,2022-09-20 15:00:00,47,23,139,0,1157,1588,2954,21267
2022-09-20 15:00:00,2022-09-20 16:00:00,48,316,165,35,229,1653,2446,21547
2022-09-20 16:00:00,2022-09-20 17:00:00,48,835,171,40,8,1906,3008,22752
2022-09-20 17:00:00,2022-09-20 18:00:00,47,698,180,40,0,2123,3088,22436
2022-09-20 18:00:00,2022-09-20 19:00:00,48,382,176,5,0,2284,2895,20792
2022-09-20 19:00:00,2022-09-20 20:00:00,47,186,149,0,0,2150,2532,19093
2022-09-20 20:00:00,2022-09-20 21:00:00,49,17,133,0,0,2025,2224,17606
2022-09-20 21:00:00,2022-09-20 22:00:00,57,0,132,0,0,1841,2030,16487
2022-09-20 22:00:00,2022-09-20 23:00:00,78,0,129,0,0,1727,1934,16023
2022-09-20 23:00:00,2022-09-21 00:00:00,92,0,129,0,0,1703,1924,15673
2022-09-21 00:00:00,2022-09-21 01:00:00,92,0,128,0,0,1753,1973,15771
2022-09-21 01:00:00,2022-09-21 02:00:00,92,0,128,0,0,1649,1869,16035
2022-09-21 02:00:00,2022-09-21 03:00:00,92,10,126,0,0,1618,1846,16774
2022-09-21 03:00:00,2022-09-21 04:00:00,92,20,131,35,19,1462,1759,19079
2022-09-21 04:00:00,2022-09-21 05:00:00,92,311,134,40,282,1340,2199,21158
2022-09-21 05:00:00,2022-09-21 06:00:00,89,484,155,40,803,1117,2688,22104
2022-09-21 06:00:00,2022-09-21 07:00:00,95,381,167,40,1618,960,3261,22354
2022-09-21 07:00:00,2022-09-21 08:00:00,95,66,161,5,2386,927,3640,22156
2022-09-21 08:00:00,2022-09-21 09:00:00,95,81,152,0,2899,1086,4313,22061
2022-09-21 09:00:00,2022-09-21 10:00:00,95,0,137,0,3210,1262,4704,22014
2022-09-21 10:00:00,2022-09-21 11:00:00,92,0,127,0,3299,1586,5104,21595
2022-09-21 11:00:00,2022-09-21 12:00:00,92,0,123,0,3229,1854,5298,21127
2022-09-21 12:00:00,2022-09-21 13:00:00,92,0,121,0,3133,2112,5458,21402
2022-09-21 13:00:00,2022-09-21 14:00:00,92,0,118,0,2150,2069,4429,21297
2022-09-21 14:00:00,2022-09-21 15:00:00,92,83,127,0,925,1811,3038,21202
2022-09-21 15:00:00,2022-09-21 16:00:00,95,485,156,0,187,1631,2554,21570
2022-09-21 16:00:00,2022-09-21 17:00:00,95,831,176,35,8,1657,2802,22765
2022-09-21 17:00:00,2022-09-21 18:00:00,95,782,177,40,0,1605,2699,22474
2022-09-21 18:00:00,2022-09-21 19:00:00,92,642,176,5,0,1353,2268,20846
2022-09-21 19:00:00,2022-09-21 20:00:00,92,336,143,0,0,1256,1827,19128
2022-09-21 20:00:00,2022-09-21 21:00:00,92,0,127,0,0,1229,1448,17742
2022-09-21 21:00:00,2022-09-21 22:00:00,95,0,127,0,0,1192,1414,16733
2022-09-21 22:00:00,2022-09-21 23:00:00,96,0,127,0,0,1163,1386,16199
2022-09-21 23:00:00,2022-09-22 00:00:00,95,0,127,0,0,1128,1350,15805
2022-09-22 00:00:00,2022-09-22 01:00:00,95,0,127,0,0,1161,1383,15840
2022-09-22 01:00:00,2022-09-22 02:00:00,95,0,127,0,0,1124,1346,16189
2022-09-22 02:00:00,2022-09-22 03:00:00,95,37,127,0,0,1118,1377,17001
2022-09-22 03:00:00,2022-09-22 04:00:00,95,93,136,35,25,1005,1389,19239
2022-09-22 04:00:00,2022-09-22 05:00:00,96,504,135,40,466,825,2066,21183
2022-09-22 05:00:00,2022-09-22 06:00:00,95,582,149,40,1455,513,2834,22159
2022-09-22 06:00:00,2022-09-22 07:00:00,95,378,163,5,2523,266,3430,22314
2022-09-22 07:00:00,2022-09-22 08:00:00,95,34,160,0,3350,278,3917,21725
2022-09-22 08:00:00,2022-09-22 09:00:00,96,0,132,0,4017,352,4597,21986
2022-09-22 09:00:00,2022-09-22 10:00:00,96,0,120,0,3782,381,4379,21881
2022-09-22 10:00:00,2022-09-22 11:00:00,96,0,120,0,3469,428,4113,21937
2022-09-22 11:00:00,2022-09-22 12:00:00,96,0,120,0,3109,493,3818,21558
2022-09-22 12:00:00,2022-09-22 13:00:00,96,0,120,0,2682,587,3485,21659
2022-09-22 13:00:00,2022-09-22 14:00:00,95,0,120,0,1720,621,2556,21416
2022-09-22 14:00:00,2022-09-22 15:00:00,96,170,123,0,812,571,1772,21255
2022-09-22 15:00:00,2022-09-22 16:00:00,96,332,125,35,171,559,1318,21510
2022-09-22 16:00:00,2022-09-22 17:00:00,96,865,127,40,8,682,1818,22565
2022-09-22 17:00:00,2022-09-22 18:00:00,95,934,132,40,0,662,1863,22402
2022-09-22 18:00:00,2022-09-22 19:00:00,96,545,151,5,0,688,1485,20951
2022-09-22 19:00:00,2022-09-22 20:00:00,96,171,138,0,0,560,965,19283
2022-09-22 20:00:00,2022-09-22 21:00:00,95,9,134,0,0,489,727,17880
2022-09-22 21:00:00,2022-09-22 22:00:00,96,0,135,0,0,427,658,16762
2022-09-22 22:00:00,2022-09-22 23:00:00,96,0,127,0,0,417,640,16238
2022-09-22 23:00:00,2022-09-23 00:00:00,96,0,117,0,0,510,723,15903
2022-09-23 00:00:00,2022-09-23 01:00:00,78,0,116,0,0,573,767,15969
2022-09-23 01:00:00,2022-09-23 02:00:00,47,0,116,0,0,639,802,16295
2022-09-23 02:00:00,2022-09-23 03:00:00,46,50,116,0,0,672,884,17097
2022-09-23 03:00:00,2022-09-23 04:00:00,45,135,125,35,30,610,980,19392
2022-09-23 04:00:00,2022-09-23 05:00:00,45,134,137,40,589,521,1466,21202
2022-09-23 05:00:00,2022-09-23 06:00:00,46,132,151,40,1979,375,2723,22078
2022-09-23 06:00:00,2022-09-23 07:00:00,47,97,174,5,3528,163,4014,22098
2022-09-23 07:00:00,2022-09-23 08:00:00,48,12,146,0,4719,89,5014,21484
2022-09-23 08:00:00,2022-09-23 09:00:00,48,0,135,0,4961,106,5250,21297
2022-09-23 09:00:00,2022-09-23 10:00:00,49,0,118,0,4458,135,4760,21069
2022-09-23 10:00:00,2022-09-23 11:00:00,49,0,117,0,4664,164,4994,21478
2022-09-23 11:00:00,2022-09-23 12:00:00,49,0,121,0,4155,207,4532,21194
2022-09-23 12:00:00,2022-09-23 13:00:00,49,0,124,0,3463,238,3874,21396
2022-09-23 13:00:00,2022-09-23 14:00:00,49,0,128,0,2276,201,2654,21340
2022-09-23 14:00:00,2022-09-23 15:00:00,49,17,125,35,1030,119,1375,21227
2022-09-23 15:00:00,2022-09-23 16:00:00,48,333,194,40,242,101,958,21308
2022-09-23 16:00:00,2022-09-23 17:00:00,48,614,233,42,19,96,1052,21854
2022-09-23 17:00:00,2022-09-23 18:00:00,48,313,248,43,0,159,811,21363
2022-09-23 18:00:00,2022-09-23 19:00:00,48,214,217,5,0,236,720,20364
2022-09-23 19:00:00,2022-09-23 20:00:00,47,155,175,0,0,335,712,18851
2022-09-23 20:00:00,2022-09-23 21:00:00,48,18,168,0,0,446,680,17618
2022-09-23 21:00:00,2022-09-23 22:00:00,46,163,139,0,0,549,897,16530
2022-09-23 22:00:00,2022-09-23 23:00:00,45,9,124,0,0,596,774,15901
2022-09-23 23:00:00,2022-09-24 00:00:00,45,0,123,0,0,618,786,15506
2022-09-24 00:00:00,2022-09-24 01:00:00,45,0,123,0,0,534,702,15389
2022-09-24 01:00:00,2022-09-24 02:00:00,45,0,123,0,0,489,657,15470
2022-09-24 02:00:00,2022-09-24 03:00:00,45,0,123,0,0,427,595,15646
2022-09-24 03:00:00,2022-09-24 04:00:00,45,0,132,0,33,344,554,16164
2022-09-24 04:00:00,2022-09-24 05:00:00,45,0,133,0,515,267,960,17304
2022-09-24 05:00:00,2022-09-24 06:00:00,45,0,145,35,1494,197,1916,18474
2022-09-24 06:00:00,2022-09-24 07:00:00,48,0,152,40,2641,109,2990,19022
2022-09-24 07:00:00,2022-09-24 08:00:00,49,0,146,5,3582,51,3833,19129
2022-09-24 08:00:00,2022-09-24 09:00:00,49,0,134,0,4133,75,4391,18859
2022-09-24 09:00:00,2022-09-24 10:00:00,49,0,121,0,4501,130,4801,18726
2022-09-24 10:00:00,2022-09-24 11:00:00,49,0,119,0,4001,133,4302,18189
2022-09-24 11:00:00,2022-09-24 12:00:00,49,0,118,0,3454,127,3748,17814
2022-09-24 12:00:00,2022-09-24 13:00:00,50,0,119,0,2973,98,3240,17909
2022-09-24 13:00:00,2022-09-24 14:00:00,49,0,125,0,2125,77,2376,18112
2022-09-24 14:00:00,2022-09-24 15:00:00,49,45,127,35,882,76,1214,18214
2022-09-24 15:00:00,2022-09-24 16:00:00,49,748,160,40,214,118,1329,18761
2022-09-24 16:00:00,2022-09-24 17:00:00,48,1252,164,40,18,238,1760,19631
2022-09-24 17:00:00,2022-09-24 18:00:00,48,1105,171,40,0,326,1690,19132
2022-09-24 18:00:00,2022-09-24 19:00:00,48,766,174,40,0,386,1414,17995
2022-09-24 19:00:00,2022-09-24 20:00:00,48,290,129,40,0,416,923,16920
2022-09-24 20:00:00,2022-09-24 21:00:00,48,50,117,5,0,371,591,15727
2022-09-24 21:00:00,2022-09-24 22:00:00,48,16,116,0,0,315,495,14775
2022-09-24 22:00:00,2022-09-24 23:00:00,47,118,115,0,0,288,568,14015
2022-09-24 23:00:00,2022-09-25 00:00:00,48,2,115,0,0,289,454,13705
2022-09-25 00:00:00,2022-09-25 01:00:00,48,0,115,0,0,292,455,13571
2022-09-25 01:00:00,2022-09-25 02:00:00,48,0,115,0,0,299,462,13697
2022-09-25 02:00:00,2022-09-25 03:00:00,47,0,115,0,0,286,448,13881
2022-09-25 03:00:00,2022-09-25 04:00:00,47,22,124,0,28,300,521,13815
2022-09-25 04:00:00,2022-09-25 05:00:00,47,28,126,0,478,281,960,14452
2022-09-25 05:00:00,2022-09-25 06:00:00,47,3,128,0,1370,248,1796,15441
2022-09-25 06:00:00,2022-09-25 07:00:00,48,0,144,0,2413,171,2776,16163
2022-09-25 07:00:00,2022-09-25 08:00:00,47,0,144,0,3439,90,3720,16498
2022-09-25 08:00:00,2022-09-25 09:00:00,47,0,134,0,4071,73,4325,16321
2022-09-25 09:00:00,2022-09-25 10:00:00,47,0,127,0,4313,73,4560,16396
2022-09-25 10:00:00,2022-09-25 11:00:00,48,0,118,0,4110,79,4355,16537
2022-09-25 11:00:00,2022-09-25 12:00:00,48,0,118,0,3394,55,3615,16510
2022-09-25 12:00:00,2022-09-25 13:00:00,49,0,118,0,2360,49,2576,16296
2022-09-25 13:00:00,2022-09-25 14:00:00,49,0,118,0,1336,65,1568,16327
2022-09-25 14:00:00,2022-09-25 15:00:00,48,0,127,0,539,83,797,16609
2022-09-25 15:00:00,2022-09-25 16:00:00,47,376,154,35,137,104,853,17480
2022-09-25 16:00:00,2022-09-25 17:00:00,47,852,159,40,7,156,1261,18603
2022-09-25 17:00:00,2022-09-25 18:00:00,57,682,161,40,0,275,1215,18222
2022-09-25 18:00:00,2022-09-25 19:00:00,68,244,161,40,0,406,919,17340
2022-09-25 19:00:00,2022-09-25 20:00:00,85,50,130,40,0,636,941,16322
2022-09-25 20:00:00,2022-09-25 21:00:00,94,0,114,5,0,960,1173,15310
2022-09-25 21:00:00,2022-09-25 22:00:00,96,0,116,0,0,1153,1365,14448
2022-09-25 22:00:00,2022-09-25 23:00:00,97,0,116,0,0,1207,1420,14024
2022-09-25 23:00:00,2022-09-26 00:00:00,96,0,116,0,0,1240,1452,13836
2022-09-26 00:00:00,2022-09-26 01:00:00,96,0,116,0,0,1224,1436,13834
2022-09-26 01:00:00,2022-09-26 02:00:00,97,0,116,0,0,1059,1272,14245
2022-09-26 02:00:00,2022-09-26 03:00:00,96,34,116,0,0,960,1206,15418
2022-09-26 03:00:00,2022-09-26 04:00:00,96,134,121,0,22,1023,1396,18350
2022-09-26 04:00:00,2022-09-26 05:00:00,96,78,121,35,369,951,1650,20416
2022-09-26 05:00:00,2022-09-26 06:00:00,96,235,147,40,1089,850,2457,21621
2022-09-26 06:00:00,2022-09-26 07:00:00,97,132,163,5,1928,623,2948,21951
2022-09-26 07:00:00,2022-09-26 08:00:00,96,0,144,0,2751,481,3472,21588
2022-09-26 08:00:00,2022-09-26 09:00:00,97,0,129,0,3201,508,3935,21674
2022-09-26 09:00:00,2022-09-26 10:00:00,97,0,121,0,3118,572,3908,21626
2022-09-26 10:00:00,2022-09-26 11:00:00,96,0,119,0,3234,650,4099,21568
2022-09-26 11:00:00,2022-09-26 12:00:00,97,0,119,0,3119,673,4008,21094
2022-09-26 12:00:00,2022-09-26 13:00:00,96,0,117,0,2634,640,3487,21282
2022-09-26 13:00:00,2022-09-26 14:00:00,97,0,125,0,1709,625,2556,21224
2022-09-26 14:00:00,2022-09-26 15:00:00,96,186,124,0,913,635,1954,21444
2022-09-26 15:00:00,2022-09-26 16:00:00,96,754,144,35,157,880,2066,21580
2022-09-26 16:00:00,2022-09-26 17:00:00,96,1010,167,40,0,1393,2706,22605
2022-09-26 17:00:00,2022-09-26 18:00:00,97,754,172,40,0,1928,2991,22130
2022-09-26 18:00:00,2022-09-26 19:00:00,97,55,172,41,0,2057,2422,20546
2022-09-26 19:00:00,2022-09-26 20:00:00,97,0,129,5,0,1975,2206,18865
2022-09-26 20:00:00,2022-09-26 21:00:00,96,0,114,0,0,2078,2288,17496
2022-09-26 21:00:00,2022-09-26 22:00:00,96,0,109,0,0,2120,2325,16390
2022-09-26 22:00:00,2022-09-26 23:00:00,96,0,108,0,0,2123,2327,15872
2022-09-26 23:00:00,2022-09-27 00:00:00,96,0,108,0,0,2039,2243,15501
2022-09-27 00:00:00,2022-09-27 01:00:00,96,0,108,0,0,1972,2176,15616
2022-09-27 01:00:00,2022-09-27 02:00:00,96,0,108,0,0,1918,2122,15966
2022-09-27 02:00:00,2022-09-27 03:00:00,97,0,108,0,0,1878,2083,16766
2022-09-27 03:00:00,2022-09-27 04:00:00,96,18,109,0,16,1848,2087,18986
2022-09-27 04:00:00,2022-09-27 05:00:00,96,71,116,35,324,1752,2394,20808
2022-09-27 05:00:00,2022-09-27 06:00:00,96,325,137,40,936,1590,3124,21736
2022-09-27 06:00:00,2022-09-27 07:00:00,96,295,147,40,1673,1381,3632,21960
2022-09-27 07:00:00,2022-09-27 08:00:00,96,27,139,5,2403,1293,3963,21828
2022-09-27 08:00:00,2022-09-27 09:00:00,97,0,139,0,2524,1376,4136,21693
2022-09-27 09:00:00,2022-09-27 10:00:00,96,0,134,0,2631,1672,4533,21766
2022-09-27 10:00:00,2022-09-27 11:00:00,96,0,126,0,2356,1715,4293,21560
2022-09-27 11:00:00,2022-09-27 12:00:00,96,0,130,0,2069,1719,4014,21150
2022-09-27 12:00:00,2022-09-27 13:00:00,96,0,129,0,1606,1795,3626,21430
2022-09-27 13:00:00,2022-09-27 14:00:00,96,0,135,0,943,1907,3081,21439
2022-09-27 14:00:00,2022-09-27 15:00:00,96,123,148,0,382,1807,2556,21494
2022-09-27 15:00:00,2022-09-27 16:00:00,97,617,181,35,84,1929,2943,22093
2022-09-27 16:00:00,2022-09-27 17:00:00,96,1031,186,40,0,2054,3407,22949
2022-09-27 17:00:00,2022-09-27 18:00:00,96,893,185,40,0,2055,3269,22473
2022-09-27 18:00:00,2022-09-27 19:00:00,96,291,181,5,0,2074,2647,20800
2022-09-27 19:00:00,2022-09-27 20:00:00,97,0,155,0,0,1798,2050,18984
2022-09-27 20:00:00,2022-09-27 21:00:00,96,0,133,0,0,1498,1727,17723
2022-09-27 21:00:00,2022-09-27 22:00:00,97,0,111,0,0,1301,1509,16680
2022-09-27 22:00:00,2022-09-27 23:00:00,96,0,110,0,0,1212,1418,16081
2022-09-27 23:00:00,2022-09-28 00:00:00,96,0,110,0,0,1153,1359,15743
2022-09-28 00:00:00,2022-09-28 01:00:00,97,0,110,0,0,1194,1401,15756
2022-09-28 01:00:00,2022-09-28 02:00:00,96,0,110,0,0,1065,1271,16102
2022-09-28 02:00:00,2022-09-28 03:00:00,96,0,110,0,0,958,1164,16947
2022-09-28 03:00:00,2022-09-28 04:00:00,96,85,118,0,10,921,1230,19244
2022-09-28 04:00:00,2022-09-28 05:00:00,97,706,126,38,275,906,2148,21021
2022-09-28 05:00:00,2022-09-28 06:00:00,96,538,151,43,1167,889,2884,21956
2022-09-28 06:00:00,2022-09-28 07:00:00,97,215,173,5,2319,750,3559,21942
2022-09-28 07:00:00,2022-09-28 08:00:00,96,0,152,0,3194,712,4154,21452
2022-09-28 08:00:00,2022-09-28 09:00:00,97,0,139,0,3944,734,4914,21770
2022-09-28 09:00:00,2022-09-28 10:00:00,96,0,126,0,4042,816,5080,22042
2022-09-28 10:00:00,2022-09-28 11:00:00,89,0,125,0,3735,846,4795,21890
2022-09-28 11:00:00,2022-09-28 12:00:00,87,0,125,0,3144,754,4110,21558
2022-09-28 12:00:00,2022-09-28 13:00:00,87,9,125,0,2401,599,3221,21642
2022-09-28 13:00:00,2022-09-28 14:00:00,86,264,125,0,1375,540,2390,21596
2022-09-28 14:00:00,2022-09-28 15:00:00,89,806,125,0,529,524,2073,21665
2022-09-28 15:00:00,2022-09-28 16:00:00,96,1099,137,38,101,594,2065,22159
2022-09-28 16:00:00,2022-09-28 17:00:00,96,1514,157,43,0,682,2492,23061
2022-09-28 17:00:00,2022-09-28 18:00:00,97,749,170,43,0,958,2017,22599
2022-09-28 18:00:00,2022-09-28 19:00:00,97,290,170,5,0,1080,1642,20871
2022-09-28 19:00:00,2022-09-28 20:00:00,97,0,143,0,0,1140,1380,19141
2022-09-28 20:00:00,2022-09-28 21:00:00,96,0,141,0,0,1162,1399,17772
2022-09-28 21:00:00,2022-09-28 22:00:00,96,0,116,0,0,1210,1422,16737
2022-09-28 22:00:00,2022-09-28 23:00:00,96,0,112,0,0,1193,1401,16170
2022-09-28 23:00:00,2022-09-29 00:00:00,96,0,112,0,0,1181,1389,15914
2022-09-29 00:00:00,2022-09-29 01:00:00,96,0,112,0,0,1100,1308,16015
2022-09-29 01:00:00,2022-09-29 02:00:00,97,0,112,0,0,984,1193,16248
2022-09-29 02:00:00,2022-09-29 03:00:00,96,0,112,0,0,872,1080,17074
2022-09-29 03:00:00,2022-09-29 04:00:00,96,10,125,0,15,818,1064,19411
2022-09-29 04:00:00,2022-09-29 05:00:00,96,439,129,38,196,741,1639,21243
2022-09-29 05:00:00,2022-09-29 06:00:00,93,479,159,43,742,591,2107,22186
2022-09-29 06:00:00,2022-09-29 07:00:00,82,280,170,5,1561,502,2600,22518
2022-09-29 07:00:00,2022-09-29 08:00:00,82,17,155,0,2455,453,3162,22240
2022-09-29 08:00:00,2022-09-29 09:00:00,82,0,152,0,3067,428,3729,22337
2022-09-29 09:00:00,2022-09-29 10:00:00,82,0,133,0,3145,412,3772,22176
2022-09-29 10:00:00,2022-09-29 11:00:00,82,0,122,0,3306,367,3877,22181
2022-09-29 11:00:00,2022-09-29 12:00:00,81,0,122,0,2801,359,3363,21596
2022-09-29 12:00:00,2022-09-29 13:00:00,82,0,122,0,2221,344,2769,21618
2022-09-29 13:00:00,2022-09-29 14:00:00,81,0,125,0,1501,293,2000,21600
2022-09-29 14:00:00,2022-09-29 15:00:00,86,88,134,0,713,274,1295,21658
2022-09-29 15:00:00,2022-09-29 16:00:00,97,415,148,38,111,322,1131,22051
2022-09-29 16:00:00,2022-09-29 17:00:00,96,902,159,43,0,430,1630,23028
2022-09-29 17:00:00,2022-09-29 18:00:00,96,762,175,43,0,610,1686,22497
2022-09-29 18:00:00,2022-09-29 19:00:00,97,172,156,5,0,688,1118,20930
2022-09-29 19:00:00,2022-09-29 20:00:00,96,0,141,0,0,686,923,19395
2022-09-29 20:00:00,2022-09-29 21:00:00,96,0,138,0,0,721,955,17984
2022-09-29 21:00:00,2022-09-29 22:00:00,97,0,122,0,0,727,946,16839
2022-09-29 22:00:00,2022-09-29 23:00:00,96,0,119,0,0,655,870,16291
2022-09-29 23:00:00,2022-09-30 00:00:00,97,0,116,0,0,595,808,15997
2022-09-30 00:00:00,2022-09-30 01:00:00,97,0,115,0,0,507,719,15975
2022-09-30 01:00:00,2022-09-30 02:00:00,97,0,115,0,0,418,630,16358
2022-09-30 02:00:00,2022-09-30 03:00:00,97,7,115,0,0,338,557,17133
2022-09-30 03:00:00,2022-09-30 04:00:00,97,76,129,38,22,321,683,19563
2022-09-30 04:00:00,2022-09-30 05:00:00,97,655,133,43,318,292,1538,21431
2022-09-30 05:00:00,2022-09-30 06:00:00,96,636,170,43,1135,265,2345,22284
2022-09-30 06:00:00,2022-09-30 07:00:00,96,439,185,43,1979,239,2981,22427
2022-09-30 07:00:00,2022-09-30 08:00:00,96,44,165,5,2559,132,3001,22147
2022-09-30 08:00:00,2022-09-30 09:00:00,96,43,153,0,2856,113,3261,22285
2022-09-30 09:00:00,2022-09-30 10:00:00,96,20,139,0,3002,122,3379,22298
2022-09-30 10:00:00,2022-09-30 11:00:00,97,28,131,0,2919,130,3305,22266
2022-09-30 11:00:00,2022-09-30 12:00:00,97,0,131,0,2477,138,2843,21774
2022-09-30 12:00:00,2022-09-30 13:00:00,97,0,132,0,2087,180,2496,21828
2022-09-30 13:00:00,2022-09-30 14:00:00,96,228,145,0,1310,190,1969,21708
2022-09-30 14:00:00,2022-09-30 15:00:00,97,637,158,0,528,178,1598,21635
2022-09-30 15:00:00,2022-09-30 16:00:00,96,818,187,38,80,304,1523,22051
2022-09-30 16:00:00,2022-09-30 17:00:00,96,1220,196,43,0,573,2128,22734
2022-09-30 17:00:00,2022-09-30 18:00:00,96,848,196,43,0,960,2143,21993
2022-09-30 18:00:00,2022-09-30 19:00:00,96,128,171,5,0,1602,2002,20494
2022-09-30 19:00:00,2022-09-30 20:00:00,96,0,160,0,0,2115,2371,18942
2022-09-30 20:00:00,2022-09-30 21:00:00,96,0,148,0,0,2167,2411,17581
2022-09-30 21:00:00,2022-09-30 22:00:00,90,0,131,0,0,2060,2281,16450
2022-09-30 22:00:00,2022-09-30 23:00:00,77,0,129,0,0,2017,2223,15744
2022-09-30 23:00:00,2022-10-01 00:00:00,77,0,129,0,0,2118,2324,15327
2022-10-01 00:00:00,2022-10-01 01:00:00,77,0,129,0,0,2240,2446,15170
2022-10-01 01:00:00,2022-10-01 02:00:00,77,0,129,0,0,2309,2515,15282
2022-10-01 02:00:00,2022-10-01 03:00:00,77,0,130,0,0,2272,2479,15300
2022-10-01 03:00:00,2022-10-01 04:00:00,77,0,143,0,16,2259,2495,15904
2022-10-01 04:00:00,2022-10-01 05:00:00,85,0,153,38,381,2319,2976,16960
2022-10-01 05:00:00,2022-10-01 06:00:00,96,145,167,43,1463,1933,3847,18429
2022-10-01 06:00:00,2022-10-01 07:00:00,85,419,175,43,2491,1384,4597,19090
2022-10-01 07:00:00,2022-10-01 08:00:00,77,249,175,5,3150,1342,4998,19133
2022-10-01 08:00:00,2022-10-01 09:00:00,76,45,163,0,3480,1699,5463,19116
2022-10-01 09:00:00,2022-10-01 10:00:00,77,0,143,0,3190,2175,5585,18783
2022-10-01 10:00:00,2022-10-01 11:00:00,77,0,141,0,2578,2636,5432,18658
2022-10-01 11:00:00,2022-10-01 12:00:00,77,0,140,0,1960,2902,5079,18479
2022-10-01 12:00:00,2022-10-01 13:00:00,77,0,139,0,1369,2906,4491,18525
2022-10-01 13:00:00,2022-10-01 14:00:00,84,23,149,0,688,3001,3945,18538
2022-10-01 14:00:00,2022-10-01 15:00:00,97,741,159,38,316,3063,4414,18557
2022-10-01 15:00:00,2022-10-01 16:00:00,96,1021,164,43,59,3033,4416,19102
2022-10-01 16:00:00,2022-10-01 17:00:00,96,1139,167,43,0,3098,4543,19640
2022-10-01 17:00:00,2022-10-01 18:00:00,97,1080,169,43,0,3142,4531,18941
2022-10-01 18:00:00,2022-10-01 19:00:00,96,874,176,5,0,2936,4087,17895
2022-10-01 19:00:00,2022-10-01 20:00:00,84,525,169,0,0,2822,3600,16820
2022-10-01 20:00:00,2022-10-01 21:00:00,76,123,143,0,0,3020,3362,15633
2022-10-01 21:00:00,2022-10-01 22:00:00,77,209,119,0,0,3367,3772,14659
2022-10-01 22:00:00,2022-10-01 23:00:00,77,110,116,0,0,3483,3786,13842
2022-10-01 23:00:00,2022-10-02 00:00:00,77,0,116,0,0,3843,4036,13551
2022-10-02 00:00:00,2022-10-02 01:00:00,77,0,116,0,0,4198,4391,13385
2022-10-02 01:00:00,2022-10-02 02:00:00,76,50,116,0,0,4339,4581,13348
2022-10-02 02:00:00,2022-10-02 03:00:00,77,134,116,0,0,4591,4918,13538
2022-10-02 03:00:00,2022-10-02 04:00:00,76,134,130,0,13,4658,5011,13707
2022-10-02 04:00:00,2022-10-02 05:00:00,75,83,135,0,160,4637,5090,14291
2022-10-02 05:00:00,2022-10-02 06:00:00,75,0,147,38,780,4738,5778,15452
2022-10-02 06:00:00,2022-10-02 07:00:00,75,0,154,43,1642,4723,6637,16265
2022-10-02 07:00:00,2022-10-02 08:00:00,73,0,145,5,2569,4832,7624,16851
2022-10-02 08:00:00,2022-10-02 09:00:00,67,0,141,0,3031,4995,8234,16874
2022-10-02 09:00:00,2022-10-02 10:00:00,70,0,140,0,3239,4848,8297,16739
2022-10-02 10:00:00,2022-10-02 11:00:00,71,0,138,0,3100,4768,8077,16784
2022-10-02 11:00:00,2022-10-02 12:00:00,67,0,126,0,2919,4415,7527,16331
2022-10-02 12:00:00,2022-10-02 13:00:00,67,17,131,0,2577,3989,6781,16194
2022-10-02 13:00:00,2022-10-02 14:00:00,67,445,150,0,1631,3704,5997,16212
2022-10-02 14:00:00,2022-10-02 15:00:00,67,851,162,0,616,3556,5252,16715
2022-10-02 15:00:00,2022-10-02 16:00:00,67,883,172,38,109,3491,4760,17549
2022-10-02 16:00:00,2022-10-02 17:00:00,67,771,176,43,0,3988,5045,18477
2022-10-02 17:00:00,2022-10-02 18:00:00,67,281,175,43,0,4487,5053,18149
2022-10-02 18:00:00,2022-10-02 19:00:00,67,17,165,43,0,4875,5167,17296
2022-10-02 19:00:00,2022-10-02 20:00:00,67,11,135,43,0,5295,5551,16443
2022-10-02 20:00:00,2022-10-02 21:00:00,68,1,122,5,0,5551,5747,15433
2022-10-02 21:00:00,2022-10-02 22:00:00,76,0,120,0,0,5689,5885,14653
2022-10-02 22:00:00,2022-10-02 23:00:00,77,0,121,0,0,5889,6087,14208
2022-10-02 23:00:00,2022-10-03 00:00:00,76,0,121,0,0,5931,6128,13991
2022-10-03 00:00:00,2022-10-03 01:00:00,77,0,121,0,0,6049,6247,14038
2022-10-03 01:00:00,2022-10-03 02:00:00,76,0,121,0,0,6180,6377,14531
2022-10-03 02:00:00,2022-10-03 03:00:00,77,0,121,0,0,6342,6540,15676
2022-10-03 03:00:00,2022-10-03 04:00:00,77,0,121,38,6,6338,6580,18488
2022-10-03 04:00:00,2022-10-03 05:00:00,68,74,123,43,109,6305,6722,20461
2022-10-03 05:00:00,2022-10-03 06:00:00,67,241,127,43,511,6355,7344,21650
2022-10-03 06:00:00,2022-10-03 07:00:00,67,452,126,43,1068,6233,7989,22028
2022-10-03 07:00:00,2022-10-03 08:00:00,67,77,126,5,1572,6306,8153,21995
2022-10-03 08:00:00,2022-10-03 09:00:00,67,10,125,0,2084,6161,8447,22209
2022-10-03 09:00:00,2022-10-03 10:00:00,67,0,127,0,2335,6278,8807,22236
2022-10-03 10:00:00,2022-10-03 11:00:00,67,0,127,0,2503,6323,9020,22125
2022-10-03 11:00:00,2022-10-03 12:00:00,67,0,121,0,2434,6230,8852,21450
2022-10-03 12:00:00,2022-10-03 13:00:00,67,0,124,0,1968,5975,8134,21165
2022-10-03 13:00:00,2022-10-03 14:00:00,67,0,139,0,1349,5567,7122,21192
2022-10-03 14:00:00,2022-10-03 15:00:00,68,17,150,0,432,5166,5833,21263
2022-10-03 15:00:00,2022-10-03 16:00:00,77,551,170,38,45,4888,5769,22044
2022-10-03 16:00:00,2022-10-03 17:00:00,77,930,186,43,0,4739,5975,22901
2022-10-03 17:00:00,2022-10-03 18:00:00,77,625,192,43,0,4775,5712,22301
2022-10-03 18:00:00,2022-10-03 19:00:00,77,341,193,43,0,5005,5659,20829
2022-10-03 19:00:00,2022-10-03 20:00:00,76,34,154,5,0,5060,5329,19042
2022-10-03 20:00:00,2022-10-03 21:00:00,77,0,144,0,0,4844,5065,17635
2022-10-03 21:00:00,2022-10-03 22:00:00,77,0,140,0,0,4694,4911,16709
2022-10-03 22:00:00,2022-10-03 23:00:00,77,0,139,0,0,4633,4849,16217
2022-10-03 23:00:00,2022-10-04 00:00:00,77,0,139,0,0,4399,4615,15837
2022-10-04 00:00:00,2022-10-04 01:00:00,77,0,139,0,0,4446,4662,15944
2022-10-04 01:00:00,2022-10-04 02:00:00,77,0,139,0,0,4440,4656,16126
2022-10-04 02:00:00,2022-10-04 03:00:00,77,0,139,0,0,4388,4604,16948
2022-10-04 03:00:00,2022-10-04 04:00:00,85,0,139,38,3,4306,4571,19421
2022-10-04 04:00:00,2022-10-04 05:00:00,96,70,134,43,201,4054,4598,21181
2022-10-04 05:00:00,2022-10-04 06:00:00,96,77,151,43,849,3515,4731,21998
2022-10-04 06:00:00,2022-10-04 07:00:00,85,234,159,43,1623,3335,5479,22355
2022-10-04 07:00:00,2022-10-04 08:00:00,69,63,163,5,2302,3345,5947,21820
2022-10-04 08:00:00,2022-10-04 09:00:00,68,5,163,0,3034,3235,6505,22001
2022-10-04 09:00:00,2022-10-04 10:00:00,68,0,149,0,3711,3196,7124,22068
2022-10-04 10:00:00,2022-10-04 11:00:00,68,0,147,0,3899,3217,7331,21823
2022-10-04 11:00:00,2022-10-04 12:00:00,68,0,146,0,3657,3006,6877,21405
2022-10-04 12:00:00,2022-10-04 13:00:00,75,0,143,38,3160,2697,6113,21476
2022-10-04 13:00:00,2022-10-04 14:00:00,97,0,143,43,2083,2142,4508,21380
2022-10-04 14:00:00,2022-10-04 15:00:00,96,96,143,43,755,1628,2761,21448
2022-10-04 15:00:00,2022-10-04 16:00:00,96,694,151,43,57,1541,2582,22169
2022-10-04 16:00:00,2022-10-04 17:00:00,96,985,188,43,0,1856,3168,23098
2022-10-04 17:00:00,2022-10-04 18:00:00,96,779,193,43,0,2238,3349,22574
2022-10-04 18:00:00,2022-10-04 19:00:00,96,185,193,43,0,2542,3059,21054
2022-10-04 19:00:00,2022-10-04 20:00:00,96,10,161,43,0,2793,3103,19318
2022-10-04 20:00:00,2022-10-04 21:00:00,86,0,156,5,0,3187,3434,17993
2022-10-04 21:00:00,2022-10-04 22:00:00,77,0,143,0,0,3305,3525,16895
2022-10-04 22:00:00,2022-10-04 23:00:00,77,0,144,0,0,3265,3486,16311
2022-10-04 23:00:00,2022-10-05 00:00:00,76,0,147,0,0,3319,3542,15976
2022-10-05 00:00:00,2022-10-05 01:00:00,77,0,147,0,0,3321,3545,16007
2022-10-05 01:00:00,2022-10-05 02:00:00,77,0,147,0,0,3437,3661,16238
2022-10-05 02:00:00,2022-10-05 03:00:00,84,1,147,0,0,3701,3933,17168
2022-10-05 03:00:00,2022-10-05 04:00:00,96,70,146,38,4,3916,4270,19728
2022-10-05 04:00:00,2022-10-05 05:00:00,96,86,151,43,279,3909,4564,21362
2022-10-05 05:00:00,2022-10-05 06:00:00,96,77,151,43,1230,3629,5226,22076
2022-10-05 06:00:00,2022-10-05 07:00:00,84,74,151,43,2403,2819,5574,22126
2022-10-05 07:00:00,2022-10-05 08:00:00,77,94,175,43,3267,2336,5992,21768
2022-10-05 08:00:00,2022-10-05 09:00:00,77,255,179,43,3549,2219,6322,21728
2022-10-05 09:00:00,2022-10-05 10:00:00,77,288,166,5,3610,2338,6484,21619
2022-10-05 10:00:00,2022-10-05 11:00:00,77,219,160,0,3641,2587,6684,21772
2022-10-05 11:00:00,2022-10-05 12:00:00,77,0,159,0,3018,2470,5724,21331
2022-10-05 12:00:00,2022-10-05 13:00:00,77,0,159,38,2319,2543,5136,21429
2022-10-05 13:00:00,2022-10-05 14:00:00,77,7,169,43,1378,2544,4218,21339
2022-10-05 14:00:00,2022-10-05 15:00:00,77,74,170,43,520,2813,3697,21456
2022-10-05 15:00:00,2022-10-05 16:00:00,84,590,189,43,79,3651,4636,22326
2022-10-05 16:00:00,2022-10-05 17:00:00,96,748,194,43,0,4479,5560,23117
2022-10-05 17:00:00,2022-10-05 18:00:00,84,621,189,43,0,4860,5797,22500
2022-10-05 18:00:00,2022-10-05 19:00:00,76,571,187,43,0,5109,5986,20857
2022-10-05 19:00:00,2022-10-05 20:00:00,77,241,166,43,0,5242,5769,19213
2022-10-05 20:00:00,2022-10-05 21:00:00,76,195,163,5,0,5440,5879,17949
2022-10-05 21:00:00,2022-10-05 22:00:00,77,102,150,0,0,5502,5831,16973
2022-10-05 22:00:00,2022-10-05 23:00:00,77,7,149,0,0,5503,5736,16236
2022-10-05 23:00:00,2022-10-06 00:00:00,77,0,149,0,0,5711,5937,16052
2022-10-06 00:00:00,2022-10-06 01:00:00,76,0,149,0,0,5927,6152,16177
2022-10-06 01:00:00,2022-10-06 02:00:00,77,0,149,0,0,5848,6074,16383
2022-10-06 02:00:00,2022-10-06 03:00:00,77,0,149,38,0,5800,6064,17098
2022-10-06 03:00:00,2022-10-06 04:00:00,77,50,148,43,6,5874,6198,19633
2022-10-06 04:00:00,2022-10-06 05:00:00,77,107,145,43,411,5666,6449,21253
2022-10-06 05:00:00,2022-10-06 06:00:00,77,10,167,43,1696,5283,7276,22112
2022-10-06 06:00:00,2022-10-06 07:00:00,77,0,176,43,2897,5234,8427,22313
2022-10-06 07:00:00,2022-10-06 08:00:00,76,0,165,5,3414,5268,8928,21556
2022-10-06 08:00:00,2022-10-06 09:00:00,68,0,158,0,3818,5364,9408,21540
2022-10-06 09:00:00,2022-10-06 10:00:00,68,0,152,0,4187,5492,9899,21752
2022-10-06 10:00:00,2022-10-06 11:00:00,68,0,157,0,4268,5380,9873,22040
2022-10-06 11:00:00,2022-10-06 12:00:00,68,0,154,0,3932,5127,9281,21501
2022-10-06 12:00:00,2022-10-06 13:00:00,68,50,153,38,3288,4793,8390,21645
2022-10-06 13:00:00,2022-10-06 14:00:00,68,17,151,43,2025,4143,6447,21491
2022-10-06 14:00:00,2022-10-06 15:00:00,68,297,162,43,682,3081,4333,21460
2022-10-06 15:00:00,2022-10-06 16:00:00,74,802,181,43,70,2841,4011,22386
2022-10-06 16:00:00,2022-10-06 17:00:00,87,1070,187,43,0,3043,4430,23190
2022-10-06 17:00:00,2022-10-06 18:00:00,75,728,187,43,0,3239,4272,22637
2022-10-06 18:00:00,2022-10-06 19:00:00,68,257,177,43,0,3382,3927,21077
2022-10-06 19:00:00,2022-10-06 20:00:00,68,12,167,43,0,3213,3503,19389
2022-10-06 20:00:00,2022-10-06 21:00:00,68,0,166,43,0,2934,3211,18120
2022-10-06 21:00:00,2022-10-06 22:00:00,75,0,162,5,0,2609,2851,17040
2022-10-06 22:00:00,2022-10-06 23:00:00,77,0,162,0,0,2224,2463,16565
2022-10-06 23:00:00,2022-10-07 00:00:00,76,0,162,0,0,1899,2137,16215
2022-10-07 00:00:00,2022-10-07 01:00:00,77,0,162,0,0,1777,2016,16228
2022-10-07 01:00:00,2022-10-07 02:00:00,77,0,162,0,0,1884,2123,16586
2022-10-07 02:00:00,2022-10-07 03:00:00,84,0,162,0,0,1929,2175,17388
2022-10-07 03:00:00,2022-10-07 04:00:00,96,118,161,38,9,2066,2488,19795
2022-10-07 04:00:00,2022-10-07 05:00:00,96,368,173,43,472,2289,3441,21443
2022-10-07 05:00:00,2022-10-07 06:00:00,80,401,188,43,2190,2255,5157,22200
2022-10-07 06:00:00,2022-10-07 07:00:00,72,140,194,43,4059,1550,6058,22037
2022-10-07 07:00:00,2022-10-07 08:00:00,64,0,192,5,5295,1095,6651,21327
2022-10-07 08:00:00,2022-10-07 09:00:00,63,0,191,0,5974,1668,7896,21174
2022-10-07 09:00:00,2022-10-07 10:00:00,63,0,170,0,6302,2473,9008,21054
2022-10-07 10:00:00,2022-10-07 11:00:00,65,0,165,0,6115,2252,8597,20872
2022-10-07 11:00:00,2022-10-07 12:00:00,65,0,167,0,5469,1772,7473,20622
2022-10-07 12:00:00,2022-10-07 13:00:00,65,0,167,38,4302,1549,6121,21006
2022-10-07 13:00:00,2022-10-07 14:00:00,73,17,177,43,2560,1385,4255,21258
2022-10-07 14:00:00,2022-10-07 15:00:00,87,357,181,43,734,1330,2732,21244
2022-10-07 15:00:00,2022-10-07 16:00:00,96,523,199,43,101,1967,2929,21989
2022-10-07 16:00:00,2022-10-07 17:00:00,97,485,210,43,0,2787,3622,22485
2022-10-07 17:00:00,2022-10-07 18:00:00,86,172,208,43,0,3194,3703,21760
2022-10-07 18:00:00,2022-10-07 19:00:00,77,10,190,43,0,3463,3783,20251
2022-10-07 19:00:00,2022-10-07 20:00:00,77,0,185,43,0,3526,3831,18878
2022-10-07 20:00:00,2022-10-07 21:00:00,76,0,184,5,0,3397,3662,17647
2022-10-07 21:00:00,2022-10-07 22:00:00,77,0,156,0,0,3072,3305,16535
2022-10-07 22:00:00,2022-10-07 23:00:00,77,0,152,0,0,2839,3068,15741
2022-10-07 23:00:00,2022-10-08 00:00:00,77,0,152,0,0,2852,3081,15482
2022-10-08 00:00:00,2022-10-08 01:00:00,76,0,152,0,0,2820,3048,15422
2022-10-08 01:00:00,2022-10-08 02:00:00,77,0,152,0,0,2680,2909,15466
2022-10-08 02:00:00,2022-10-08 03:00:00,77,0,152,0,0,2590,2819,15643
2022-10-08 03:00:00,2022-10-08 04:00:00,75,0,151,0,8,2519,2753,16345
2022-10-08 04:00:00,2022-10-08 05:00:00,64,0,148,38,324,2399,2973,17227
2022-10-08 05:00:00,2022-10-08 06:00:00,63,0,143,43,1458,2319,4026,18528
2022-10-08 06:00:00,2022-10-08 07:00:00,63,0,146,43,2905,1732,4889,19108
2022-10-08 07:00:00,2022-10-08 08:00:00,64,0,131,5,3906,1225,5331,19128
2022-10-08 08:00:00,2022-10-08 09:00:00,65,0,121,0,4368,1469,6023,19159
2022-10-08 09:00:00,2022-10-08 10:00:00,65,0,123,0,4358,2156,6702,19038
2022-10-08 10:00:00,2022-10-08 11:00:00,65,0,134,0,3725,2742,6666,18780
2022-10-08 11:00:00,2022-10-08 12:00:00,65,0,143,0,2782,2830,5820,18204
2022-10-08 12:00:00,2022-10-08 13:00:00,65,7,143,0,1985,2739,4939,18291
2022-10-08 13:00:00,2022-10-08 14:00:00,65,87,153,38,1157,2615,4115,18422
2022-10-08 14:00:00,2022-10-08 15:00:00,65,518,158,43,405,2506,3695,18618
2022-10-08 15:00:00,2022-10-08 16:00:00,65,958,162,43,98,2811,4137,19489
2022-10-08 16:00:00,2022-10-08 17:00:00,65,1171,162,43,0,3118,4559,19768
2022-10-08 17:00:00,2022-10-08 18:00:00,65,807,167,43,0,3396,4478,19192
2022-10-08 18:00:00,2022-10-08 19:00:00,65,159,168,43,0,3725,4160,18144
2022-10-08 19:00:00,2022-10-08 20:00:00,65,0,165,43,0,3708,3981,16963
2022-10-08 20:00:00,2022-10-08 21:00:00,65,0,154,5,0,3645,3869,15699
2022-10-08 21:00:00,2022-10-08 22:00:00,65,0,128,0,0,3658,3851,14733
2022-10-08 22:00:00,2022-10-08 23:00:00,65,0,126,0,0,3638,3829,14147
2022-10-08 23:00:00,2022-10-09 00:00:00,65,0,125,0,0,3458,3648,13830
2022-10-09 00:00:00,2022-10-09 01:00:00,65,0,125,0,0,3491,3681,13566
2022-10-09 01:00:00,2022-10-09 02:00:00,65,0,125,0,0,3378,3568,13576
2022-10-09 02:00:00,2022-10-09 03:00:00,64,0,126,0,0,3056,3246,13712
2022-10-09 03:00:00,2022-10-09 04:00:00,64,0,135,0,8,2850,3057,14192
2022-10-09 04:00:00,2022-10-09 05:00:00,63,0,139,0,252,2504,2958,14594
2022-10-09 05:00:00,2022-10-09 06:00:00,63,132,147,38,1123,2036,3539,15595
2022-10-09 06:00:00,2022-10-09 07:00:00,63,99,158,43,2212,1386,3961,16428
2022-10-09 07:00:00,2022-10-09 08:00:00,63,0,155,5,3159,1083,4465,16581
2022-10-09 08:00:00,2022-10-09 09:00:00,63,0,145,0,4045,1119,5372,16711
2022-10-09 09:00:00,2022-10-09 10:00:00,63,0,130,0,4524,976,5693,16736
2022-10-09 10:00:00,2022-10-09 11:00:00,63,0,130,0,4651,837,5681,16943
2022-10-09 11:00:00,2022-10-09 12:00:00,63,0,135,0,4164,744,5106,16477
2022-10-09 12:00:00,2022-10-09 13:00:00,63,0,135,0,3597,615,4410,16375
2022-10-09 13:00:00,2022-10-09 14:00:00,68,40,135,0,2157,467,2867,16491
2022-10-09 14:00:00,2022-10-09 15:00:00,73,408,150,38,749,330,1748,17195
2022-10-09 15:00:00,2022-10-09 16:00:00,62,754,168,43,88,340,1455,18552
2022-10-09 16:00:00,2022-10-09 17:00:00,62,1009,169,43,0,471,1754,19274
2022-10-09 17:00:00,2022-10-09 18:00:00,62,842,171,43,0,636,1754,18833
2022-10-09 18:00:00,2022-10-09 19:00:00,62,444,169,43,0,857,1575,17819
2022-10-09 19:00:00,2022-10-09 20:00:00,62,0,139,43,0,1365,1609,16785
2022-10-09 20:00:00,2022-10-09 21:00:00,62,0,137,5,0,1990,2194,15715
2022-10-09 21:00:00,2022-10-09 22:00:00,62,0,128,0,0,2624,2814,14956
2022-10-09 22:00:00,2022-10-09 23:00:00,62,0,128,0,0,2925,3115,14596
2022-10-09 23:00:00,2022-10-10 00:00:00,62,0,127,0,0,3089,3278,14498
2022-10-10 00:00:00,2022-10-10 01:00:00,62,0,127,0,0,3308,3497,14576
2022-10-10 01:00:00,2022-10-10 02:00:00,62,0,127,0,0,3605,3794,14970
2022-10-10 02:00:00,2022-10-10 03:00:00,62,0,128,0,0,3748,3938,16123
2022-10-10 03:00:00,2022-10-10 04:00:00,62,125,138,38,3,4028,4394,19119
2022-10-10 04:00:00,2022-10-10 05:00:00,62,549,144,43,399,4352,5549,21188
2022-10-10 05:00:00,2022-10-10 06:00:00,62,173,155,43,2073,4229,6735,22042
2022-10-10 06:00:00,2022-10-10 07:00:00,62,0,149,5,4005,3279,7500,21811
2022-10-10 07:00:00,2022-10-10 08:00:00,62,0,145,0,5290,3093,8590,21070
2022-10-10 08:00:00,2022-10-10 09:00:00,62,0,142,0,5966,3415,9585,20971
2022-10-10 09:00:00,2022-10-10 10:00:00,62,0,139,0,6026,3454,9681,20854
2022-10-10 10:00:00,2022-10-10 11:00:00,62,0,138,0,5635,3531,9366,20976
2022-10-10 11:00:00,2022-10-10 12:00:00,62,0,138,0,4734,3724,8658,20565
2022-10-10 12:00:00,2022-10-10 13:00:00,62,0,138,0,3549,3799,7548,21020
2022-10-10 13:00:00,2022-10-10 14:00:00,63,14,153,0,2019,3713,5962,21240
2022-10-10 14:00:00,2022-10-10 15:00:00,75,466,154,38,530,3793,5056,21285
2022-10-10 15:00:00,2022-10-10 16:00:00,77,806,171,43,20,4384,5501,22271
2022-10-10 16:00:00,2022-10-10 17:00:00,77,789,178,43,0,4788,5875,22955
2022-10-10 17:00:00,2022-10-10 18:00:00,73,591,179,43,0,4965,5851,22297
2022-10-10 18:00:00,2022-10-10 19:00:00,72,126,182,5,0,4877,5262,20788
2022-10-10 19:00:00,2022-10-10 20:00:00,74,0,153,0,0,4786,5013,19155
2022-10-10 20:00:00,2022-10-10 21:00:00,73,0,136,0,0,4631,4840,17866
2022-10-10 21:00:00,2022-10-10 22:00:00,68,0,140,0,0,4362,4570,16856
2022-10-10 22:00:00,2022-10-10 23:00:00,67,0,140,0,0,4266,4473,16410
2022-10-10 23:00:00,2022-10-11 00:00:00,67,0,138,0,0,4362,4567,16109
2022-10-11 00:00:00,2022-10-11 01:00:00,67,0,139,0,0,4393,4599,16152
2022-10-11 01:00:00,2022-10-11 02:00:00,67,0,138,0,0,4301,4506,16599
2022-10-11 02:00:00,2022-10-11 03:00:00,75,0,139,0,0,3918,4132,17416
2022-10-11 03:00:00,2022-10-11 04:00:00,96,17,140,0,3,3621,3877,19935
2022-10-11 04:00:00,2022-10-11 05:00:00,96,144,143,0,228,3417,4028,21537
2022-10-11 05:00:00,2022-10-11 06:00:00,96,252,152,0,1249,2860,4609,22417
2022-10-11 06:00:00,2022-10-11 07:00:00,97,74,157,0,2505,2398,5231,22477
2022-10-11 07:00:00,2022-10-11 08:00:00,97,0,153,0,3315,2341,5906,21965
2022-10-11 08:00:00,2022-10-11 09:00:00,86,0,154,0,3872,2603,6715,21959
2022-10-11 09:00:00,2022-10-11 10:00:00,88,0,154,0,4162,2900,7304,21952
2022-10-11 10:00:00,2022-10-11 11:00:00,87,0,154,0,4140,2992,7373,21718
2022-10-11 11:00:00,2022-10-11 12:00:00,91,0,153,0,3701,3022,6967,21239
2022-10-11 12:00:00,2022-10-11 13:00:00,91,0,153,0,2837,2801,5882,21186
2022-10-11 13:00:00,2022-10-11 14:00:00,92,0,153,0,1957,2449,4651,21634
2022-10-11 14:00:00,2022-10-11 15:00:00,92,162,171,38,483,1704,2650,21827
2022-10-11 15:00:00,2022-10-11 16:00:00,96,1011,182,43,14,1594,2940,22854
2022-10-11 16:00:00,2022-10-11 17:00:00,97,1075,189,43,0,1869,3273,23410
2022-10-11 17:00:00,2022-10-11 18:00:00,96,991,198,43,0,2043,3371,22835
2022-10-11 18:00:00,2022-10-11 19:00:00,96,387,189,43,0,2103,2818,21185
2022-10-11 19:00:00,2022-10-11 20:00:00,96,27,171,43,0,2045,2382,19699
2022-10-11 20:00:00,2022-10-11 21:00:00,96,0,144,5,0,1985,2230,18381
2022-10-11 21:00:00,2022-10-11 22:00:00,96,0,136,0,0,1794,2026,17403
2022-10-11 22:00:00,2022-10-11 23:00:00,97,0,136,0,0,1602,1835,16933
2022-10-11 23:00:00,2022-10-12 00:00:00,96,0,136,0,0,1505,1737,16579
2022-10-12 00:00:00,2022-10-12 01:00:00,96,0,136,0,0,1339,1571,16677
2022-10-12 01:00:00,2022-10-12 02:00:00,97,0,136,0,0,1125,1358,16918
2022-10-12 02:00:00,2022-10-12 03:00:00,97,0,136,0,0,933,1166,17702
2022-10-12 03:00:00,2022-10-12 04:00:00,97,100,138,38,3,793,1169,20412
2022-10-12 04:00:00,2022-10-12 05:00:00,97,364,152,43,326,760,1742,21887
2022-10-12 05:00:00,2022-10-12 06:00:00,97,302,165,43,1666,568,2841,22879
2022-10-12 06:00:00,2022-10-12 07:00:00,97,47,178,5,3188,288,3803,22783
2022-10-12 07:00:00,2022-10-12 08:00:00,97,0,164,0,4195,147,4603,21741
2022-10-12 08:00:00,2022-10-12 09:00:00,97,0,164,0,4939,189,5389,21623
2022-10-12 09:00:00,2022-10-12 10:00:00,97,0,162,0,5022,253,5534,21563
2022-10-12 10:00:00,2022-10-12 11:00:00,97,0,162,0,4196,229,4684,21580
2022-10-12 11:00:00,2022-10-12 12:00:00,97,0,148,0,3660,179,4084,21763
2022-10-12 12:00:00,2022-10-12 13:00:00,97,0,143,0,2693,142,3075,21776
2022-10-12 13:00:00,2022-10-12 14:00:00,97,0,143,0,1571,126,1937,21982
2022-10-12 14:00:00,2022-10-12 15:00:00,96,320,154,0,426,149,1145,22073
2022-10-12 15:00:00,2022-10-12 16:00:00,97,1011,173,38,19,248,1586,22917
2022-10-12 16:00:00,2022-10-12 17:00:00,97,1421,176,43,0,395,2132,23421
2022-10-12 17:00:00,2022-10-12 18:00:00,96,808,187,43,0,631,1765,22806
2022-10-12 18:00:00,2022-10-12 19:00:00,96,419,189,43,0,839,1586,21293
2022-10-12 19:00:00,2022-10-12 20:00:00,97,125,179,43,0,989,1433,19759
2022-10-12 20:00:00,2022-10-12 21:00:00,97,0,166,5,0,1291,1559,18429
2022-10-12 21:00:00,2022-10-12 22:00:00,87,0,150,0,0,1534,1771,17340
2022-10-12 22:00:00,2022-10-12 23:00:00,82,0,144,0,0,1702,1928,16771
2022-10-12 23:00:00,2022-10-13 00:00:00,82,0,144,0,0,1871,2097,16424
2022-10-13 00:00:00,2022-10-13 01:00:00,82,0,145,0,0,1866,2093,16400
2022-10-13 01:00:00,2022-10-13 02:00:00,82,0,145,0,0,1848,2075,16802
2022-10-13 02:00:00,2022-10-13 03:00:00,88,0,144,0,0,1929,2161,17678
2022-10-13 03:00:00,2022-10-13 04:00:00,97,30,143,38,4,2180,2492,20240
2022-10-13 04:00:00,2022-10-13 05:00:00,96,96,143,43,252,2390,3020,21750
2022-10-13 05:00:00,2022-10-13 06:00:00,96,112,137,43,1632,2407,4427,22512
2022-10-13 06:00:00,2022-10-13 07:00:00,82,15,132,5,3449,1738,5421,22362
2022-10-13 07:00:00,2022-10-13 08:00:00,62,0,133,0,4707,1198,6100,21577
2022-10-13 08:00:00,2022-10-13 09:00:00,58,0,132,0,5512,1496,7198,21375
2022-10-13 09:00:00,2022-10-13 10:00:00,59,0,132,0,5544,1846,7581,21046
2022-10-13 10:00:00,2022-10-13 11:00:00,58,0,135,0,5319,1762,7274,21170
2022-10-13 11:00:00,2022-10-13 12:00:00,59,0,135,0,4441,1621,6256,20888
2022-10-13 12:00:00,2022-10-13 13:00:00,64,0,136,0,3211,1420,4831,21241
2022-10-13 13:00:00,2022-10-13 14:00:00,87,0,144,0,1681,1233,3145,21564
2022-10-13 14:00:00,2022-10-13 15:00:00,96,161,159,38,320,1356,2130,21791
2022-10-13 15:00:00,2022-10-13 16:00:00,97,565,166,43,17,1998,2886,22742
2022-10-13 16:00:00,2022-10-13 17:00:00,96,601,173,43,0,2833,3746,23217
2022-10-13 17:00:00,2022-10-13 18:00:00,97,310,182,43,0,3208,3840,22544
2022-10-13 18:00:00,2022-10-13 19:00:00,85,211,168,43,0,3202,3709,21002
2022-10-13 19:00:00,2022-10-13 20:00:00,77,0,159,5,0,3050,3291,19436
2022-10-13 20:00:00,2022-10-13 21:00:00,84,0,158,0,0,2795,3037,18035
2022-10-13 21:00:00,2022-10-13 22:00:00,97,0,158,0,0,2364,2619,17152
2022-10-13 22:00:00,2022-10-13 23:00:00,96,0,158,0,0,1981,2235,16621
2022-10-13 23:00:00,2022-10-14 00:00:00,96,0,158,0,0,1676,1930,16326
2022-10-14 00:00:00,2022-10-14 01:00:00,96,0,158,0,0,1507,1761,16313
2022-10-14 01:00:00,2022-10-14 02:00:00,96,0,158,0,0,1460,1714,16699
2022-10-14 02:00:00,2022-10-14 03:00:00,96,0,157,0,0,1442,1695,17594
2022-10-14 03:00:00,2022-10-14 04:00:00,97,0,157,38,5,1366,1663,19994
2022-10-14 04:00:00,2022-10-14 05:00:00,97,178,157,43,200,1294,1969,21683
2022-10-14 05:00:00,2022-10-14 06:00:00,97,527,154,43,980,1094,2895,22680
2022-10-14 06:00:00,2022-10-14 07:00:00,97,322,152,43,2184,702,3500,22788
2022-10-14 07:00:00,2022-10-14 08:00:00,97,89,152,5,3220,321,3884,22230
2022-10-14 08:00:00,2022-10-14 09:00:00,97,56,139,0,4117,225,4634,22288
2022-10-14 09:00:00,2022-10-14 10:00:00,97,0,138,0,4141,285,4661,22093
2022-10-14 10:00:00,2022-10-14 11:00:00,97,0,139,0,3858,362,4456,21913
2022-10-14 11:00:00,2022-10-14 12:00:00,97,17,140,0,3354,337,3945,21896
2022-10-14 12:00:00,2022-10-14 13:00:00,97,118,140,0,2149,339,2843,21861
2022-10-14 13:00:00,2022-10-14 14:00:00,96,0,135,38,1038,408,1715,21902
2022-10-14 14:00:00,2022-10-14 15:00:00,97,299,148,43,263,572,1422,21938
2022-10-14 15:00:00,2022-10-14 16:00:00,96,716,177,43,26,932,1990,22789
2022-10-14 16:00:00,2022-10-14 17:00:00,97,782,181,43,0,1450,2553,22875
2022-10-14 17:00:00,2022-10-14 18:00:00,97,139,150,43,0,2012,2441,22203
2022-10-14 18:00:00,2022-10-14 19:00:00,97,9,139,43,0,2261,2549,20646
2022-10-14 19:00:00,2022-10-14 20:00:00,96,0,138,5,0,2434,2673,19235
2022-10-14 20:00:00,2022-10-14 21:00:00,96,0,130,0,0,2519,2745,17927
2022-10-14 21:00:00,2022-10-14 22:00:00,83,0,126,0,0,2495,2704,16870
2022-10-14 22:00:00,2022-10-14 23:00:00,77,0,126,0,0,2591,2794,16257
2022-10-14 23:00:00,2022-10-15 00:00:00,77,0,126,0,0,2673,2876,15839
2022-10-15 00:00:00,2022-10-15 01:00:00,77,0,126,0,0,2544,2747,15727
2022-10-15 01:00:00,2022-10-15 02:00:00,77,0,126,0,0,2519,2722,15741
2022-10-15 02:00:00,2022-10-15 03:00:00,77,0,126,0,0,2653,2856,15885
2022-10-15 03:00:00,2022-10-15 04:00:00,77,0,125,0,4,2770,2976,16652
2022-10-15 04:00:00,2022-10-15 05:00:00,77,0,124,0,148,2859,3208,17462
2022-10-15 05:00:00,2022-10-15 06:00:00,77,19,125,0,752,2699,3672,18716
2022-10-15 06:00:00,2022-10-15 07:00:00,77,59,125,0,1602,2271,4134,19352
2022-10-15 07:00:00,2022-10-15 08:00:00,77,180,126,0,2297,1935,4615,19422
2022-10-15 08:00:00,2022-10-15 09:00:00,67,49,126,0,2819,1831,4892,19408
2022-10-15 09:00:00,2022-10-15 10:00:00,62,0,129,0,2887,1936,5014,19355
2022-10-15 10:00:00,2022-10-15 11:00:00,62,0,130,0,2486,2134,4812,19135
2022-10-15 11:00:00,2022-10-15 12:00:00,62,0,130,0,1922,2001,4115,18815
2022-10-15 12:00:00,2022-10-15 13:00:00,63,8,134,0,1217,1809,3231,18770
2022-10-15 13:00:00,2022-10-15 14:00:00,76,23,137,0,558,1733,2527,18652
2022-10-15 14:00:00,2022-10-15 15:00:00,77,341,150,38,181,1996,2783,19013
2022-10-15 15:00:00,2022-10-15 16:00:00,86,1048,161,43,20,2344,3702,19809
2022-10-15 16:00:00,2022-10-15 17:00:00,96,943,164,43,0,2683,3929,19835
2022-10-15 17:00:00,2022-10-15 18:00:00,96,299,151,43,0,3030,3619,19176
2022-10-15 18:00:00,2022-10-15 19:00:00,84,9,137,43,0,3178,3451,18095
2022-10-15 19:00:00,2022-10-15 20:00:00,77,37,136,5,0,3185,3440,16984
2022-10-15 20:00:00,2022-10-15 21:00:00,77,0,134,0,0,3295,3506,15764
2022-10-15 21:00:00,2022-10-15 22:00:00,77,0,121,0,0,3262,3460,14741
2022-10-15 22:00:00,2022-10-15 23:00:00,77,0,120,0,0,3210,3407,14129
2022-10-15 23:00:00,2022-10-16 00:00:00,77,0,120,0,0,3185,3382,13867
2022-10-16 00:00:00,2022-10-16 01:00:00,77,0,120,0,0,3117,3314,13630
2022-10-16 01:00:00,2022-10-16 02:00:00,77,0,120,0,0,3148,3345,13646
2022-10-16 02:00:00,2022-10-16 03:00:00,77,0,120,0,0,3077,3274,13787
2022-10-16 03:00:00,2022-10-16 04:00:00,77,0,119,0,4,3105,3305,14268
2022-10-16 04:00:00,2022-10-16 05:00:00,77,0,119,0,134,3031,3361,14548
2022-10-16 05:00:00,2022-10-16 06:00:00,77,0,129,0,762,2870,3838,15544
2022-10-16 06:00:00,2022-10-16 07:00:00,77,0,135,0,1859,2439,4510,16395
2022-10-16 07:00:00,2022-10-16 08:00:00,77,0,129,0,2655,2116,4977,16779
2022-10-16 08:00:00,2022-10-16 09:00:00,77,0,128,0,3053,1890,5148,16705
2022-10-16 09:00:00,2022-10-16 10:00:00,77,0,123,0,3268,1847,5315,16711
2022-10-16 10:00:00,2022-10-16 11:00:00,77,0,120,0,2923,1915,5035,16646
2022-10-16 11:00:00,2022-10-16 12:00:00,77,0,120,0,2575,2050,4822,16589
2022-10-16 12:00:00,2022-10-16 13:00:00,77,0,120,0,1957,1981,4135,16535
2022-10-16 13:00:00,2022-10-16 14:00:00,77,33,124,0,1150,1899,3283,16605
2022-10-16 14:00:00,2022-10-16 15:00:00,77,499,139,38,319,1824,2896,17167
2022-10-16 15:00:00,2022-10-16 16:00:00,77,971,146,43,22,2384,3643,18398
2022-10-16 16:00:00,2022-10-16 17:00:00,76,736,148,43,0,2967,3970,18680
2022-10-16 17:00:00,2022-10-16 18:00:00,77,613,150,43,0,3237,4120,18223
2022-10-16 18:00:00,2022-10-16 19:00:00,77,168,142,43,0,3292,3722,17393
2022-10-16 19:00:00,2022-10-16 20:00:00,77,0,120,5,0,2810,3012,16498
2022-10-16 20:00:00,2022-10-16 21:00:00,77,0,119,0,0,2290,2486,15618
2022-10-16 21:00:00,2022-10-16 22:00:00,77,0,116,0,0,1843,2036,14781
2022-10-16 22:00:00,2022-10-16 23:00:00,77,0,117,0,0,1380,1574,14512
2022-10-16 23:00:00,2022-10-17 00:00:00,77,0,117,0,0,998,1192,14316
2022-10-17 00:00:00,2022-10-17 01:00:00,77,0,117,0,0,854,1048,14389
2022-10-17 01:00:00,2022-10-17 02:00:00,84,0,117,0,0,771,972,14864
2022-10-17 02:00:00,2022-10-17 03:00:00,96,0,117,0,0,794,1007,16011
2022-10-17 03:00:00,2022-10-17 04:00:00,97,204,118,38,1,1007,1465,19227
2022-10-17 04:00:00,2022-10-17 05:00:00,97,547,117,43,167,1307,2278,21052
2022-10-17 05:00:00,2022-10-17 06:00:00,97,395,127,43,1211,1486,3359,21961
2022-10-17 06:00:00,2022-10-17 07:00:00,96,44,143,5,2748,1474,4510,21910
2022-10-17 07:00:00,2022-10-17 08:00:00,84,0,135,0,3958,1050,5227,21340
2022-10-17 08:00:00,2022-10-17 09:00:00,77,0,134,0,4764,795,5770,21418
2022-10-17 09:00:00,2022-10-17 10:00:00,77,0,134,0,5185,837,6233,21292
2022-10-17 10:00:00,2022-10-17 11:00:00,77,0,135,0,5108,1026,6346,21271
2022-10-17 11:00:00,2022-10-17 12:00:00,77,0,135,0,4273,1384,5869,20908
2022-10-17 12:00:00,2022-10-17 13:00:00,77,0,134,0,3164,1612,4987,21307
2022-10-17 13:00:00,2022-10-17 14:00:00,77,0,139,0,1547,2119,3882,21387
2022-10-17 14:00:00,2022-10-17 15:00:00,83,128,148,38,311,3200,3908,21508
2022-10-17 15:00:00,2022-10-17 16:00:00,96,542,152,43,4,4413,5250,22591
2022-10-17 16:00:00,2022-10-17 17:00:00,85,788,153,43,0,5008,6077,22965
2022-10-17 17:00:00,2022-10-17 18:00:00,77,497,144,5,0,5373,6096,22243
2022-10-17 18:00:00,2022-10-17 19:00:00,77,53,142,0,0,5436,5708,20674
2022-10-17 19:00:00,2022-10-17 20:00:00,77,0,138,0,0,5331,5546,18998
2022-10-17 20:00:00,2022-10-17 21:00:00,77,0,137,0,0,5142,5356,17600
2022-10-17 21:00:00,2022-10-17 22:00:00,77,0,126,0,0,4474,4677,16557
2022-10-17 22:00:00,2022-10-17 23:00:00,77,0,120,0,0,3984,4181,16109
2022-10-17 23:00:00,2022-10-18 00:00:00,77,0,120,0,0,3698,3895,15816
2022-10-18 00:00:00,2022-10-18 01:00:00,77,0,120,0,0,3201,3398,15782
2022-10-18 01:00:00,2022-10-18 02:00:00,77,0,120,0,0,2892,3089,16159
2022-10-18 02:00:00,2022-10-18 03:00:00,85,0,120,0,0,2469,2674,17148
2022-10-18 03:00:00,2022-10-18 04:00:00,96,65,120,38,1,2154,2474,19811
2022-10-18 04:00:00,2022-10-18 05:00:00,97,498,136,43,161,1778,2713,21300
2022-10-18 05:00:00,2022-10-18 06:00:00,97,565,143,43,962,1308,3118,22130
2022-10-18 06:00:00,2022-10-18 07:00:00,97,159,146,5,1977,927,3311,22131
2022-10-18 07:00:00,2022-10-18 08:00:00,85,0,132,0,2732,663,3612,21664
2022-10-18 08:00:00,2022-10-18 09:00:00,94,0,129,0,3096,574,3893,21744
2022-10-18 09:00:00,2022-10-18 10:00:00,140,0,122,0,3107,589,3958,21878
2022-10-18 10:00:00,2022-10-18 11:00:00,125,0,121,0,2822,651,3719,21855
2022-10-18 11:00:00,2022-10-18 12:00:00,173,0,120,0,2233,904,3430,21710
2022-10-18 12:00:00,2022-10-18 13:00:00,183,0,120,0,1489,1411,3203,21895
2022-10-18 13:00:00,2022-10-18 14:00:00,211,12,132,0,730,1674,2759,22017
2022-10-18 14:00:00,2022-10-18 15:00:00,224,270,150,38,255,2092,3029,22352
2022-10-18 15:00:00,2022-10-18 16:00:00,226,755,155,43,2,2424,3605,23081
2022-10-18 16:00:00,2022-10-18 17:00:00,226,663,159,43,0,2632,3723,23146
2022-10-18 17:00:00,2022-10-18 18:00:00,224,586,155,5,0,2749,3719,22425
2022-10-18 18:00:00,2022-10-18 19:00:00,211,391,132,0,0,3184,3918,20742
2022-10-18 19:00:00,2022-10-18 20:00:00,206,0,122,0,0,3423,3751,19140
2022-10-18 20:00:00,2022-10-18 21:00:00,206,0,118,0,0,3674,3998,17893
2022-10-18 21:00:00,2022-10-18 22:00:00,215,0,118,0,0,3560,3893,16727
2022-10-18 22:00:00,2022-10-18 23:00:00,227,0,119,0,0,3646,3992,16205
2022-10-18 23:00:00,2022-10-19 00:00:00,227,0,119,0,0,3614,3960,15923
2022-10-19 00:00:00,2022-10-19 01:00:00,223,0,118,0,0,3630,3971,15866
2022-10-19 01:00:00,2022-10-19 02:00:00,222,0,118,0,0,3631,3971,16155
2022-10-19 02:00:00,2022-10-19 03:00:00,225,0,118,0,0,3394,3737,16975
2022-10-19 03:00:00,2022-10-19 04:00:00,226,0,117,0,1,3107,3451,19723
2022-10-19 04:00:00,2022-10-19 05:00:00,224,28,118,0,81,3132,3583,21328
2022-10-19 05:00:00,2022-10-19 06:00:00,226,94,122,0,558,3307,4307,22075
2022-10-19 06:00:00,2022-10-19 07:00:00,230,0,124,0,1306,3284,4944,22212
2022-10-19 07:00:00,2022-10-19 08:00:00,238,0,122,0,1941,3393,5694,22006
2022-10-19 08:00:00,2022-10-19 09:00:00,246,0,123,0,2407,3694,6470,22334
2022-10-19 09:00:00,2022-10-19 10:00:00,245,205,122,0,2753,3652,6977,22671
2022-10-19 10:00:00,2022-10-19 11:00:00,247,110,122,0,2649,3544,6672,22428
2022-10-19 11:00:00,2022-10-19 12:00:00,245,0,120,0,2623,3323,6311,22081
2022-10-19 12:00:00,2022-10-19 13:00:00,246,0,119,0,2187,3189,5741,21974
2022-10-19 13:00:00,2022-10-19 14:00:00,250,0,132,0,1013,2884,4279,21597
2022-10-19 14:00:00,2022-10-19 15:00:00,261,15,151,38,203,2438,3106,21812
2022-10-19 15:00:00,2022-10-19 16:00:00,261,539,157,43,5,2232,3237,22883
2022-10-19 16:00:00,2022-10-19 17:00:00,246,770,163,43,0,2149,3371,23039
2022-10-19 17:00:00,2022-10-19 18:00:00,268,584,151,43,0,1824,2870,22438
2022-10-19 18:00:00,2022-10-19 19:00:00,271,105,143,43,0,1603,2165,20967
2022-10-19 19:00:00,2022-10-19 20:00:00,270,0,140,5,0,1443,1858,19492
2022-10-19 20:00:00,2022-10-19 21:00:00,260,0,140,0,0,1137,1537,18162
2022-10-19 21:00:00,2022-10-19 22:00:00,256,0,137,0,0,931,1324,17065
2022-10-19 22:00:00,2022-10-19 23:00:00,254,0,133,0,0,817,1204,16591
2022-10-19 23:00:00,2022-10-20 00:00:00,254,0,133,0,0,741,1128,16312
2022-10-20 00:00:00,2022-10-20 01:00:00,254,0,134,0,0,706,1094,16350
2022-10-20 01:00:00,2022-10-20 02:00:00,252,0,133,0,0,736,1121,16745
2022-10-20 02:00:00,2022-10-20 03:00:00,257,0,134,0,0,762,1153,17552
2022-10-20 03:00:00,2022-10-20 04:00:00,268,282,133,38,0,829,1550,20368
2022-10-20 04:00:00,2022-10-20 05:00:00,269,546,143,43,139,865,2005,22160
2022-10-20 05:00:00,2022-10-20 06:00:00,267,432,176,43,1188,858,2964,22940
2022-10-20 06:00:00,2022-10-20 07:00:00,256,197,174,5,2755,715,4102,22861
2022-10-20 07:00:00,2022-10-20 08:00:00,255,0,162,0,4095,363,4875,22214
2022-10-20 08:00:00,2022-10-20 09:00:00,227,0,146,0,4915,281,5569,21778
2022-10-20 09:00:00,2022-10-20 10:00:00,253,0,137,0,5353,475,6218,21908
2022-10-20 10:00:00,2022-10-20 11:00:00,252,0,137,0,5168,676,6233,21837
2022-10-20 11:00:00,2022-10-20 12:00:00,255,0,138,0,4659,789,5841,21612
2022-10-20 12:00:00,2022-10-20 13:00:00,254,0,140,0,3518,935,4847,21810
2022-10-20 13:00:00,2022-10-20 14:00:00,258,0,154,0,1730,1029,3171,21907
2022-10-20 14:00:00,2022-10-20 15:00:00,267,231,156,38,288,1354,2334,22242
2022-10-20 15:00:00,2022-10-20 16:00:00,268,770,171,43,5,2181,3438,23173
2022-10-20 16:00:00,2022-10-20 17:00:00,267,762,173,43,0,3066,4311,23294
2022-10-20 17:00:00,2022-10-20 18:00:00,261,845,161,5,0,3738,5010,22835
2022-10-20 18:00:00,2022-10-20 19:00:00,253,764,148,0,0,4168,5333,21223
2022-10-20 19:00:00,2022-10-20 20:00:00,254,218,136,0,0,4368,4976,19607
2022-10-20 20:00:00,2022-10-20 21:00:00,253,17,136,0,0,4528,4934,18284
2022-10-20 21:00:00,2022-10-20 22:00:00,254,0,126,0,0,4691,5071,17331
2022-10-20 22:00:00,2022-10-20 23:00:00,253,0,124,0,0,4687,5064,16758
2022-10-20 23:00:00,2022-10-21 00:00:00,255,0,124,0,0,4529,4908,16365
2022-10-21 00:00:00,2022-10-21 01:00:00,253,0,126,0,0,4417,4796,16449
2022-10-21 01:00:00,2022-10-21 02:00:00,253,0,126,0,0,4093,4472,16803
2022-10-21 02:00:00,2022-10-21 03:00:00,255,0,125,0,0,3806,4186,17709
2022-10-21 03:00:00,2022-10-21 04:00:00,255,0,124,0,0,3550,3929,20271
2022-10-21 04:00:00,2022-10-21 05:00:00,254,2,117,0,153,3377,3903,22023
2022-10-21 05:00:00,2022-10-21 06:00:00,254,12,120,0,879,3211,4476,22623
2022-10-21 06:00:00,2022-10-21 07:00:00,255,21,125,0,1891,2744,5036,22813
2022-10-21 07:00:00,2022-10-21 08:00:00,254,30,123,0,2513,2170,5090,22386
2022-10-21 08:00:00,2022-10-21 09:00:00,255,45,116,0,2762,1799,4977,22580
2022-10-21 09:00:00,2022-10-21 10:00:00,252,51,113,0,2640,1504,4560,22514
2022-10-21 10:00:00,2022-10-21 11:00:00,252,27,115,0,2616,1359,4369,22508
2022-10-21 11:00:00,2022-10-21 12:00:00,261,0,114,0,2229,1280,3884,22133
2022-10-21 12:00:00,2022-10-21 13:00:00,275,90,114,0,1254,1342,3075,22074
2022-10-21 13:00:00,2022-10-21 14:00:00,273,292,125,0,446,1575,2711,22040
2022-10-21 14:00:00,2022-10-21 15:00:00,274,314,126,38,117,2036,2905,22280
2022-10-21 15:00:00,2022-10-21 16:00:00,272,433,143,43,2,2455,3348,22931
2022-10-21 16:00:00,2022-10-21 17:00:00,274,414,145,43,0,2618,3494,22893
2022-10-21 17:00:00,2022-10-21 18:00:00,273,244,136,43,0,2480,3176,22296
2022-10-21 18:00:00,2022-10-21 19:00:00,267,29,130,5,0,2303,2734,20876
2022-10-21 19:00:00,2022-10-21 20:00:00,274,51,122,0,0,2166,2613,19338
2022-10-21 20:00:00,2022-10-21 21:00:00,262,7,112,0,0,1980,2361,18059
2022-10-21 21:00:00,2022-10-21 22:00:00,254,19,117,0,0,1654,2044,16941
2022-10-21 22:00:00,2022-10-21 23:00:00,254,8,118,0,0,1426,1806,16303
2022-10-21 23:00:00,2022-10-22 00:00:00,253,0,118,0,0,1357,1728,16001
2022-10-22 00:00:00,2022-10-22 01:00:00,253,0,118,0,0,1337,1708,15910
2022-10-22 01:00:00,2022-10-22 02:00:00,253,0,118,0,0,1197,1568,15958
2022-10-22 02:00:00,2022-10-22 03:00:00,253,0,118,0,0,1140,1511,16196
2022-10-22 03:00:00,2022-10-22 04:00:00,262,0,117,0,0,964,1343,17028
2022-10-22 04:00:00,2022-10-22 05:00:00,269,0,118,0,73,981,1441,17891
2022-10-22 05:00:00,2022-10-22 06:00:00,192,0,119,0,445,897,1653,19165
2022-10-22 06:00:00,2022-10-22 07:00:00,179,0,130,0,849,775,1933,19921
2022-10-22 07:00:00,2022-10-22 08:00:00,233,39,139,0,1057,721,2189,20338
2022-10-22 08:00:00,2022-10-22 09:00:00,255,29,138,0,1110,639,2171,20669
2022-10-22 09:00:00,2022-10-22 10:00:00,254,124,128,0,956,611,2073,20634
2022-10-22 10:00:00,2022-10-22 11:00:00,254,134,120,0,737,700,1945,20429
2022-10-22 11:00:00,2022-10-22 12:00:00,255,102,120,0,551,826,1854,19893
2022-10-22 12:00:00,2022-10-22 13:00:00,254,3,121,0,409,981,1768,19696
2022-10-22 13:00:00,2022-10-22 14:00:00,260,16,132,0,226,1200,1834,19621
2022-10-22 14:00:00,2022-10-22 15:00:00,275,306,132,38,78,1291,2120,19800
2022-10-22 15:00:00,2022-10-22 16:00:00,273,637,145,43,3,1357,2458,20495
2022-10-22 16:00:00,2022-10-22 17:00:00,273,679,161,43,0,1475,2631,20366
2022-10-22 17:00:00,2022-10-22 18:00:00,275,96,151,43,0,1615,2180,19648
2022-10-22 18:00:00,2022-10-22 19:00:00,261,0,144,5,0,1837,2247,18467
2022-10-22 19:00:00,2022-10-22 20:00:00,254,0,123,0,0,1934,2311,17304
2022-10-22 20:00:00,2022-10-22 21:00:00,251,0,122,0,0,2031,2404,16190
2022-10-22 21:00:00,2022-10-22 22:00:00,254,0,115,0,0,2127,2496,15134
2022-10-22 22:00:00,2022-10-22 23:00:00,252,0,114,0,0,2054,2420,14503
2022-10-22 23:00:00,2022-10-23 00:00:00,255,0,114,0,0,1874,2243,14171
2022-10-23 00:00:00,2022-10-23 01:00:00,256,0,114,0,0,1723,2093,13891
2022-10-23 01:00:00,2022-10-23 02:00:00,252,0,114,0,0,1608,1974,13937
2022-10-23 02:00:00,2022-10-23 03:00:00,253,0,114,0,0,1565,1932,14080
2022-10-23 03:00:00,2022-10-23 04:00:00,254,0,115,0,0,1579,1948,14475
2022-10-23 04:00:00,2022-10-23 05:00:00,254,0,114,0,52,1558,1978,14927
2022-10-23 05:00:00,2022-10-23 06:00:00,254,0,113,0,473,1429,2269,15852
2022-10-23 06:00:00,2022-10-23 07:00:00,253,0,113,0,1299,1281,2946,16735
2022-10-23 07:00:00,2022-10-23 08:00:00,255,0,115,0,2101,1191,3662,17225
2022-10-23 08:00:00,2022-10-23 09:00:00,253,0,115,0,2750,1140,4258,17419
2022-10-23 09:00:00,2022-10-23 10:00:00,254,0,114,0,3033,1142,4543,17351
2022-10-23 10:00:00,2022-10-23 11:00:00,254,0,115,0,3146,1063,4578,17251
2022-10-23 11:00:00,2022-10-23 12:00:00,253,0,113,0,2926,874,4166,17023
2022-10-23 12:00:00,2022-10-23 13:00:00,253,0,116,0,2006,596,2971,16828
2022-10-23 13:00:00,2022-10-23 14:00:00,253,0,127,0,847,426,1653,17010
2022-10-23 14:00:00,2022-10-23 15:00:00,255,81,128,38,180,505,1187,17708
2022-10-23 15:00:00,2022-10-23 16:00:00,254,707,148,43,4,690,1846,18866
2022-10-23 16:00:00,2022-10-23 17:00:00,255,746,162,43,0,1099,2305,19030
2022-10-23 17:00:00,2022-10-23 18:00:00,254,233,154,43,0,1483,2167,18554
2022-10-23 18:00:00,2022-10-23 19:00:00,254,91,145,5,0,1762,2257,17628
2022-10-23 19:00:00,2022-10-23 20:00:00,254,12,137,0,0,2018,2421,16702
2022-10-23 20:00:00,2022-10-23 21:00:00,254,33,135,0,0,2265,2687,15613
2022-10-23 21:00:00,2022-10-23 22:00:00,254,5,122,0,0,2281,2662,14747
2022-10-23 22:00:00,2022-10-23 23:00:00,253,0,123,0,0,2447,2823,14400
2022-10-23 23:00:00,2022-10-24 00:00:00,253,0,123,0,0,2538,2914,14232
2022-10-24 00:00:00,2022-10-24 01:00:00,253,0,123,0,0,2543,2919,14232
2022-10-24 01:00:00,2022-10-24 02:00:00,255,0,123,0,0,2441,2819,14633
2022-10-24 02:00:00,2022-10-24 03:00:00,253,0,123,0,0,2389,2765,15951
2022-10-24 03:00:00,2022-10-24 04:00:00,254,0,124,0,0,2416,2794,19244
2022-10-24 04:00:00,2022-10-24 05:00:00,260,0,124,0,55,2299,2738,21260
2022-10-24 05:00:00,2022-10-24 06:00:00,274,185,129,0,309,2180,3077,22335
2022-10-24 06:00:00,2022-10-24 07:00:00,262,387,143,0,910,1912,3614,22687
2022-10-24 07:00:00,2022-10-24 08:00:00,254,212,142,0,1702,1606,3916,22394
2022-10-24 08:00:00,2022-10-24 09:00:00,253,212,139,0,2426,1410,4440,22432
2022-10-24 09:00:00,2022-10-24 10:00:00,253,18,123,0,3004,1108,4506,22309
2022-10-24 10:00:00,2022-10-24 11:00:00,254,0,123,0,2982,1058,4417,22112
2022-10-24 11:00:00,2022-10-24 12:00:00,254,0,122,0,2259,1138,3773,21826
2022-10-24 12:00:00,2022-10-24 13:00:00,253,128,120,0,1569,1233,3303,22127
2022-10-24 13:00:00,2022-10-24 14:00:00,254,656,127,0,678,1430,3145,21974
2022-10-24 14:00:00,2022-10-24 15:00:00,260,578,132,38,144,1833,2985,22335
2022-10-24 15:00:00,2022-10-24 16:00:00,266,762,152,43,0,2536,3759,23080
2022-10-24 16:00:00,2022-10-24 17:00:00,200,699,155,43,0,3295,4392,23043
2022-10-24 17:00:00,2022-10-24 18:00:00,252,452,142,43,0,3504,4393,22499
2022-10-24 18:00:00,2022-10-24 19:00:00,254,298,134,5,0,3330,4021,20960
2022-10-24 19:00:00,2022-10-24 20:00:00,253,64,118,0,0,3316,3751,19175
2022-10-24 20:00:00,2022-10-24 21:00:00,255,0,118,0,0,3399,3772,17831
2022-10-24 21:00:00,2022-10-24 22:00:00,246,0,119,0,0,3293,3658,16879
2022-10-24 22:00:00,2022-10-24 23:00:00,244,0,120,0,0,3024,3388,16355
2022-10-24 23:00:00,2022-10-25 00:00:00,243,0,120,0,0,2785,3148,16071
2022-10-25 00:00:00,2022-10-25 01:00:00,243,0,120,0,0,2639,3002,16086
2022-10-25 01:00:00,2022-10-25 02:00:00,245,0,120,0,0,2502,2867,16313
2022-10-25 02:00:00,2022-10-25 03:00:00,248,0,120,0,0,2497,2865,17303
2022-10-25 03:00:00,2022-10-25 04:00:00,271,71,121,0,0,2470,2933,19921
2022-10-25 04:00:00,2022-10-25 05:00:00,262,44,130,0,57,2347,2840,21715
2022-10-25 05:00:00,2022-10-25 06:00:00,252,333,134,0,496,2245,3460,22339
2022-10-25 06:00:00,2022-10-25 07:00:00,253,457,140,0,1310,1913,4073,22400
2022-10-25 07:00:00,2022-10-25 08:00:00,253,378,139,0,2128,1525,4423,22172
2022-10-25 08:00:00,2022-10-25 09:00:00,254,23,140,0,2424,1462,4303,22503
2022-10-25 09:00:00,2022-10-25 10:00:00,255,149,126,0,1780,1541,3851,22470
2022-10-25 10:00:00,2022-10-25 11:00:00,253,0,120,0,2336,1736,4445,22124
2022-10-25 11:00:00,2022-10-25 12:00:00,256,0,120,0,2075,1972,4423,21751
2022-10-25 12:00:00,2022-10-25 13:00:00,253,0,118,0,1406,1795,3572,21852
2022-10-25 13:00:00,2022-10-25 14:00:00,253,0,127,0,631,1553,2564,21955
2022-10-25 14:00:00,2022-10-25 15:00:00,260,107,138,38,126,1514,2183,22344
2022-10-25 15:00:00,2022-10-25 16:00:00,273,833,156,43,0,1824,3129,23191
2022-10-25 16:00:00,2022-10-25 17:00:00,274,789,158,43,0,2102,3366,23203
2022-10-25 17:00:00,2022-10-25 18:00:00,273,396,143,43,0,2302,3157,22647
2022-10-25 18:00:00,2022-10-25 19:00:00,262,53,136,5,0,2521,2977,21155
2022-10-25 19:00:00,2022-10-25 20:00:00,253,0,134,0,0,2457,2844,19392
2022-10-25 20:00:00,2022-10-25 21:00:00,253,0,133,0,0,2399,2785,17932
2022-10-25 21:00:00,2022-10-25 22:00:00,253,0,119,0,0,2285,2657,16815
2022-10-25 22:00:00,2022-10-25 23:00:00,253,0,116,0,0,2168,2537,16308
2022-10-25 23:00:00,2022-10-26 00:00:00,255,0,116,0,0,1997,2368,16065
2022-10-26 00:00:00,2022-10-26 01:00:00,255,0,116,0,0,1742,2113,16058
2022-10-26 01:00:00,2022-10-26 02:00:00,253,0,116,0,0,1408,1777,16334
2022-10-26 02:00:00,2022-10-26 03:00:00,254,0,116,0,0,1167,1537,17316
2022-10-26 03:00:00,2022-10-26 04:00:00,253,42,116,0,0,1004,1415,20165
2022-10-26 04:00:00,2022-10-26 05:00:00,253,244,117,0,55,791,1460,22035
2022-10-26 05:00:00,2022-10-26 06:00:00,254,510,119,0,557,665,2105,22629
2022-10-26 06:00:00,2022-10-26 07:00:00,255,292,139,0,1649,584,2919,22682
2022-10-26 07:00:00,2022-10-26 08:00:00,255,0,143,0,2562,522,3482,22238
2022-10-26 08:00:00,2022-10-26 09:00:00,253,0,141,0,3214,537,4145,22251
2022-10-26 09:00:00,2022-10-26 10:00:00,243,0,141,0,3601,557,4542,22129
2022-10-26 10:00:00,2022-10-26 11:00:00,241,0,142,0,3605,555,4543,21993
2022-10-26 11:00:00,2022-10-26 12:00:00,249,0,129,0,3356,466,4200,21942
2022-10-26 12:00:00,2022-10-26 13:00:00,253,0,121,0,2418,370,3162,21964
2022-10-26 13:00:00,2022-10-26 14:00:00,253,94,123,38,1051,293,1852,21949
2022-10-26 14:00:00,2022-10-26 15:00:00,254,598,128,43,132,346,1501,22327
2022-10-26 15:00:00,2022-10-26 16:00:00,254,990,141,43,0,518,1946,23282
2022-10-26 16:00:00,2022-10-26 17:00:00,253,920,151,43,0,722,2089,23313
2022-10-26 17:00:00,2022-10-26 18:00:00,253,575,137,43,0,966,1974,22663
2022-10-26 18:00:00,2022-10-26 19:00:00,253,314,135,5,0,1141,1848,21251
2022-10-26 19:00:00,2022-10-26 20:00:00,254,14,124,0,0,1173,1565,19607
2022-10-26 20:00:00,2022-10-26 21:00:00,253,0,117,0,0,1279,1649,18104
2022-10-26 21:00:00,2022-10-26 22:00:00,253,0,112,0,0,1376,1741,17083
2022-10-26 22:00:00,2022-10-26 23:00:00,254,0,112,0,0,1403,1769,16443
2022-10-26 23:00:00,2022-10-27 00:00:00,254,0,112,0,0,1284,1650,16212
2022-10-27 00:00:00,2022-10-27 01:00:00,254,0,112,0,0,1226,1592,16267
2022-10-27 01:00:00,2022-10-27 02:00:00,253,0,112,0,0,1204,1569,16628
2022-10-27 02:00:00,2022-10-27 03:00:00,260,0,112,0,0,1171,1543,17519
2022-10-27 03:00:00,2022-10-27 04:00:00,273,88,112,0,0,1153,1626,20156
2022-10-27 04:00:00,2022-10-27 05:00:00,261,513,112,0,62,1114,2062,21831
2022-10-27 05:00:00,2022-10-27 06:00:00,253,480,128,0,743,1038,2642,22447
2022-10-27 06:00:00,2022-10-27 07:00:00,242,105,137,0,2260,875,3619,22652
2022-10-27 07:00:00,2022-10-27 08:00:00,242,0,138,0,3522,483,4385,22129
2022-10-27 08:00:00,2022-10-27 09:00:00,243,0,137,0,4307,274,4961,21938
2022-10-27 09:00:00,2022-10-27 10:00:00,244,0,136,0,4757,253,5390,21852
2022-10-27 10:00:00,2022-10-27 11:00:00,260,0,117,0,4564,302,5243,21724
2022-10-27 11:00:00,2022-10-27 12:00:00,261,0,114,0,3751,357,4483,21562
2022-10-27 12:00:00,2022-10-27 13:00:00,261,0,116,0,2558,340,3275,21804
2022-10-27 13:00:00,2022-10-27 14:00:00,268,0,117,0,1001,347,1733,21866
2022-10-27 14:00:00,2022-10-27 15:00:00,281,226,123,38,145,463,1276,22429
2022-10-27 15:00:00,2022-10-27 16:00:00,281,700,145,43,0,710,1879,23423
2022-10-27 16:00:00,2022-10-27 17:00:00,280,751,161,43,0,1047,2282,23411
2022-10-27 17:00:00,2022-10-27 18:00:00,273,502,156,43,0,1462,2436,22664
2022-10-27 18:00:00,2022-10-27 19:00:00,261,111,153,5,0,1749,2279,21143
2022-10-27 19:00:00,2022-10-27 20:00:00,254,0,120,0,0,2009,2383,19370
2022-10-27 20:00:00,2022-10-27 21:00:00,252,0,117,0,0,2143,2512,17974
2022-10-27 21:00:00,2022-10-27 22:00:00,253,0,116,0,0,2160,2529,16812
2022-10-27 22:00:00,2022-10-27 23:00:00,251,0,115,0,0,2236,2602,16397
2022-10-27 23:00:00,2022-10-28 00:00:00,253,0,116,0,0,2274,2643,16109
2022-10-28 00:00:00,2022-10-28 01:00:00,252,0,116,0,0,2344,2712,16110
2022-10-28 01:00:00,2022-10-28 02:00:00,253,0,120,0,0,2487,2860,16489
2022-10-28 02:00:00,2022-10-28 03:00:00,253,0,120,0,0,2458,2831,17308
2022-10-28 03:00:00,2022-10-28 04:00:00,252,204,120,0,0,2483,3059,19986
2022-10-28 04:00:00,2022-10-28 05:00:00,253,350,120,0,60,2652,3435,21705
2022-10-28 05:00:00,2022-10-28 06:00:00,252,409,120,0,612,2431,3824,22312
2022-10-28 06:00:00,2022-10-28 07:00:00,260,199,120,0,1963,2024,4566,22348
2022-10-28 07:00:00,2022-10-28 08:00:00,260,32,119,0,3260,1444,5115,22042
2022-10-28 08:00:00,2022-10-28 09:00:00,254,49,119,0,3834,1094,5350,21779
2022-10-28 09:00:00,2022-10-28 10:00:00,252,50,118,0,3921,1097,5438,21660
2022-10-28 10:00:00,2022-10-28 11:00:00,251,6,118,0,3544,1013,4932,21604
2022-10-28 11:00:00,2022-10-28 12:00:00,253,0,118,0,2863,1164,4398,21347
2022-10-28 12:00:00,2022-10-28 13:00:00,254,0,119,38,2021,1365,3797,21437
2022-10-28 13:00:00,2022-10-28 14:00:00,254,139,131,43,800,1738,3105,21444
2022-10-28 14:00:00,2022-10-28 15:00:00,253,461,139,43,113,2597,3606,21759
2022-10-28 15:00:00,2022-10-28 16:00:00,253,611,156,43,0,3522,4585,22467
2022-10-28 16:00:00,2022-10-28 17:00:00,253,627,161,5,0,4220,5266,22517
2022-10-28 17:00:00,2022-10-28 18:00:00,252,679,144,0,0,4492,5567,21836
2022-10-28 18:00:00,2022-10-28 19:00:00,255,829,129,0,0,4501,5714,20205
2022-10-28 19:00:00,2022-10-28 20:00:00,253,711,117,0,0,4391,5472,18650
2022-10-28 20:00:00,2022-10-28 21:00:00,254,86,116,0,0,4261,4717,17385
2022-10-28 21:00:00,2022-10-28 22:00:00,250,0,116,0,0,4210,4576,16439
2022-10-28 22:00:00,2022-10-28 23:00:00,253,0,116,0,0,4188,4557,15788
2022-10-28 23:00:00,2022-10-29 00:00:00,253,0,116,0,0,4238,4607,15400
2022-10-29 00:00:00,2022-10-29 01:00:00,256,0,116,0,0,4394,4766,15344
2022-10-29 01:00:00,2022-10-29 02:00:00,253,0,116,0,0,4502,4871,15315
2022-10-29 02:00:00,2022-10-29 03:00:00,254,0,116,0,0,4663,5033,15525
2022-10-29 03:00:00,2022-10-29 04:00:00,254,0,116,0,0,4840,5210,16583
2022-10-29 04:00:00,2022-10-29 05:00:00,253,20,116,0,50,4659,5098,17392
2022-10-29 05:00:00,2022-10-29 06:00:00,255,271,123,0,486,4503,5638,18356
2022-10-29 06:00:00,2022-10-29 07:00:00,254,422,135,0,1578,4089,6478,19286
2022-10-29 07:00:00,2022-10-29 08:00:00,255,55,135,0,2532,3795,6772,19190
2022-10-29 08:00:00,2022-10-29 09:00:00,253,0,135,0,3280,3513,7181,19103
2022-10-29 09:00:00,2022-10-29 10:00:00,252,0,120,0,3676,3306,7354,18971
2022-10-29 10:00:00,2022-10-29 11:00:00,254,0,118,0,3544,3124,7040,18841
2022-10-29 11:00:00,2022-10-29 12:00:00,252,0,118,0,2789,2928,6087,18444
2022-10-29 12:00:00,2022-10-29 13:00:00,254,0,119,0,1616,2526,4515,18476
2022-10-29 13:00:00,2022-10-29 14:00:00,254,17,129,0,564,2208,3172,18516
2022-10-29 14:00:00,2022-10-29 15:00:00,253,458,133,0,145,2219,3208,19277
2022-10-29 15:00:00,2022-10-29 16:00:00,255,683,146,38,0,2303,3425,19869
2022-10-29 16:00:00,2022-10-29 17:00:00,253,619,156,43,0,2268,3339,19612
2022-10-29 17:00:00,2022-10-29 18:00:00,253,133,142,43,0,2181,2752,19072
2022-10-29 18:00:00,2022-10-29 19:00:00,254,0,141,5,0,2048,2448,17966
2022-10-29 19:00:00,2022-10-29 20:00:00,253,0,120,0,0,1811,2184,16893
2022-10-29 20:00:00,2022-10-29 21:00:00,254,0,117,0,0,1589,1960,15723
2022-10-29 21:00:00,2022-10-29 22:00:00,253,0,117,0,0,1540,1910,14619
2022-10-29 22:00:00,2022-10-29 23:00:00,246,0,117,0,0,1485,1848,13974
2022-10-29 23:00:00,2022-10-30 00:00:00,189,0,117,0,0,1283,1589,13640
2022-10-30 00:00:00,2022-10-30 01:00:00,237,0,117,0,0,1116,1470,13440
2022-10-30 01:00:00,2022-10-30 02:00:00,256,0,117,0,0,985,1358,13390
2022-10-30 02:00:00,2022-10-30 03:00:00,252,0,117,0,0,878,1247,13519
2022-10-30 03:00:00,2022-10-30 04:00:00,252,0,117,0,0,841,1210,13767
2022-10-30 04:00:00,2022-10-30 05:00:00,253,0,117,0,0,711,1081,14204
2022-10-30 05:00:00,2022-10-30 06:00:00,254,0,117,0,415,671,1457,15089
2022-10-30 06:00:00,2022-10-30 07:00:00,254,0,129,0,1530,639,2552,16329
2022-10-30 07:00:00,2022-10-30 08:00:00,252,0,135,0,2408,612,3407,16727
2022-10-30 08:00:00,2022-10-30 09:00:00,254,0,134,0,2942,443,3773,16762
2022-10-30 09:00:00,2022-10-30 10:00:00,254,0,134,0,3161,300,3849,16683
2022-10-30 10:00:00,2022-10-30 11:00:00,253,0,120,0,3324,245,3942,16900
2022-10-30 11:00:00,2022-10-30 12:00:00,254,0,118,0,2760,209,3341,16918
2022-10-30 12:00:00,2022-10-30 13:00:00,254,0,117,0,1915,245,2531,16718
2022-10-30 13:00:00,2022-10-30 14:00:00,254,0,118,0,753,307,1432,16561
2022-10-30 14:00:00,2022-10-30 15:00:00,254,0,127,0,143,476,1000,17272
2022-10-30 15:00:00,2022-10-30 16:00:00,251,361,142,0,52,623,1429,18307
2022-10-30 16:00:00,2022-10-30 17:00:00,253,500,146,38,0,667,1604,18346
2022-10-30 17:00:00,2022-10-30 18:00:00,254,410,138,43,0,687,1532,18234
2022-10-30 18:00:00,2022-10-30 19:00:00,254,149,135,43,0,663,1244,17834
2022-10-30 19:00:00,2022-10-30 20:00:00,254,0,137,5,0,540,936,16936
2022-10-30 20:00:00,2022-10-30 21:00:00,253,0,116,0,0,445,814,15999
2022-10-30 21:00:00,2022-10-30 22:00:00,255,0,116,0,0,354,725,15039
2022-10-30 22:00:00,2022-10-30 23:00:00,253,0,112,0,0,336,701,14387
2022-10-30 23:00:00,2022-10-31 00:00:00,254,0,112,0,0,320,686,14064
2022-10-31 00:00:00,2022-10-31 01:00:00,254,0,112,0,0,331,697,13939
2022-10-31 01:00:00,2022-10-31 02:00:00,253,0,112,0,0,343,708,13987
2022-10-31 02:00:00,2022-10-31 03:00:00,254,0,112,0,0,396,762,14359
2022-10-31 03:00:00,2022-10-31 04:00:00,252,0,112,0,0,473,837,15149
2022-10-31 04:00:00,2022-10-31 05:00:00,253,0,112,0,32,566,963,16796
2022-10-31 05:00:00,2022-10-31 06:00:00,253,139,121,0,498,579,1590,18293
2022-10-31 06:00:00,2022-10-31 07:00:00,255,191,135,0,1598,479,2658,19209
2022-10-31 07:00:00,2022-10-31 08:00:00,255,48,133,0,2519,269,3224,19412
2022-10-31 08:00:00,2022-10-31 09:00:00,254,0,128,0,3135,125,3642,19196
2022-10-31 09:00:00,2022-10-31 10:00:00,254,59,119,0,3399,65,3896,19287
2022-10-31 10:00:00,2022-10-31 11:00:00,254,135,116,0,3344,66,3915,19419
2022-10-31 11:00:00,2022-10-31 12:00:00,254,17,110,0,2864,95,3340,19649
2022-10-31 12:00:00,2022-10-31 13:00:00,254,121,110,0,1891,96,2472,19609
2022-10-31 13:00:00,2022-10-31 14:00:00,260,396,117,0,645,66,1484,19610
2022-10-31 14:00:00,2022-10-31 15:00:00,273,811,120,38,122,84,1448,20230
2022-10-31 15:00:00,2022-10-31 16:00:00,274,1240,134,43,41,112,1844,20840
2022-10-31 16:00:00,2022-10-31 17:00:00,274,1052,158,43,0,122,1649,20608
2022-10-31 17:00:00,2022-10-31 18:00:00,261,808,155,43,0,138,1405,20267
2022-10-31 18:00:00,2022-10-31 19:00:00,255,253,148,5,0,145,806,19573
2022-10-31 19:00:00,2022-10-31 20:00:00,247,0,147,0,0,174,568,18364
2022-10-31 20:00:00,2022-10-31 21:00:00,254,0,135,0,0,241,630,16932
2022-10-31 21:00:00,2022-10-31 22:00:00,253,0,134,0,0,303,690,15582
2022-10-31 22:00:00,2022-10-31 23:00:00,250,85,119,0,0,348,802,14443
2022-10-31 23:00:00,2022-11-01 00:00:00,253,8,117,0,0,403,781,14095
2022-11-01 00:00:00,2022-11-01 01:00:00,252,0,117,0,0,534,903,13823
2022-11-01 01:00:00,2022-11-01 02:00:00,251,0,120,0,0,721,1092,13665
2022-11-01 02:00:00,2022-11-01 03:00:00,251,0,122,0,0,740,1113,13689
2022-11-01 03:00:00,2022-11-01 04:00:00,250,0,121,0,0,829,1200,13893
2022-11-01 04:00:00,2022-11-01 05:00:00,252,0,121,0,19,978,1370,13874
2022-11-01 05:00:00,2022-11-01 06:00:00,250,0,121,0,273,786,1430,14499
2022-11-01 06:00:00,2022-11-01 07:00:00,251,303,131,0,862,740,2287,15468
2022-11-01 07:00:00,2022-11-01 08:00:00,252,391,143,0,1482,691,2959,16004
2022-11-01 08:00:00,2022-11-01 09:00:00,251,72,143,0,1980,677,3123,16021
2022-11-01 09:00:00,2022-11-01 10:00:00,216,0,141,0,2204,646,3207,15829
2022-11-01 10:00:00,2022-11-01 11:00:00,250,0,126,0,2149,634,3159,15755
2022-11-01 11:00:00,2022-11-01 12:00:00,252,0,126,0,1761,623,2762,15891
2022-11-01 12:00:00,2022-11-01 13:00:00,251,0,126,0,1077,634,2088,15796
2022-11-01 13:00:00,2022-11-01 14:00:00,251,0,133,0,376,698,1458,15822
2022-11-01 14:00:00,2022-11-01 15:00:00,251,181,145,0,108,901,1586,16487
2022-11-01 15:00:00,2022-11-01 16:00:00,250,614,146,38,41,1175,2264,17107
2022-11-01 16:00:00,2022-11-01 17:00:00,251,767,136,43,0,1304,2501,17285
2022-11-01 17:00:00,2022-11-01 18:00:00,252,798,130,43,0,1459,2682,17205
2022-11-01 18:00:00,2022-11-01 19:00:00,251,594,129,5,0,1698,2677,16916
2022-11-01 19:00:00,2022-11-01 20:00:00,250,172,129,0,0,1634,2185,16135
2022-11-01 20:00:00,2022-11-01 21:00:00,251,0,115,0,0,1504,1870,15313
2022-11-01 21:00:00,2022-11-01 22:00:00,252,183,113,0,0,1424,1972,14381
2022-11-01 22:00:00,2022-11-01 23:00:00,251,79,112,0,0,1393,1835,13713
2022-11-01 23:00:00,2022-11-02 00:00:00,252,0,112,0,0,1247,1611,13453
2022-11-02 00:00:00,2022-11-02 01:00:00,250,0,113,0,0,1296,1659,13337
2022-11-02 01:00:00,2022-11-02 02:00:00,228,0,113,0,0,1333,1674,13325
2022-11-02 02:00:00,2022-11-02 03:00:00,74,0,112,0,0,1395,1581,13776
2022-11-02 03:00:00,2022-11-02 04:00:00,74,0,112,0,0,1556,1742,15173
2022-11-02 04:00:00,2022-11-02 05:00:00,74,0,112,0,11,1671,1868,18136
2022-11-02 05:00:00,2022-11-02 06:00:00,74,126,124,0,336,1907,2567,20273
2022-11-02 06:00:00,2022-11-02 07:00:00,74,188,136,38,1340,1827,3603,21282
2022-11-02 07:00:00,2022-11-02 08:00:00,74,30,137,43,2515,1462,4261,21357
2022-11-02 08:00:00,2022-11-02 09:00:00,74,0,135,5,3320,1319,4853,20872
2022-11-02 09:00:00,2022-11-02 10:00:00,74,0,120,0,3832,1572,5598,21192
2022-11-02 10:00:00,2022-11-02 11:00:00,75,0,113,0,3622,1952,5762,21196
2022-11-02 11:00:00,2022-11-02 12:00:00,74,0,112,0,3150,2236,5572,21420
2022-11-02 12:00:00,2022-11-02 13:00:00,74,204,112,0,1873,2183,4446,21256
2022-11-02 13:00:00,2022-11-02 14:00:00,74,268,112,0,593,2050,3097,21495
2022-11-02 14:00:00,2022-11-02 15:00:00,99,292,112,0,90,2547,3140,22244
2022-11-02 15:00:00,2022-11-02 16:00:00,177,587,126,38,22,3243,4193,22864
2022-11-02 16:00:00,2022-11-02 17:00:00,223,547,130,43,0,3485,4428,22522
2022-11-02 17:00:00,2022-11-02 18:00:00,249,627,122,5,0,3818,4821,22439
2022-11-02 18:00:00,2022-11-02 19:00:00,250,491,113,0,0,3705,4559,21711
2022-11-02 19:00:00,2022-11-02 20:00:00,252,73,110,0,0,3805,4240,20247
2022-11-02 20:00:00,2022-11-02 21:00:00,252,0,110,0,0,3810,4172,18539
2022-11-02 21:00:00,2022-11-02 22:00:00,252,0,109,0,0,3535,3896,17216
2022-11-02 22:00:00,2022-11-02 23:00:00,252,0,107,0,0,3272,3631,16375
2022-11-02 23:00:00,2022-11-03 00:00:00,252,0,107,0,0,3036,3395,16021
2022-11-03 00:00:00,2022-11-03 01:00:00,253,0,107,0,0,2644,3004,15726
2022-11-03 01:00:00,2022-11-03 02:00:00,250,0,107,0,0,2353,2710,15863
2022-11-03 02:00:00,2022-11-03 03:00:00,251,0,107,0,0,2189,2547,16232
2022-11-03 03:00:00,2022-11-03 04:00:00,250,10,107,0,0,2059,2426,17281
2022-11-03 04:00:00,2022-11-03 05:00:00,251,277,107,0,29,1945,2609,19744
2022-11-03 05:00:00,2022-11-03 06:00:00,252,181,108,0,765,1889,3195,21542
2022-11-03 06:00:00,2022-11-03 07:00:00,140,0,131,0,2489,1677,4437,22278
2022-11-03 07:00:00,2022-11-03 08:00:00,75,117,134,0,3848,1245,5419,21955
2022-11-03 08:00:00,2022-11-03 09:00:00,75,17,136,0,4718,841,5787,21450
2022-11-03 09:00:00,2022-11-03 10:00:00,75,0,138,0,4979,955,6147,21517
2022-11-03 10:00:00,2022-11-03 11:00:00,75,0,139,0,4653,1105,5972,21554
2022-11-03 11:00:00,2022-11-03 12:00:00,75,0,133,0,3831,1099,5138,21752
2022-11-03 12:00:00,2022-11-03 13:00:00,75,203,119,0,2389,1070,3856,21764
2022-11-03 13:00:00,2022-11-03 14:00:00,74,584,120,0,658,1361,2797,21971
2022-11-03 14:00:00,2022-11-03 15:00:00,75,566,134,38,108,2356,3277,22798
2022-11-03 15:00:00,2022-11-03 16:00:00,122,440,136,43,37,3614,4392,23375
2022-11-03 16:00:00,2022-11-03 17:00:00,176,472,128,5,0,4304,5085,23011
2022-11-03 17:00:00,2022-11-03 18:00:00,185,510,123,0,0,4740,5558,22853
2022-11-03 18:00:00,2022-11-03 19:00:00,186,515,119,0,0,4950,5770,22193
2022-11-03 19:00:00,2022-11-03 20:00:00,184,402,119,0,0,5065,5770,20670
2022-11-03 20:00:00,2022-11-03 21:00:00,186,108,116,0,0,5069,5479,18971
2022-11-03 21:00:00,2022-11-03 22:00:00,186,0,116,0,0,4992,5294,17752
2022-11-03 22:00:00,2022-11-03 23:00:00,186,0,121,0,0,4778,5085,16792
2022-11-03 23:00:00,2022-11-04 00:00:00,185,0,122,0,0,4480,4787,16198
2022-11-04 00:00:00,2022-11-04 01:00:00,185,0,122,0,0,4283,4590,15889
2022-11-04 01:00:00,2022-11-04 02:00:00,186,0,122,0,0,4273,4581,16010
2022-11-04 02:00:00,2022-11-04 03:00:00,185,0,122,0,0,4149,4456,16320
2022-11-04 03:00:00,2022-11-04 04:00:00,185,0,122,0,0,4013,4320,17224
2022-11-04 04:00:00,2022-11-04 05:00:00,185,0,122,0,20,4000,4327,19678
2022-11-04 05:00:00,2022-11-04 06:00:00,185,0,114,0,329,3829,4457,21392
2022-11-04 06:00:00,2022-11-04 07:00:00,186,31,138,0,1200,3219,4774,22428
2022-11-04 07:00:00,2022-11-04 08:00:00,184,4,142,0,1843,2333,4506,22583
2022-11-04 08:00:00,2022-11-04 09:00:00,185,0,137,0,2173,1825,4320,22290
2022-11-04 09:00:00,2022-11-04 10:00:00,195,19,121,0,2133,1625,4093,22262
2022-11-04 10:00:00,2022-11-04 11:00:00,245,0,113,0,2016,1658,4032,22489
2022-11-04 11:00:00,2022-11-04 12:00:00,251,0,122,0,1556,1597,3526,22619
2022-11-04 12:00:00,2022-11-04 13:00:00,252,153,124,0,728,1534,2791,22347
2022-11-04 13:00:00,2022-11-04 14:00:00,252,569,125,0,187,1649,2782,22603
2022-11-04 14:00:00,2022-11-04 15:00:00,250,735,138,38,86,1905,3152,23288
2022-11-04 15:00:00,2022-11-04 16:00:00,250,820,152,43,34,2143,3442,23489
2022-11-04 16:00:00,2022-11-04 17:00:00,250,644,147,5,0,2185,3231,22962
2022-11-04 17:00:00,2022-11-04 18:00:00,250,510,141,0,0,2121,3022,22784
2022-11-04 18:00:00,2022-11-04 19:00:00,251,268,140,0,0,2089,2748,22071
2022-11-04 19:00:00,2022-11-04 20:00:00,250,173,123,0,0,2122,2668,20537
2022-11-04 20:00:00,2022-11-04 21:00:00,250,0,118,0,0,1988,2356,19017
2022-11-04 21:00:00,2022-11-04 22:00:00,250,0,117,0,0,1882,2249,17770
2022-11-04 22:00:00,2022-11-04 23:00:00,251,0,113,0,0,1963,2327,16814
2022-11-04 23:00:00,2022-11-05 00:00:00,251,0,110,0,0,2213,2574,16143
2022-11-05 00:00:00,2022-11-05 01:00:00,251,0,110,0,0,2483,2844,15827
2022-11-05 01:00:00,2022-11-05 02:00:00,250,0,111,0,0,2462,2823,15728
2022-11-05 02:00:00,2022-11-05 03:00:00,251,0,111,0,0,2457,2819,15802
2022-11-05 03:00:00,2022-11-05 04:00:00,251,0,111,0,0,2654,3016,16082
2022-11-05 04:00:00,2022-11-05 05:00:00,250,0,110,0,18,2755,3133,16853
2022-11-05 05:00:00,2022-11-05 06:00:00,251,0,111,0,107,2603,3072,17962
2022-11-05 06:00:00,2022-11-05 07:00:00,250,0,123,0,331,2123,2827,19166
2022-11-05 07:00:00,2022-11-05 08:00:00,251,0,135,0,603,1878,2867,20106
2022-11-05 08:00:00,2022-11-05 09:00:00,251,0,136,0,920,1821,3128,20664
2022-11-05 09:00:00,2022-11-05 10:00:00,252,0,136,0,1082,1791,3261,20877
2022-11-05 10:00:00,2022-11-05 11:00:00,250,0,135,0,1100,1759,3244,20864
2022-11-05 11:00:00,2022-11-05 12:00:00,250,0,136,0,994,1721,3101,20701
2022-11-05 12:00:00,2022-11-05 13:00:00,250,0,135,0,767,1648,2800,20111
2022-11-05 13:00:00,2022-11-05 14:00:00,258,0,135,0,341,1469,2203,19946
2022-11-05 14:00:00,2022-11-05 15:00:00,273,53,150,0,73,1501,2050,20410
2022-11-05 15:00:00,2022-11-05 16:00:00,274,824,153,38,38,1705,3032,20713
2022-11-05 16:00:00,2022-11-05 17:00:00,273,232,146,43,0,1950,2644,20384
2022-11-05 17:00:00,2022-11-05 18:00:00,259,0,143,5,0,2145,2552,19955
2022-11-05 18:00:00,2022-11-05 19:00:00,250,0,142,0,0,2258,2650,19352
2022-11-05 19:00:00,2022-11-05 20:00:00,249,0,140,0,0,2151,2540,18289
2022-11-05 20:00:00,2022-11-05 21:00:00,252,0,116,0,0,2226,2594,17095
2022-11-05 21:00:00,2022-11-05 22:00:00,250,0,114,0,0,2252,2616,15948
2022-11-05 22:00:00,2022-11-05 23:00:00,251,0,113,0,0,2167,2531,15032
2022-11-05 23:00:00,2022-11-06 00:00:00,251,0,111,0,0,2090,2452,14474
2022-11-06 00:00:00,2022-11-06 01:00:00,250,0,111,0,0,1969,2330,14063
2022-11-06 01:00:00,2022-11-06 02:00:00,251,0,111,0,0,1880,2242,13968
2022-11-06 02:00:00,2022-11-06 03:00:00,250,0,110,0,0,1739,2099,14003
2022-11-06 03:00:00,2022-11-06 04:00:00,251,0,112,0,0,1836,2199,14263
2022-11-06 04:00:00,2022-11-06 05:00:00,250,0,111,0,11,1924,2296,14542
2022-11-06 05:00:00,2022-11-06 06:00:00,246,0,111,0,364,2171,2892,15170
2022-11-06 06:00:00,2022-11-06 07:00:00,246,0,121,0,1447,2197,4011,16278
2022-11-06 07:00:00,2022-11-06 08:00:00,245,0,134,0,2598,1680,4657,17024
2022-11-06 08:00:00,2022-11-06 09:00:00,246,0,135,0,3491,1551,5423,17460
2022-11-06 09:00:00,2022-11-06 10:00:00,246,0,135,0,3924,1610,5915,17514
2022-11-06 10:00:00,2022-11-06 11:00:00,246,0,131,0,3857,1820,6054,17551
2022-11-06 11:00:00,2022-11-06 12:00:00,245,0,130,0,3257,1888,5520,17625
2022-11-06 12:00:00,2022-11-06 13:00:00,247,0,130,0,2112,1822,4311,17516
2022-11-06 13:00:00,2022-11-06 14:00:00,246,125,131,0,613,1831,2946,17485
2022-11-06 14:00:00,2022-11-06 15:00:00,250,243,147,38,80,2364,3122,18231
2022-11-06 15:00:00,2022-11-06 16:00:00,252,105,151,43,36,3303,3890,18891
2022-11-06 16:00:00,2022-11-06 17:00:00,251,407,149,5,0,4102,4914,18843
2022-11-06 17:00:00,2022-11-06 18:00:00,251,917,145,0,0,4342,5655,18770
2022-11-06 18:00:00,2022-11-06 19:00:00,251,964,140,0,0,4615,5970,18295
2022-11-06 19:00:00,2022-11-06 20:00:00,251,808,133,0,0,4697,5889,17496
2022-11-06 20:00:00,2022-11-06 21:00:00,251,493,121,0,0,4656,5521,16739
2022-11-06 21:00:00,2022-11-06 22:00:00,252,112,118,0,0,4586,5068,15788
2022-11-06 22:00:00,2022-11-06 23:00:00,250,0,116,0,0,4562,4928,15089
2022-11-06 23:00:00,2022-11-07 00:00:00,250,0,115,0,0,4327,4692,14712
2022-11-07 00:00:00,2022-11-07 01:00:00,252,0,114,0,0,4113,4479,14463
2022-11-07 01:00:00,2022-11-07 02:00:00,250,0,114,0,0,3936,4300,14569
2022-11-07 02:00:00,2022-11-07 03:00:00,250,0,115,0,0,3766,4131,15075
2022-11-07 03:00:00,2022-11-07 04:00:00,253,0,115,0,0,3598,3966,16280
2022-11-07 04:00:00,2022-11-07 05:00:00,251,113,115,0,7,3391,3877,19383
2022-11-07 05:00:00,2022-11-07 06:00:00,250,260,114,0,159,3342,4125,21370
2022-11-07 06:00:00,2022-11-07 07:00:00,252,270,121,0,580,3192,4415,22503
2022-11-07 07:00:00,2022-11-07 08:00:00,249,188,124,0,1270,2891,4722,22798
2022-11-07 08:00:00,2022-11-07 09:00:00,249,14,122,0,1848,2684,4917,22551
2022-11-07 09:00:00,2022-11-07 10:00:00,252,0,120,0,2243,2500,5115,22723
2022-11-07 10:00:00,2022-11-07 11:00:00,251,0,122,0,2175,2379,4927,22720
2022-11-07 11:00:00,2022-11-07 12:00:00,251,0,122,0,1846,2297,4516,22728
2022-11-07 12:00:00,2022-11-07 13:00:00,252,16,119,0,1296,2350,4033,22623
2022-11-07 13:00:00,2022-11-07 14:00:00,250,306,120,0,359,2494,3529,22570
2022-11-07 14:00:00,2022-11-07 15:00:00,251,652,136,25,35,3106,4205,23283
2022-11-07 15:00:00,2022-11-07 16:00:00,250,708,146,29,0,3812,4945,23537
2022-11-07 16:00:00,2022-11-07 17:00:00,251,587,139,29,0,4168,5174,23225
2022-11-07 17:00:00,2022-11-07 18:00:00,251,664,134,4,0,4050,5103,23004
2022-11-07 18:00:00,2022-11-07 19:00:00,251,363,125,0,0,3960,4699,22458
2022-11-07 19:00:00,2022-11-07 20:00:00,251,21,116,0,0,3967,4355,20981
2022-11-07 20:00:00,2022-11-07 21:00:00,251,0,105,0,0,3830,4186,19369
2022-11-07 21:00:00,2022-11-07 22:00:00,253,0,103,0,0,3749,4105,18063
2022-11-07 22:00:00,2022-11-07 23:00:00,250,0,106,0,0,3575,3931,17133
2022-11-07 23:00:00,2022-11-08 00:00:00,250,0,108,0,0,3535,3893,16723
2022-11-08 00:00:00,2022-11-08 01:00:00,252,0,108,0,0,3425,3785,16425
2022-11-08 01:00:00,2022-11-08 02:00:00,250,0,108,0,0,3443,3801,16317
2022-11-08 02:00:00,2022-11-08 03:00:00,251,0,108,0,0,3492,3851,16588
2022-11-08 03:00:00,2022-11-08 04:00:00,249,0,108,0,0,3302,3659,17563
2022-11-08 04:00:00,2022-11-08 05:00:00,250,147,108,0,9,3179,3693,20199
2022-11-08 05:00:00,2022-11-08 06:00:00,250,304,108,0,411,3110,4183,21870
2022-11-08 06:00:00,2022-11-08 07:00:00,251,190,127,0,1698,2703,4969,22464
2022-11-08 07:00:00,2022-11-08 08:00:00,263,15,137,0,3129,1994,5538,22299
2022-11-08 08:00:00,2022-11-08 09:00:00,279,0,134,0,4043,1421,5877,21800
2022-11-08 09:00:00,2022-11-08 10:00:00,279,0,126,0,4568,1325,6298,21861
2022-11-08 10:00:00,2022-11-08 11:00:00,277,0,111,0,4497,1476,6361,21934
2022-11-08 11:00:00,2022-11-08 12:00:00,277,0,112,0,3652,1665,5706,22028
2022-11-08 12:00:00,2022-11-08 13:00:00,277,118,121,0,2195,1776,4487,21935
2022-11-08 13:00:00,2022-11-08 14:00:00,277,597,121,25,593,2141,3754,22114
2022-11-08 14:00:00,2022-11-08 15:00:00,277,766,143,29,38,3069,4322,23018
2022-11-08 15:00:00,2022-11-08 16:00:00,276,661,147,29,0,4038,5151,23427
2022-11-08 16:00:00,2022-11-08 17:00:00,277,272,141,4,0,4734,5428,23124
2022-11-08 17:00:00,2022-11-08 18:00:00,278,354,138,0,0,5080,5850,23016
2022-11-08 18:00:00,2022-11-08 19:00:00,274,428,125,0,0,5143,5970,22531
2022-11-08 19:00:00,2022-11-08 20:00:00,249,393,122,0,0,5034,5798,20959
2022-11-08 20:00:00,2022-11-08 21:00:00,250,289,115,0,0,4973,5627,19397
2022-11-08 21:00:00,2022-11-08 22:00:00,251,27,114,0,0,4893,5285,18070
2022-11-08 22:00:00,2022-11-08 23:00:00,259,0,112,0,0,4500,4871,17055
2022-11-08 23:00:00,2022-11-09 00:00:00,259,0,112,0,0,4137,4508,16447
2022-11-09 00:00:00,2022-11-09 01:00:00,252,0,112,0,0,4024,4388,16251
2022-11-09 01:00:00,2022-11-09 02:00:00,251,0,112,0,0,3878,4241,16292
2022-11-09 02:00:00,2022-11-09 03:00:00,249,0,112,0,0,3751,4112,16632
2022-11-09 03:00:00,2022-11-09 04:00:00,250,0,112,0,0,3884,4246,17560
2022-11-09 04:00:00,2022-11-09 05:00:00,250,0,112,0,13,3949,4324,20170
2022-11-09 05:00:00,2022-11-09 06:00:00,251,0,114,25,349,3817,4556,21660
2022-11-09 06:00:00,2022-11-09 07:00:00,250,0,114,29,1386,3448,5227,22264
2022-11-09 07:00:00,2022-11-09 08:00:00,251,0,114,4,2262,2939,5570,22335
2022-11-09 08:00:00,2022-11-09 09:00:00,253,0,112,0,2591,2504,5460,22092
2022-11-09 09:00:00,2022-11-09 10:00:00,251,15,112,0,2512,2332,5222,22291
2022-11-09 10:00:00,2022-11-09 11:00:00,251,0,108,0,2243,2334,4936,22374
2022-11-09 11:00:00,2022-11-09 12:00:00,251,0,109,0,1770,2334,4464,22413
2022-11-09 12:00:00,2022-11-09 13:00:00,250,5,109,0,1120,2312,3796,22359
2022-11-09 13:00:00,2022-11-09 14:00:00,251,302,108,25,381,2498,3565,22598
2022-11-09 14:00:00,2022-11-09 15:00:00,259,719,123,29,41,3054,4225,23373
2022-11-09 15:00:00,2022-11-09 16:00:00,273,701,125,29,0,3437,4565,23622
2022-11-09 16:00:00,2022-11-09 17:00:00,257,523,116,29,0,3796,4721,23287
2022-11-09 17:00:00,2022-11-09 18:00:00,251,187,111,29,0,3909,4487,23203
2022-11-09 18:00:00,2022-11-09 19:00:00,253,34,111,4,0,3805,4207,22631
2022-11-09 19:00:00,2022-11-09 20:00:00,251,9,111,0,0,3654,4025,21114
2022-11-09 20:00:00,2022-11-09 21:00:00,258,0,110,0,0,3521,3889,19450
2022-11-09 21:00:00,2022-11-09 22:00:00,253,0,111,0,0,3437,3801,18206
2022-11-09 22:00:00,2022-11-09 23:00:00,250,0,111,0,0,3509,3870,17239
2022-11-09 23:00:00,2022-11-10 00:00:00,249,0,111,0,0,3342,3702,16547
2022-11-10 00:00:00,2022-11-10 01:00:00,252,0,111,0,0,3289,3652,16301
2022-11-10 01:00:00,2022-11-10 02:00:00,251,0,111,0,0,3210,3572,16381
2022-11-10 02:00:00,2022-11-10 03:00:00,251,0,111,0,0,3147,3509,16718
2022-11-10 03:00:00,2022-11-10 04:00:00,251,0,111,0,0,3269,3631,17763
2022-11-10 04:00:00,2022-11-10 05:00:00,250,0,112,25,12,3468,3867,20294
2022-11-10 05:00:00,2022-11-10 06:00:00,258,0,113,29,135,3588,4123,22001
2022-11-10 06:00:00,2022-11-10 07:00:00,276,0,123,4,565,3624,4592,22890
2022-11-10 07:00:00,2022-11-10 08:00:00,258,0,139,0,1069,3383,4849,23063
2022-11-10 08:00:00,2022-11-10 09:00:00,251,0,138,0,1542,3254,5185,22988
2022-11-10 09:00:00,2022-11-10 10:00:00,251,0,138,0,1840,3186,5415,23165
2022-11-10 10:00:00,2022-11-10 11:00:00,249,0,130,0,1810,3199,5388,23195
2022-11-10 11:00:00,2022-11-10 12:00:00,249,0,116,0,1550,3107,5022,22969
2022-11-10 12:00:00,2022-11-10 13:00:00,259,0,116,0,979,2916,4270,22545
2022-11-10 13:00:00,2022-11-10 14:00:00,273,100,129,0,320,2729,3551,22665
2022-11-10 14:00:00,2022-11-10 15:00:00,288,729,132,25,24,2899,4097,23223
2022-11-10 15:00:00,2022-11-10 16:00:00,296,813,143,29,0,3333,4614,23373
2022-11-10 16:00:00,2022-11-10 17:00:00,296,441,143,29,0,3575,4484,22930
2022-11-10 17:00:00,2022-11-10 18:00:00,295,311,142,29,0,3850,4627,22618
2022-11-10 18:00:00,2022-11-10 19:00:00,266,75,139,4,0,3908,4392,21879
2022-11-10 19:00:00,2022-11-10 20:00:00,252,0,139,0,0,3910,4301,20504
2022-11-10 20:00:00,2022-11-10 21:00:00,252,0,117,0,0,3901,4270,18906
2022-11-10 21:00:00,2022-11-10 22:00:00,252,0,114,0,0,3852,4218,17558
2022-11-10 22:00:00,2022-11-10 23:00:00,251,0,112,0,0,3978,4341,16599
2022-11-10 23:00:00,2022-11-11 00:00:00,251,18,112,0,0,3894,4275,15998
2022-11-11 00:00:00,2022-11-11 01:00:00,252,2,112,0,0,3887,4253,15519
2022-11-11 01:00:00,2022-11-11 02:00:00,250,0,112,0,0,3929,4291,15392
2022-11-11 02:00:00,2022-11-11 03:00:00,253,0,112,0,0,3614,3979,15256
2022-11-11 03:00:00,2022-11-11 04:00:00,252,0,112,0,0,3719,4083,15173
2022-11-11 04:00:00,2022-11-11 05:00:00,251,0,112,0,8,3941,4312,15183
2022-11-11 05:00:00,2022-11-11 06:00:00,252,0,112,0,187,4063,4614,15544
2022-11-11 06:00:00,2022-11-11 07:00:00,250,3,125,0,668,3865,4911,16650
2022-11-11 07:00:00,2022-11-11 08:00:00,251,20,133,0,1230,3649,5283,17517
2022-11-11 08:00:00,2022-11-11 09:00:00,252,0,136,0,1779,3497,5664,18133
2022-11-11 09:00:00,2022-11-11 10:00:00,251,0,126,0,1677,3536,5590,18276
2022-11-11 10:00:00,2022-11-11 11:00:00,252,0,114,0,1493,3517,5376,18423
2022-11-11 11:00:00,2022-11-11 12:00:00,252,0,114,0,1198,3376,4940,18793
2022-11-11 12:00:00,2022-11-11 13:00:00,252,0,114,0,698,3212,4276,18446
2022-11-11 13:00:00,2022-11-11 14:00:00,252,12,117,0,241,3123,3745,18265
2022-11-11 14:00:00,2022-11-11 15:00:00,252,265,150,25,39,3231,3962,18904
2022-11-11 15:00:00,2022-11-11 16:00:00,252,289,152,29,0,3348,4070,19072
2022-11-11 16:00:00,2022-11-11 17:00:00,250,283,144,29,0,3464,4170,18925
2022-11-11 17:00:00,2022-11-11 18:00:00,251,268,139,29,0,3500,4187,18666
2022-11-11 18:00:00,2022-11-11 19:00:00,250,206,139,29,0,3341,3965,18231
2022-11-11 19:00:00,2022-11-11 20:00:00,250,69,139,4,0,3145,3607,17362
2022-11-11 20:00:00,2022-11-11 21:00:00,251,98,136,0,0,3045,3530,16696
2022-11-11 21:00:00,2022-11-11 22:00:00,252,9,136,0,0,2799,3196,15728
2022-11-11 22:00:00,2022-11-11 23:00:00,251,0,135,0,0,2571,2957,14741
2022-11-11 23:00:00,2022-11-12 00:00:00,251,0,135,0,0,2450,2836,14337
2022-11-12 00:00:00,2022-11-12 01:00:00,251,0,135,0,0,2430,2816,14085
2022-11-12 01:00:00,2022-11-12 02:00:00,250,0,135,0,0,2251,2636,13968
2022-11-12 02:00:00,2022-11-12 03:00:00,252,0,135,0,0,2114,2501,14167
2022-11-12 03:00:00,2022-11-12 04:00:00,250,0,135,0,0,1887,2272,14594
2022-11-12 04:00:00,2022-11-12 05:00:00,249,0,135,0,4,1779,2167,15526
2022-11-12 05:00:00,2022-11-12 06:00:00,251,0,135,0,155,1825,2366,16357
2022-11-12 06:00:00,2022-11-12 07:00:00,250,0,134,0,706,1758,2848,17488
2022-11-12 07:00:00,2022-11-12 08:00:00,251,0,131,0,1321,1428,3131,18306
2022-11-12 08:00:00,2022-11-12 09:00:00,252,0,133,0,1762,1178,3325,18748
2022-11-12 09:00:00,2022-11-12 10:00:00,251,0,115,0,1847,1081,3294,18897
2022-11-12 10:00:00,2022-11-12 11:00:00,251,0,111,0,1664,1010,3036,18887
2022-11-12 11:00:00,2022-11-12 12:00:00,250,0,111,0,1371,947,2679,19034
2022-11-12 12:00:00,2022-11-12 13:00:00,250,0,112,0,862,828,2052,19008
2022-11-12 13:00:00,2022-11-12 14:00:00,251,44,112,0,278,721,1406,19212
2022-11-12 14:00:00,2022-11-12 15:00:00,250,498,121,25,36,590,1520,19936
2022-11-12 15:00:00,2022-11-12 16:00:00,252,977,138,29,0,483,1879,20121
2022-11-12 16:00:00,2022-11-12 17:00:00,251,726,142,29,0,429,1577,19904
2022-11-12 17:00:00,2022-11-12 18:00:00,251,486,138,29,0,344,1248,19682
2022-11-12 18:00:00,2022-11-12 19:00:00,251,191,126,29,0,287,884,19154
2022-11-12 19:00:00,2022-11-12 20:00:00,249,19,120,4,0,236,628,18164
2022-11-12 20:00:00,2022-11-12 21:00:00,251,0,111,0,0,188,550,17103
2022-11-12 21:00:00,2022-11-12 22:00:00,249,0,108,0,0,152,509,16012
2022-11-12 22:00:00,2022-11-12 23:00:00,252,0,111,0,0,174,537,15035
2022-11-12 23:00:00,2022-11-13 00:00:00,251,0,114,0,0,177,542,14509
2022-11-13 00:00:00,2022-11-13 01:00:00,250,0,113,0,0,210,573,14060
2022-11-13 01:00:00,2022-11-13 02:00:00,251,0,113,0,0,190,554,13885
2022-11-13 02:00:00,2022-11-13 03:00:00,250,0,114,0,0,163,527,13971
2022-11-13 03:00:00,2022-11-13 04:00:00,251,0,113,0,0,124,488,14193
2022-11-13 04:00:00,2022-11-13 05:00:00,251,0,113,0,8,132,504,14639
2022-11-13 05:00:00,2022-11-13 06:00:00,251,0,113,0,92,167,623,15073
2022-11-13 06:00:00,2022-11-13 07:00:00,251,0,119,0,440,174,984,16211
2022-11-13 07:00:00,2022-11-13 08:00:00,249,0,131,0,870,178,1428,17105
2022-11-13 08:00:00,2022-11-13 09:00:00,252,0,132,0,1214,233,1831,17748
2022-11-13 09:00:00,2022-11-13 10:00:00,251,0,131,0,1306,280,1968,17928
2022-11-13 10:00:00,2022-11-13 11:00:00,251,0,128,0,1338,319,2036,18122
2022-11-13 11:00:00,2022-11-13 12:00:00,251,0,120,0,1131,362,1864,18260
2022-11-13 12:00:00,2022-11-13 13:00:00,250,0,120,0,708,408,1486,18062
2022-11-13 13:00:00,2022-11-13 14:00:00,250,25,120,0,240,523,1158,17966
2022-11-13 14:00:00,2022-11-13 15:00:00,251,402,133,25,33,601,1445,18633
2022-11-13 15:00:00,2022-11-13 16:00:00,251,707,135,29,0,766,1888,19052
2022-11-13 16:00:00,2022-11-13 17:00:00,250,660,123,29,0,861,1923,19092
2022-11-13 17:00:00,2022-11-13 18:00:00,251,501,124,29,0,979,1884,19088
2022-11-13 18:00:00,2022-11-13 19:00:00,250,406,124,29,0,1045,1854,18662
2022-11-13 19:00:00,2022-11-13 20:00:00,250,38,123,4,0,1140,1555,17787
2022-11-13 20:00:00,2022-11-13 21:00:00,253,0,121,0,0,1249,1623,17018
2022-11-13 21:00:00,2022-11-13 22:00:00,251,0,121,0,0,1312,1684,16004
2022-11-13 22:00:00,2022-11-13 23:00:00,249,0,119,0,0,1478,1846,15143
2022-11-13 23:00:00,2022-11-14 00:00:00,251,0,119,0,0,1569,1939,14743
2022-11-14 00:00:00,2022-11-14 01:00:00,249,0,119,0,0,1691,2059,14596
2022-11-14 01:00:00,2022-11-14 02:00:00,249,0,119,0,0,1722,2090,14699
2022-11-14 02:00:00,2022-11-14 03:00:00,251,0,119,0,0,1670,2040,15202
2022-11-14 03:00:00,2022-11-14 04:00:00,250,0,119,0,0,1573,1942,16470
2022-11-14 04:00:00,2022-11-14 05:00:00,259,0,119,0,2,1564,1944,19719
2022-11-14 05:00:00,2022-11-14 06:00:00,273,72,119,0,92,1697,2253,21854
2022-11-14 06:00:00,2022-11-14 07:00:00,274,457,136,0,485,1665,3017,23071
2022-11-14 07:00:00,2022-11-14 08:00:00,274,493,144,0,1105,1603,3619,23558
2022-11-14 08:00:00,2022-11-14 09:00:00,273,143,144,0,1674,1594,3828,23431
2022-11-14 09:00:00,2022-11-14 10:00:00,272,84,137,3,2104,1478,4078,23556
2022-11-14 10:00:00,2022-11-14 11:00:00,273,0,130,1,2241,1326,3971,23447
2022-11-14 11:00:00,2022-11-14 12:00:00,274,0,131,4,1918,1293,3620,23351
2022-11-14 12:00:00,2022-11-14 13:00:00,274,10,130,0,1120,1351,2885,23152
2022-11-14 13:00:00,2022-11-14 14:00:00,273,341,130,0,315,1544,2603,23101
2022-11-14 14:00:00,2022-11-14 15:00:00,274,957,130,0,8,1894,3263,23758
2022-11-14 15:00:00,2022-11-14 16:00:00,273,898,144,0,0,2196,3511,24036
2022-11-14 16:00:00,2022-11-14 17:00:00,272,612,148,25,0,2219,3276,23721
2022-11-14 17:00:00,2022-11-14 18:00:00,274,521,139,29,0,2014,2977,23531
2022-11-14 18:00:00,2022-11-14 19:00:00,272,69,131,29,0,1781,2282,22972
2022-11-14 19:00:00,2022-11-14 20:00:00,259,0,130,4,0,1615,2008,21410
2022-11-14 20:00:00,2022-11-14 21:00:00,251,0,130,0,0,1401,1782,19883
2022-11-14 21:00:00,2022-11-14 22:00:00,258,0,129,0,0,1165,1552,18614
2022-11-14 22:00:00,2022-11-14 23:00:00,275,0,117,0,0,957,1349,17529
2022-11-14 23:00:00,2022-11-15 00:00:00,273,0,117,0,0,845,1235,17046
2022-11-15 00:00:00,2022-11-15 01:00:00,273,0,117,0,0,776,1166,16731
2022-11-15 01:00:00,2022-11-15 02:00:00,274,0,117,0,0,754,1145,16823
2022-11-15 02:00:00,2022-11-15 03:00:00,274,0,117,0,0,698,1089,17199
2022-11-15 03:00:00,2022-11-15 04:00:00,274,0,117,0,0,617,1008,18253
2022-11-15 04:00:00,2022-11-15 05:00:00,273,36,114,0,2,507,932,20918
2022-11-15 05:00:00,2022-11-15 06:00:00,274,514,106,0,125,442,1461,22708
2022-11-15 06:00:00,2022-11-15 07:00:00,272,668,110,0,665,392,2107,23484
2022-11-15 07:00:00,2022-11-15 08:00:00,272,379,113,0,1388,277,2429,23595
2022-11-15 08:00:00,2022-11-15 09:00:00,275,13,113,0,1840,170,2411,23079
2022-11-15 09:00:00,2022-11-15 10:00:00,273,45,115,0,2129,115,2677,23288
2022-11-15 10:00:00,2022-11-15 11:00:00,274,24,113,13,2184,79,2687,23544
2022-11-15 11:00:00,2022-11-15 12:00:00,274,0,110,14,1685,103,2186,23598
2022-11-15 12:00:00,2022-11-15 13:00:00,273,18,118,14,822,134,1379,23277
2022-11-15 13:00:00,2022-11-15 14:00:00,272,315,122,14,191,158,1072,23468
2022-11-15 14:00:00,2022-11-15 15:00:00,271,874,139,14,4,189,1491,24147
2022-11-15 15:00:00,2022-11-15 16:00:00,272,909,155,14,0,258,1608,24370
2022-11-15 16:00:00,2022-11-15 17:00:00,272,700,155,14,0,373,1514,24028
2022-11-15 17:00:00,2022-11-15 18:00:00,273,635,154,14,0,480,1556,23856
2022-11-15 18:00:00,2022-11-15 19:00:00,273,363,149,14,0,643,1442,23162
2022-11-15 19:00:00,2022-11-15 20:00:00,272,0,149,14,0,778,1213,21648
2022-11-15 20:00:00,2022-11-15 21:00:00,271,0,123,14,0,873,1281,20128
2022-11-15 21:00:00,2022-11-15 22:00:00,264,0,119,14,0,917,1314,18785
2022-11-15 22:00:00,2022-11-15 23:00:00,248,0,121,14,0,1044,1427,17619
2022-11-15 23:00:00,2022-11-16 00:00:00,253,0,122,14,0,1170,1559,17053
2022-11-16 00:00:00,2022-11-16 01:00:00,250,0,122,14,0,1394,1780,16794
2022-11-16 01:00:00,2022-11-16 02:00:00,251,0,122,14,0,1666,2053,16745
2022-11-16 02:00:00,2022-11-16 03:00:00,252,0,122,14,0,1835,2223,17095
2022-11-16 03:00:00,2022-11-16 04:00:00,257,0,121,14,0,2206,2598,18048
2022-11-16 04:00:00,2022-11-16 05:00:00,273,0,121,14,1,2552,2961,20644
2022-11-16 05:00:00,2022-11-16 06:00:00,274,0,105,14,49,2974,3416,22437
2022-11-16 06:00:00,2022-11-16 07:00:00,274,0,113,14,202,3065,3668,23491
2022-11-16 07:00:00,2022-11-16 08:00:00,272,0,118,14,400,3223,4027,23972
2022-11-16 08:00:00,2022-11-16 09:00:00,272,17,106,14,520,3149,4078,23954
2022-11-16 09:00:00,2022-11-16 10:00:00,274,244,104,14,586,3100,4322,24297
2022-11-16 10:00:00,2022-11-16 11:00:00,261,578,104,2,488,3238,4671,24395
2022-11-16 11:00:00,2022-11-16 12:00:00,273,546,106,0,386,3336,4647,24485
2022-11-16 12:00:00,2022-11-16 13:00:00,273,22,105,0,201,3325,3926,24090
2022-11-16 13:00:00,2022-11-16 14:00:00,273,14,106,0,78,3444,3915,24030
2022-11-16 14:00:00,2022-11-16 15:00:00,272,230,121,0,7,3760,4390,24623
2022-11-16 15:00:00,2022-11-16 16:00:00,271,260,130,0,0,3930,4591,24480
2022-11-16 16:00:00,2022-11-16 17:00:00,273,587,130,0,0,4116,5106,24095
2022-11-16 17:00:00,2022-11-16 18:00:00,272,918,125,0,0,4182,5497,23951
2022-11-16 18:00:00,2022-11-16 19:00:00,261,850,124,0,0,4031,5266,23344
2022-11-16 19:00:00,2022-11-16 20:00:00,257,745,123,0,0,3967,5092,21807
2022-11-16 20:00:00,2022-11-16 21:00:00,254,99,117,0,0,3938,4408,20233
2022-11-16 21:00:00,2022-11-16 22:00:00,260,0,117,0,0,3729,4106,18933
2022-11-16 22:00:00,2022-11-16 23:00:00,271,0,117,0,0,3537,3925,17744
2022-11-16 23:00:00,2022-11-17 00:00:00,271,0,118,0,0,3664,4053,17235
2022-11-17 00:00:00,2022-11-17 01:00:00,264,0,119,0,0,3739,4122,16911
2022-11-17 01:00:00,2022-11-17 02:00:00,202,0,119,0,0,3867,4188,17021
2022-11-17 02:00:00,2022-11-17 03:00:00,209,0,118,0,0,3924,4251,17293
2022-11-17 03:00:00,2022-11-17 04:00:00,259,0,117,0,0,3973,4349,18237
2022-11-17 04:00:00,2022-11-17 05:00:00,273,0,115,0,3,4030,4421,20928
2022-11-17 05:00:00,2022-11-17 06:00:00,273,0,115,0,73,4037,4498,22693
2022-11-17 06:00:00,2022-11-17 07:00:00,274,0,128,0,297,4014,4713,23827
2022-11-17 07:00:00,2022-11-17 08:00:00,271,0,141,0,680,3939,5031,24258
2022-11-17 08:00:00,2022-11-17 09:00:00,272,0,135,0,997,3787,5191,24239
2022-11-17 09:00:00,2022-11-17 10:00:00,272,0,128,0,1340,3432,5172,24668
2022-11-17 10:00:00,2022-11-17 11:00:00,271,17,119,0,1404,3134,4945,24813
2022-11-17 11:00:00,2022-11-17 12:00:00,271,137,119,0,1129,2847,4503,24803
2022-11-17 12:00:00,2022-11-17 13:00:00,271,67,125,0,563,2733,3759,24472
2022-11-17 13:00:00,2022-11-17 14:00:00,271,267,130,0,125,2516,3309,24533
2022-11-17 14:00:00,2022-11-17 15:00:00,273,668,144,37,7,2569,3698,25060
2022-11-17 15:00:00,2022-11-17 16:00:00,272,526,153,43,0,2535,3529,25031
2022-11-17 16:00:00,2022-11-17 17:00:00,270,227,145,5,0,2403,3050,24647
2022-11-17 17:00:00,2022-11-17 18:00:00,271,585,139,0,0,2188,3183,24467
2022-11-17 18:00:00,2022-11-17 19:00:00,271,574,135,0,0,2098,3078,23843
2022-11-17 19:00:00,2022-11-17 20:00:00,270,157,135,0,0,1992,2554,22385
2022-11-17 20:00:00,2022-11-17 21:00:00,270,0,118,0,0,1860,2248,20785
2022-11-17 21:00:00,2022-11-17 22:00:00,271,0,115,0,0,1812,2198,19456
2022-11-17 22:00:00,2022-11-17 23:00:00,272,0,112,0,0,1702,2086,18422
2022-11-17 23:00:00,2022-11-18 00:00:00,270,0,112,0,0,1645,2027,17831
2022-11-18 00:00:00,2022-11-18 01:00:00,270,0,112,0,0,1741,2123,17661
2022-11-18 01:00:00,2022-11-18 02:00:00,270,0,112,0,0,1678,2060,17574
2022-11-18 02:00:00,2022-11-18 03:00:00,270,0,112,0,0,1793,2175,17987
2022-11-18 03:00:00,2022-11-18 04:00:00,260,0,112,0,0,2000,2372,19036
2022-11-18 04:00:00,2022-11-18 05:00:00,272,2,112,0,3,2108,2497,21647
2022-11-18 05:00:00,2022-11-18 06:00:00,271,0,113,0,71,2510,2965,23477
2022-11-18 06:00:00,2022-11-18 07:00:00,271,82,114,0,336,2230,3033,24618
2022-11-18 07:00:00,2022-11-18 08:00:00,270,441,114,0,692,1944,3461,24981
2022-11-18 08:00:00,2022-11-18 09:00:00,270,239,128,0,1158,1916,3711,24995
2022-11-18 09:00:00,2022-11-18 10:00:00,270,25,130,0,1362,2021,3808,25341
2022-11-18 10:00:00,2022-11-18 11:00:00,270,6,118,0,1280,1985,3659,25557
2022-11-18 11:00:00,2022-11-18 12:00:00,269,318,115,0,951,2089,3742,25582
2022-11-18 12:00:00,2022-11-18 13:00:00,270,438,115,0,511,1718,3052,24906
2022-11-18 13:00:00,2022-11-18 14:00:00,270,679,130,0,133,1504,2716,24881
2022-11-18 14:00:00,2022-11-18 15:00:00,268,967,147,0,4,1446,2832,25508
2022-11-18 15:00:00,2022-11-18 16:00:00,270,865,151,0,0,1489,2775,25318
2022-11-18 16:00:00,2022-11-18 17:00:00,271,524,145,38,0,1440,2418,24889
2022-11-18 17:00:00,2022-11-18 18:00:00,270,481,140,43,0,1174,2108,24619
2022-11-18 18:00:00,2022-11-18 19:00:00,271,566,138,5,0,974,1954,24072
2022-11-18 19:00:00,2022-11-18 20:00:00,270,232,125,0,0,759,1386,22591
2022-11-18 20:00:00,2022-11-18 21:00:00,269,0,123,0,0,556,948,21233
2022-11-18 21:00:00,2022-11-18 22:00:00,244,0,119,0,0,433,796,19954
2022-11-18 22:00:00,2022-11-18 23:00:00,148,0,115,0,0,312,575,18833
2022-11-18 23:00:00,2022-11-19 00:00:00,94,0,115,0,0,216,425,18124
2022-11-19 00:00:00,2022-11-19 01:00:00,94,0,115,0,0,256,465,17848
2022-11-19 01:00:00,2022-11-19 02:00:00,94,0,115,0,0,387,596,17748
2022-11-19 02:00:00,2022-11-19 03:00:00,94,0,115,0,0,504,713,17753
2022-11-19 03:00:00,2022-11-19 04:00:00,94,0,115,0,0,609,818,18027
2022-11-19 04:00:00,2022-11-19 05:00:00,94,0,115,0,2,662,873,18944
2022-11-19 05:00:00,2022-11-19 06:00:00,94,0,115,0,97,688,994,19868
2022-11-19 06:00:00,2022-11-19 07:00:00,94,17,114,0,540,758,1523,21271
2022-11-19 07:00:00,2022-11-19 08:00:00,94,302,113,0,1276,664,2449,22045
2022-11-19 08:00:00,2022-11-19 09:00:00,95,50,112,0,1845,711,2813,22337
2022-11-19 09:00:00,2022-11-19 10:00:00,95,0,112,0,2096,889,3192,22463
2022-11-19 10:00:00,2022-11-19 11:00:00,95,0,112,0,1964,1254,3425,22504
2022-11-19 11:00:00,2022-11-19 12:00:00,95,0,111,0,1496,1545,3247,22583
2022-11-19 12:00:00,2022-11-19 13:00:00,95,0,111,0,759,1565,2530,22114
2022-11-19 13:00:00,2022-11-19 14:00:00,94,13,112,0,202,1552,1973,22000
2022-11-19 14:00:00,2022-11-19 15:00:00,94,350,125,37,5,1520,2131,22550
2022-11-19 15:00:00,2022-11-19 16:00:00,94,335,138,43,0,1708,2318,22561
2022-11-19 16:00:00,2022-11-19 17:00:00,94,291,137,5,0,1993,2520,22386
2022-11-19 17:00:00,2022-11-19 18:00:00,94,160,133,0,0,1987,2374,21992
2022-11-19 18:00:00,2022-11-19 19:00:00,94,0,125,0,0,1891,2110,21289
2022-11-19 19:00:00,2022-11-19 20:00:00,94,0,123,0,0,1776,1993,20305
2022-11-19 20:00:00,2022-11-19 21:00:00,94,0,106,0,0,1615,1815,19273
2022-11-19 21:00:00,2022-11-19 22:00:00,94,0,105,0,0,1597,1796,18100
2022-11-19 22:00:00,2022-11-19 23:00:00,81,0,102,0,0,1488,1671,17151
2022-11-19 23:00:00,2022-11-20 00:00:00,76,39,101,0,0,1334,1550,16506
2022-11-20 00:00:00,2022-11-20 01:00:00,76,3,99,0,0,1329,1507,16196
2022-11-20 01:00:00,2022-11-20 02:00:00,76,44,100,0,0,1183,1403,16020
2022-11-20 02:00:00,2022-11-20 03:00:00,76,10,101,0,0,1130,1317,16113
2022-11-20 03:00:00,2022-11-20 04:00:00,76,0,100,0,0,1212,1388,16276
2022-11-20 04:00:00,2022-11-20 05:00:00,76,0,100,0,3,1256,1435,16805
2022-11-20 05:00:00,2022-11-20 06:00:00,76,0,103,0,138,1250,1567,17202
2022-11-20 06:00:00,2022-11-20 07:00:00,76,0,121,0,631,1177,2005,18123
2022-11-20 07:00:00,2022-11-20 08:00:00,76,0,122,0,1393,968,2559,19054
2022-11-20 08:00:00,2022-11-20 09:00:00,76,0,120,0,1833,726,2755,19534
2022-11-20 09:00:00,2022-11-20 10:00:00,76,18,107,0,1927,698,2826,19570
2022-11-20 10:00:00,2022-11-20 11:00:00,79,239,108,0,1787,712,2925,19891
2022-11-20 11:00:00,2022-11-20 12:00:00,83,33,109,0,1328,774,2327,20019
2022-11-20 12:00:00,2022-11-20 13:00:00,89,0,116,0,758,859,1822,19957
2022-11-20 13:00:00,2022-11-20 14:00:00,95,221,116,0,177,981,1590,19852
2022-11-20 14:00:00,2022-11-20 15:00:00,95,215,134,0,5,1206,1655,20579
2022-11-20 15:00:00,2022-11-20 16:00:00,94,431,136,38,0,1451,2150,20757
2022-11-20 16:00:00,2022-11-20 17:00:00,95,258,129,43,0,1727,2252,20804
2022-11-20 17:00:00,2022-11-20 18:00:00,94,0,128,5,0,1804,2031,20844
2022-11-20 18:00:00,2022-11-20 19:00:00,94,0,112,0,0,1899,2105,20325
2022-11-20 19:00:00,2022-11-20 20:00:00,81,0,106,0,0,1894,2081,19467
2022-11-20 20:00:00,2022-11-20 21:00:00,76,0,102,0,0,1754,1932,18822
2022-11-20 21:00:00,2022-11-20 22:00:00,79,0,102,0,0,1585,1766,17731
2022-11-20 22:00:00,2022-11-20 23:00:00,94,0,104,0,0,1388,1586,16904
2022-11-20 23:00:00,2022-11-21 00:00:00,94,0,104,0,0,1210,1408,16546
2022-11-21 00:00:00,2022-11-21 01:00:00,94,0,106,0,0,1341,1541,16351
2022-11-21 01:00:00,2022-11-21 02:00:00,94,0,103,0,0,1458,1655,16435
2022-11-21 02:00:00,2022-11-21 03:00:00,94,0,103,0,0,1472,1669,16929
2022-11-21 03:00:00,2022-11-21 04:00:00,95,0,103,0,0,1434,1632,18143
2022-11-21 04:00:00,2022-11-21 05:00:00,95,0,104,0,1,1437,1637,21344
2022-11-21 05:00:00,2022-11-21 06:00:00,95,0,105,0,95,1293,1588,23387
2022-11-21 06:00:00,2022-11-21 07:00:00,96,0,118,0,364,1262,1840,24574
2022-11-21 07:00:00,2022-11-21 08:00:00,96,0,135,0,649,1277,2157,24892
2022-11-21 08:00:00,2022-11-21 09:00:00,96,0,124,0,1040,1136,2396,24885
2022-11-21 09:00:00,2022-11-21 10:00:00,95,0,123,0,1128,908,2254,25082
2022-11-21 10:00:00,2022-11-21 11:00:00,95,29,115,0,1088,808,2135,25293
2022-11-21 11:00:00,2022-11-21 12:00:00,95,95,113,0,838,869,2010,25482
2022-11-21 12:00:00,2022-11-21 13:00:00,95,203,121,0,445,889,1753,25203
2022-11-21 13:00:00,2022-11-21 14:00:00,96,549,123,0,151,759,1678,25252
2022-11-21 14:00:00,2022-11-21 15:00:00,95,949,143,0,4,783,1974,25792
2022-11-21 15:00:00,2022-11-21 16:00:00,95,822,149,0,0,664,1730,25785
2022-11-21 16:00:00,2022-11-21 17:00:00,95,631,146,38,0,604,1514,25252
2022-11-21 17:00:00,2022-11-21 18:00:00,95,596,137,43,0,555,1426,25061
2022-11-21 18:00:00,2022-11-21 19:00:00,95,275,121,5,0,494,990,24447
2022-11-21 19:00:00,2022-11-21 20:00:00,95,16,119,0,0,397,627,22951
2022-11-21 20:00:00,2022-11-21 21:00:00,95,0,109,0,0,415,619,21266
2022-11-21 21:00:00,2022-11-21 22:00:00,94,0,108,0,0,429,631,19849
2022-11-21 22:00:00,2022-11-21 23:00:00,95,0,106,0,0,445,646,18833
2022-11-21 23:00:00,2022-11-22 00:00:00,95,0,106,0,0,574,775,18362
2022-11-22 00:00:00,2022-11-22 01:00:00,95,0,106,0,0,648,849,18094
2022-11-22 01:00:00,2022-11-22 02:00:00,95,0,106,0,0,691,892,18207
2022-11-22 02:00:00,2022-11-22 03:00:00,95,0,106,0,0,783,984,18611
2022-11-22 03:00:00,2022-11-22 04:00:00,95,0,106,0,0,822,1023,19642
2022-11-22 04:00:00,2022-11-22 05:00:00,95,0,106,0,1,906,1108,22251
2022-11-22 05:00:00,2022-11-22 06:00:00,95,139,106,0,66,1049,1455,24086
2022-11-22 06:00:00,2022-11-22 07:00:00,96,433,127,34,350,1069,2109,24932
2022-11-22 07:00:00,2022-11-22 08:00:00,96,385,145,43,781,1148,2598,25156
2022-11-22 08:00:00,2022-11-22 09:00:00,96,278,140,5,1149,1324,2992,24918
2022-11-22 09:00:00,2022-11-22 10:00:00,96,23,138,0,1342,1484,3083,25087
2022-11-22 10:00:00,2022-11-22 11:00:00,96,29,129,0,1147,1563,2964,25050
2022-11-22 11:00:00,2022-11-22 12:00:00,96,35,134,0,793,1596,2654,25086
2022-11-22 12:00:00,2022-11-22 13:00:00,97,23,128,0,332,1630,2210,24884
2022-11-22 13:00:00,2022-11-22 14:00:00,97,184,127,0,93,1883,2384,25074
2022-11-22 14:00:00,2022-11-22 15:00:00,96,212,149,0,4,2116,2577,25631
2022-11-22 15:00:00,2022-11-22 16:00:00,97,245,153,0,0,2406,2901,25352
2022-11-22 16:00:00,2022-11-22 17:00:00,96,285,145,0,0,2428,2954,24692
2022-11-22 17:00:00,2022-11-22 18:00:00,97,211,138,0,0,2350,2796,24766
2022-11-22 18:00:00,2022-11-22 19:00:00,96,0,129,0,0,2031,2256,24127
2022-11-22 19:00:00,2022-11-22 20:00:00,95,0,128,0,0,1831,2054,22673
2022-11-22 20:00:00,2022-11-22 21:00:00,95,0,122,0,0,1775,1992,21052
2022-11-22 21:00:00,2022-11-22 22:00:00,95,0,118,0,0,1745,1958,19741
2022-11-22 22:00:00,2022-11-22 23:00:00,95,0,117,0,0,1708,1920,18640
2022-11-22 23:00:00,2022-11-23 00:00:00,95,0,118,0,0,1523,1736,18159
2022-11-23 00:00:00,2022-11-23 01:00:00,95,0,118,0,0,1370,1583,17979
2022-11-23 01:00:00,2022-11-23 02:00:00,95,0,117,0,0,1165,1377,18061
2022-11-23 02:00:00,2022-11-23 03:00:00,95,0,113,0,0,1135,1343,18347
2022-11-23 03:00:00,2022-11-23 04:00:00,95,0,111,0,0,1232,1438,19394
2022-11-23 04:00:00,2022-11-23 05:00:00,95,0,113,0,1,1147,1356,22095
2022-11-23 05:00:00,2022-11-23 06:00:00,95,129,108,0,45,1087,1464,24010
2022-11-23 06:00:00,2022-11-23 07:00:00,95,390,122,0,217,999,1823,25037
2022-11-23 07:00:00,2022-11-23 08:00:00,96,321,130,0,434,858,1839,25371
2022-11-23 08:00:00,2022-11-23 09:00:00,97,10,122,0,681,813,1723,25354
2022-11-23 09:00:00,2022-11-23 10:00:00,97,0,116,0,881,717,1811,25674
2022-11-23 10:00:00,2022-11-23 11:00:00,97,0,115,0,783,575,1570,25587
2022-11-23 11:00:00,2022-11-23 12:00:00,97,126,114,0,624,509,1470,25736
2022-11-23 12:00:00,2022-11-23 13:00:00,97,135,116,0,284,508,1140,25391
2022-11-23 13:00:00,2022-11-23 14:00:00,97,94,117,0,108,605,1021,25434
2022-11-23 14:00:00,2022-11-23 15:00:00,96,794,142,37,4,734,1807,25925
2022-11-23 15:00:00,2022-11-23 16:00:00,96,645,149,43,0,796,1729,25795
2022-11-23 16:00:00,2022-11-23 17:00:00,96,554,150,5,0,851,1656,25402
2022-11-23 17:00:00,2022-11-23 18:00:00,96,618,136,0,0,809,1659,25229
2022-11-23 18:00:00,2022-11-23 19:00:00,96,274,118,0,0,715,1203,24594
2022-11-23 19:00:00,2022-11-23 20:00:00,95,0,118,0,0,553,766,23123
2022-11-23 20:00:00,2022-11-23 21:00:00,95,0,113,0,0,500,708,21556
2022-11-23 21:00:00,2022-11-23 22:00:00,95,0,109,0,0,410,614,20165
2022-11-23 22:00:00,2022-11-23 23:00:00,95,0,109,0,0,294,498,19093
2022-11-23 23:00:00,2022-11-24 00:00:00,95,0,109,0,0,254,458,18534
2022-11-24 00:00:00,2022-11-24 01:00:00,95,0,109,0,0,221,425,18222
2022-11-24 01:00:00,2022-11-24 02:00:00,95,0,109,0,0,197,401,18210
2022-11-24 02:00:00,2022-11-24 03:00:00,95,0,109,0,0,181,385,18637
2022-11-24 03:00:00,2022-11-24 04:00:00,95,0,109,0,0,146,350,19592
2022-11-24 04:00:00,2022-11-24 05:00:00,95,17,109,0,0,120,341,22287
2022-11-24 05:00:00,2022-11-24 06:00:00,96,139,109,0,44,100,488,24252
2022-11-24 06:00:00,2022-11-24 07:00:00,96,129,110,0,139,83,557,25365
2022-11-24 07:00:00,2022-11-24 08:00:00,96,146,110,0,299,62,713,25813
2022-11-24 08:00:00,2022-11-24 09:00:00,96,328,132,0,467,42,1065,25881
2022-11-24 09:00:00,2022-11-24 10:00:00,96,369,125,0,542,47,1179,26222
2022-11-24 10:00:00,2022-11-24 11:00:00,96,321,117,0,519,32,1085,26287
2022-11-24 11:00:00,2022-11-24 12:00:00,96,321,116,0,518,29,1080,26522
2022-11-24 12:00:00,2022-11-24 13:00:00,96,470,116,0,267,34,983,26045
2022-11-24 13:00:00,2022-11-24 14:00:00,96,627,128,0,96,31,978,25773
2022-11-24 14:00:00,2022-11-24 15:00:00,96,682,143,0,3,40,964,26266
2022-11-24 15:00:00,2022-11-24 16:00:00,96,638,145,38,0,37,954,26117
2022-11-24 16:00:00,2022-11-24 17:00:00,96,350,135,43,0,41,665,25701
2022-11-24 17:00:00,2022-11-24 18:00:00,96,409,121,5,0,42,673,25519
2022-11-24 18:00:00,2022-11-24 19:00:00,96,216,116,0,0,50,478,24849
2022-11-24 19:00:00,2022-11-24 20:00:00,95,0,112,0,0,57,264,23353
2022-11-24 20:00:00,2022-11-24 21:00:00,95,0,106,0,0,54,255,21701
2022-11-24 21:00:00,2022-11-24 22:00:00,95,0,106,0,0,57,258,20243
2022-11-24 22:00:00,2022-11-24 23:00:00,95,0,104,0,0,79,278,19124
2022-11-24 23:00:00,2022-11-25 00:00:00,95,0,104,0,0,75,274,18517
2022-11-25 00:00:00,2022-11-25 01:00:00,95,0,104,0,0,102,301,18234
2022-11-25 01:00:00,2022-11-25 02:00:00,95,0,104,0,0,102,301,18281
2022-11-25 02:00:00,2022-11-25 03:00:00,155,0,104,0,0,105,364,18704
2022-11-25 03:00:00,2022-11-25 04:00:00,195,0,104,0,0,101,400,19653
2022-11-25 04:00:00,2022-11-25 05:00:00,224,0,105,0,0,91,420,22280
2022-11-25 05:00:00,2022-11-25 06:00:00,248,23,110,0,32,118,531,24086
2022-11-25 06:00:00,2022-11-25 07:00:00,259,119,115,0,148,123,764,25150
2022-11-25 07:00:00,2022-11-25 08:00:00,268,50,115,0,413,116,962,25600
2022-11-25 08:00:00,2022-11-25 09:00:00,272,18,123,0,653,88,1154,25592
2022-11-25 09:00:00,2022-11-25 10:00:00,272,17,118,0,754,53,1214,25873
2022-11-25 10:00:00,2022-11-25 11:00:00,274,24,120,0,786,57,1261,25911
2022-11-25 11:00:00,2022-11-25 12:00:00,273,13,120,0,583,57,1046,25935
2022-11-25 12:00:00,2022-11-25 13:00:00,272,18,120,0,350,50,810,25412
2022-11-25 13:00:00,2022-11-25 14:00:00,273,352,121,0,115,96,957,25344
2022-11-25 14:00:00,2022-11-25 15:00:00,274,506,135,38,3,146,1102,25771
2022-11-25 15:00:00,2022-11-25 16:00:00,273,490,139,43,0,193,1138,25568
2022-11-25 16:00:00,2022-11-25 17:00:00,272,76,136,5,0,254,743,25042
2022-11-25 17:00:00,2022-11-25 18:00:00,272,0,131,0,0,275,678,24676
2022-11-25 18:00:00,2022-11-25 19:00:00,274,0,127,0,0,287,688,24028
2022-11-25 19:00:00,2022-11-25 20:00:00,273,0,111,0,0,347,731,22577
2022-11-25 20:00:00,2022-11-25 21:00:00,271,0,106,0,0,292,669,21025
2022-11-25 21:00:00,2022-11-25 22:00:00,269,0,106,0,0,285,660,19701
2022-11-25 22:00:00,2022-11-25 23:00:00,262,0,105,0,0,264,631,18597
2022-11-25 23:00:00,2022-11-26 00:00:00,260,0,105,0,0,231,596,17917
2022-11-26 00:00:00,2022-11-26 01:00:00,258,0,105,0,0,221,584,17461
2022-11-26 01:00:00,2022-11-26 02:00:00,260,0,105,0,0,228,593,17329
2022-11-26 02:00:00,2022-11-26 03:00:00,261,0,104,0,0,235,600,17404
2022-11-26 03:00:00,2022-11-26 04:00:00,260,11,104,0,0,236,611,17641
2022-11-26 04:00:00,2022-11-26 05:00:00,260,165,104,0,0,290,819,18543
2022-11-26 05:00:00,2022-11-26 06:00:00,260,40,103,0,28,321,752,19491
2022-11-26 06:00:00,2022-11-26 07:00:00,260,13,118,0,136,327,854,20790
2022-11-26 07:00:00,2022-11-26 08:00:00,260,395,130,0,338,297,1420,21791
2022-11-26 08:00:00,2022-11-26 09:00:00,259,133,131,0,556,266,1345,22382
2022-11-26 09:00:00,2022-11-26 10:00:00,263,388,127,0,644,226,1648,22668
2022-11-26 10:00:00,2022-11-26 11:00:00,274,489,122,0,625,195,1705,22619
2022-11-26 11:00:00,2022-11-26 12:00:00,273,323,121,0,406,167,1290,22580
2022-11-26 12:00:00,2022-11-26 13:00:00,273,127,121,0,192,228,941,21955
2022-11-26 13:00:00,2022-11-26 14:00:00,273,524,126,0,76,290,1289,21827
2022-11-26 14:00:00,2022-11-26 15:00:00,273,640,139,0,3,347,1402,22352
2022-11-26 15:00:00,2022-11-26 16:00:00,272,713,141,37,0,337,1500,22196
2022-11-26 16:00:00,2022-11-26 17:00:00,272,393,134,43,0,272,1114,21706
2022-11-26 17:00:00,2022-11-26 18:00:00,272,194,131,5,0,278,880,21357
2022-11-26 18:00:00,2022-11-26 19:00:00,273,100,128,0,0,284,785,20726
2022-11-26 19:00:00,2022-11-26 20:00:00,272,27,118,0,0,305,722,19644
2022-11-26 20:00:00,2022-11-26 21:00:00,272,51,118,0,0,265,706,18693
2022-11-26 21:00:00,2022-11-26 22:00:00,269,0,116,0,0,249,634,17581
2022-11-26 22:00:00,2022-11-26 23:00:00,252,0,105,0,0,228,585,16490
2022-11-26 23:00:00,2022-11-27 00:00:00,252,0,106,0,0,285,643,15891
2022-11-27 00:00:00,2022-11-27 01:00:00,253,0,106,0,0,316,675,15491
2022-11-27 01:00:00,2022-11-27 02:00:00,252,0,106,0,0,291,649,15367
2022-11-27 02:00:00,2022-11-27 03:00:00,252,0,106,0,0,264,622,15476
2022-11-27 03:00:00,2022-11-27 04:00:00,253,0,106,0,0,221,580,15578
2022-11-27 04:00:00,2022-11-27 05:00:00,253,0,105,0,0,201,559,15982
2022-11-27 05:00:00,2022-11-27 06:00:00,253,1,105,0,24,190,573,16284
2022-11-27 06:00:00,2022-11-27 07:00:00,257,0,106,0,163,204,730,17238
2022-11-27 07:00:00,2022-11-27 08:00:00,259,76,105,0,440,210,1090,18358
2022-11-27 08:00:00,2022-11-27 09:00:00,261,270,106,0,741,198,1576,19123
2022-11-27 09:00:00,2022-11-27 10:00:00,261,274,105,0,1013,182,1835,19635
2022-11-27 10:00:00,2022-11-27 11:00:00,259,265,105,0,1048,139,1816,19822
2022-11-27 11:00:00,2022-11-27 12:00:00,269,434,105,0,753,138,1699,19810
2022-11-27 12:00:00,2022-11-27 13:00:00,274,616,112,0,390,173,1565,19504
2022-11-27 13:00:00,2022-11-27 14:00:00,273,371,114,0,108,299,1165,19329
2022-11-27 14:00:00,2022-11-27 15:00:00,273,289,139,0,3,505,1209,20130
2022-11-27 15:00:00,2022-11-27 16:00:00,273,310,141,38,0,650,1412,20245
2022-11-27 16:00:00,2022-11-27 17:00:00,272,357,140,43,0,742,1554,20240
2022-11-27 17:00:00,2022-11-27 18:00:00,273,199,137,5,0,822,1436,20285
2022-11-27 18:00:00,2022-11-27 19:00:00,273,114,129,0,0,864,1380,19891
2022-11-27 19:00:00,2022-11-27 20:00:00,264,14,124,0,0,907,1309,19085
2022-11-27 20:00:00,2022-11-27 21:00:00,261,0,107,0,0,959,1327,18322
2022-11-27 21:00:00,2022-11-27 22:00:00,257,0,105,0,0,1032,1394,17317
2022-11-27 22:00:00,2022-11-27 23:00:00,270,0,105,0,0,1232,1607,16416
2022-11-27 23:00:00,2022-11-28 00:00:00,272,0,105,0,0,1308,1685,15929
2022-11-28 00:00:00,2022-11-28 01:00:00,273,0,105,0,0,1375,1753,15819
2022-11-28 01:00:00,2022-11-28 02:00:00,272,0,105,0,0,1385,1762,15826
2022-11-28 02:00:00,2022-11-28 03:00:00,271,0,105,0,0,1382,1758,16224
2022-11-28 03:00:00,2022-11-28 04:00:00,273,0,105,0,0,1707,2085,17611
2022-11-28 04:00:00,2022-11-28 05:00:00,272,25,105,38,0,1973,2413,20792
2022-11-28 05:00:00,2022-11-28 06:00:00,271,76,105,43,43,2069,2607,22917
2022-11-28 06:00:00,2022-11-28 07:00:00,272,124,106,5,370,2033,2910,23991
2022-11-28 07:00:00,2022-11-28 08:00:00,272,107,130,0,1009,1953,3471,24520
2022-11-28 08:00:00,2022-11-28 09:00:00,271,86,127,0,1662,1787,3933,24655
2022-11-28 09:00:00,2022-11-28 10:00:00,269,42,127,0,1692,1691,3821,24702
2022-11-28 10:00:00,2022-11-28 11:00:00,272,55,123,0,1597,1718,3765,24803
2022-11-28 11:00:00,2022-11-28 12:00:00,273,55,120,0,1133,1823,3404,24854
2022-11-28 12:00:00,2022-11-28 13:00:00,272,107,127,0,643,1962,3111,24490
2022-11-28 13:00:00,2022-11-28 14:00:00,273,390,129,0,176,2322,3290,24459
2022-11-28 14:00:00,2022-11-28 15:00:00,271,536,148,0,0,2793,3748,25029
2022-11-28 15:00:00,2022-11-28 16:00:00,272,401,157,0,0,3119,3949,24858
2022-11-28 16:00:00,2022-11-28 17:00:00,273,353,148,0,0,3331,4105,24565
2022-11-28 17:00:00,2022-11-28 18:00:00,272,285,140,0,0,3387,4084,24466
2022-11-28 18:00:00,2022-11-28 19:00:00,271,540,116,0,0,3233,4160,23767
2022-11-28 19:00:00,2022-11-28 20:00:00,273,189,108,0,0,3155,3725,22210
2022-11-28 20:00:00,2022-11-28 21:00:00,271,20,107,0,0,3165,3563,20746
2022-11-28 21:00:00,2022-11-28 22:00:00,271,0,107,0,0,3115,3493,19332
2022-11-28 22:00:00,2022-11-28 23:00:00,250,0,112,0,0,2947,3309,18257
2022-11-28 23:00:00,2022-11-29 00:00:00,142,0,118,0,0,2879,3139,17710
2022-11-29 00:00:00,2022-11-29 01:00:00,250,0,118,0,0,2747,3115,17429
2022-11-29 01:00:00,2022-11-29 02:00:00,262,0,119,0,0,2672,3053,17602
2022-11-29 02:00:00,2022-11-29 03:00:00,270,0,119,0,0,2694,3083,17951
2022-11-29 03:00:00,2022-11-29 04:00:00,272,0,118,0,0,2656,3046,18844
2022-11-29 04:00:00,2022-11-29 05:00:00,271,0,117,0,0,2720,3108,21668
2022-11-29 05:00:00,2022-11-29 06:00:00,272,0,122,0,39,2726,3159,23672
2022-11-29 06:00:00,2022-11-29 07:00:00,277,0,127,0,271,2746,3421,24606
2022-11-29 07:00:00,2022-11-29 08:00:00,290,105,127,0,686,2585,3793,24952
2022-11-29 08:00:00,2022-11-29 09:00:00,291,32,124,0,1043,2377,3867,24912
2022-11-29 09:00:00,2022-11-29 10:00:00,289,0,119,0,1068,2146,3622,25089
2022-11-29 10:00:00,2022-11-29 11:00:00,289,85,118,0,938,1996,3426,25111
2022-11-29 11:00:00,2022-11-29 12:00:00,289,114,118,0,731,1878,3130,25248
2022-11-29 12:00:00,2022-11-29 13:00:00,289,44,128,0,502,1874,2837,25167
2022-11-29 13:00:00,2022-11-29 14:00:00,290,11,135,0,101,1943,2480,25124
2022-11-29 14:00:00,2022-11-29 15:00:00,290,294,146,38,0,1966,2734,25646
2022-11-29 15:00:00,2022-11-29 16:00:00,289,178,149,43,0,1936,2595,25451
2022-11-29 16:00:00,2022-11-29 17:00:00,291,11,134,5,0,1845,2286,25065
2022-11-29 17:00:00,2022-11-29 18:00:00,289,55,133,0,0,1728,2205,24932
2022-11-29 18:00:00,2022-11-29 19:00:00,288,111,116,0,0,1598,2113,24302
2022-11-29 19:00:00,2022-11-29 20:00:00,290,131,111,0,0,1521,2053,22681
2022-11-29 20:00:00,2022-11-29 21:00:00,289,77,103,0,0,1396,1865,21183
2022-11-29 21:00:00,2022-11-29 22:00:00,275,0,103,0,0,1316,1694,19870
2022-11-29 22:00:00,2022-11-29 23:00:00,271,0,105,0,0,1258,1634,18740
2022-11-29 23:00:00,2022-11-30 00:00:00,272,0,105,0,0,1185,1562,18205
2022-11-30 00:00:00,2022-11-30 01:00:00,273,0,105,0,0,1140,1518,17883
2022-11-30 01:00:00,2022-11-30 02:00:00,274,0,105,0,0,1077,1456,17950
2022-11-30 02:00:00,2022-11-30 03:00:00,271,0,105,0,0,1089,1465,18307
2022-11-30 03:00:00,2022-11-30 04:00:00,271,0,105,0,0,1104,1480,19270
2022-11-30 04:00:00,2022-11-30 05:00:00,274,23,105,0,0,1073,1475,22104
2022-11-30 05:00:00,2022-11-30 06:00:00,285,98,105,0,44,1110,1642,24147
2022-11-30 06:00:00,2022-11-30 07:00:00,288,257,124,0,163,1052,1884,25126
2022-11-30 07:00:00,2022-11-30 08:00:00,293,181,136,0,482,985,2077,25706
2022-11-30 08:00:00,2022-11-30 09:00:00,296,324,133,0,706,898,2357,25820
2022-11-30 09:00:00,2022-11-30 10:00:00,295,422,133,0,700,836,2386,26127
2022-11-30 10:00:00,2022-11-30 11:00:00,295,601,134,0,556,847,2433,26189
2022-11-30 11:00:00,2022-11-30 12:00:00,293,487,134,0,402,878,2194,26194
2022-11-30 12:00:00,2022-11-30 13:00:00,292,165,136,0,202,924,1719,25742
2022-11-30 13:00:00,2022-11-30 14:00:00,293,219,141,38,72,967,1730,25658
2022-11-30 14:00:00,2022-11-30 15:00:00,292,620,153,43,0,1033,2141,26094
2022-11-30 15:00:00,2022-11-30 16:00:00,293,602,154,5,0,1040,2094,25710
2022-11-30 16:00:00,2022-11-30 17:00:00,294,361,141,0,0,1129,1925,25321
2022-11-30 17:00:00,2022-11-30 18:00:00,293,308,139,0,0,1153,1893,25126
2022-11-30 18:00:00,2022-11-30 19:00:00,296,159,136,0,0,1129,1720,24078
2022-11-30 19:00:00,2022-11-30 20:00:00,294,0,120,0,0,1034,1448,22508
2022-11-30 20:00:00,2022-11-30 21:00:00,291,0,108,0,0,901,1300,21382
2022-11-30 21:00:00,2022-11-30 22:00:00,285,0,108,0,0,805,1198,20055
2022-11-30 22:00:00,2022-11-30 23:00:00,270,0,106,0,0,712,1088,18941
2022-11-30 23:00:00,2022-12-01 00:00:00,266,0,106,0,0,642,1014,18312
2022-12-01 00:00:00,2022-12-01 01:00:00,267,0,106,0,0,648,1021,18035
2022-12-01 01:00:00,2022-12-01 02:00:00,268,0,106,0,0,615,989,18051
2022-12-01 02:00:00,2022-12-01 03:00:00,267,0,106,0,0,578,951,18413
2022-12-01 03:00:00,2022-12-01 04:00:00,266,11,106,0,0,543,926,19289
2022-12-01 04:00:00,2022-12-01 05:00:00,268,55,106,0,0,491,920,21942
2022-12-01 05:00:00,2022-12-01 06:00:00,280,0,106,0,30,449,865,23929
2022-12-01 06:00:00,2022-12-01 07:00:00,285,112,111,0,110,414,1032,25013
2022-12-01 07:00:00,2022-12-01 08:00:00,286,168,128,0,269,399,1250,25481
2022-12-01 08:00:00,2022-12-01 09:00:00,288,158,134,0,428,336,1344,25598
2022-12-01 09:00:00,2022-12-01 10:00:00,287,103,131,0,485,288,1294,25972
2022-12-01 10:00:00,2022-12-01 11:00:00,286,115,115,0,449,285,1250,26122
2022-12-01 11:00:00,2022-12-01 12:00:00,286,171,122,0,307,305,1191,26155
2022-12-01 12:00:00,2022-12-01 13:00:00,287,181,125,0,140,367,1100,25700
2022-12-01 13:00:00,2022-12-01 14:00:00,284,276,130,0,78,427,1195,25742
2022-12-01 14:00:00,2022-12-01 15:00:00,286,474,139,38,0,480,1417,26069
2022-12-01 15:00:00,2022-12-01 16:00:00,287,399,143,43,0,531,1403,25734
2022-12-01 16:00:00,2022-12-01 17:00:00,285,326,144,5,0,581,1341,25362
2022-12-01 17:00:00,2022-12-01 18:00:00,286,406,144,0,0,529,1365,25131
2022-12-01 18:00:00,2022-12-01 19:00:00,286,340,130,0,0,483,1239,24489
2022-12-01 19:00:00,2022-12-01 20:00:00,282,84,129,0,0,465,960,22974
2022-12-01 20:00:00,2022-12-01 21:00:00,282,0,111,0,0,506,899,21522
2022-12-01 21:00:00,2022-12-01 22:00:00,269,0,109,0,0,511,889,20101
2022-12-01 22:00:00,2022-12-01 23:00:00,268,0,109,0,0,544,921,19108
2022-12-01 23:00:00,2022-12-02 00:00:00,262,0,109,0,0,556,927,18452
2022-12-02 00:00:00,2022-12-02 01:00:00,256,0,109,0,0,577,942,18189
2022-12-02 01:00:00,2022-12-02 02:00:00,258,0,114,0,0,617,989,18145
2022-12-02 02:00:00,2022-12-02 03:00:00,264,0,114,0,0,651,1029,18539
2022-12-02 03:00:00,2022-12-02 04:00:00,264,0,115,0,0,734,1113,19594
2022-12-02 04:00:00,2022-12-02 05:00:00,261,51,115,0,0,793,1220,22339
2022-12-02 05:00:00,2022-12-02 06:00:00,272,253,115,0,44,887,1571,24396
2022-12-02 06:00:00,2022-12-02 07:00:00,282,578,125,0,95,967,2047,25366
2022-12-02 07:00:00,2022-12-02 08:00:00,286,557,141,0,210,890,2084,25888
2022-12-02 08:00:00,2022-12-02 09:00:00,286,481,136,0,351,769,2023,26014
2022-12-02 09:00:00,2022-12-02 10:00:00,286,579,132,0,408,758,2163,26352
2022-12-02 10:00:00,2022-12-02 11:00:00,285,412,133,0,403,795,2028,26435
2022-12-02 11:00:00,2022-12-02 12:00:00,284,343,133,0,332,807,1899,26537
2022-12-02 12:00:00,2022-12-02 13:00:00,285,135,133,0,174,854,1581,26054
2022-12-02 13:00:00,2022-12-02 14:00:00,286,23,137,0,88,908,1442,26095
2022-12-02 14:00:00,2022-12-02 15:00:00,286,314,154,38,0,1022,1814,26226
2022-12-02 15:00:00,2022-12-02 16:00:00,287,243,156,43,0,1007,1736,25917
2022-12-02 16:00:00,2022-12-02 17:00:00,285,176,142,5,0,1029,1637,25487
2022-12-02 17:00:00,2022-12-02 18:00:00,286,15,139,0,0,932,1372,25120
2022-12-02 18:00:00,2022-12-02 19:00:00,287,0,131,0,0,848,1266,24380
2022-12-02 19:00:00,2022-12-02 20:00:00,284,0,130,0,0,821,1235,22898
2022-12-02 20:00:00,2022-12-02 21:00:00,286,0,130,0,0,793,1209,21417
2022-12-02 21:00:00,2022-12-02 22:00:00,273,0,130,0,0,737,1140,20187
2022-12-02 22:00:00,2022-12-02 23:00:00,268,0,127,0,0,735,1130,19011
2022-12-02 23:00:00,2022-12-03 00:00:00,269,0,126,0,0,712,1107,18344
2022-12-03 00:00:00,2022-12-03 01:00:00,266,0,126,0,0,718,1110,17872
2022-12-03 01:00:00,2022-12-03 02:00:00,268,0,126,0,0,777,1171,17758
2022-12-03 02:00:00,2022-12-03 03:00:00,267,0,126,0,0,785,1178,17946
2022-12-03 03:00:00,2022-12-03 04:00:00,268,0,127,0,0,764,1159,18181
2022-12-03 04:00:00,2022-12-03 05:00:00,269,0,126,0,0,755,1150,19094
2022-12-03 05:00:00,2022-12-03 06:00:00,272,0,126,0,39,736,1173,19931
2022-12-03 06:00:00,2022-12-03 07:00:00,281,17,126,0,120,695,1239,21242
2022-12-03 07:00:00,2022-12-03 08:00:00,286,368,126,0,330,640,1750,22427
2022-12-03 08:00:00,2022-12-03 09:00:00,286,675,127,0,571,547,2206,22963
2022-12-03 09:00:00,2022-12-03 10:00:00,285,538,127,0,672,461,2083,23170
2022-12-03 10:00:00,2022-12-03 11:00:00,283,402,126,0,683,433,1927,23052
2022-12-03 11:00:00,2022-12-03 12:00:00,287,285,126,0,517,430,1645,22970
2022-12-03 12:00:00,2022-12-03 13:00:00,285,29,126,0,319,495,1254,22507
2022-12-03 13:00:00,2022-12-03 14:00:00,284,55,131,0,131,617,1218,22387
2022-12-03 14:00:00,2022-12-03 15:00:00,287,304,143,38,0,774,1546,22805
2022-12-03 15:00:00,2022-12-03 16:00:00,287,74,145,43,0,874,1423,22530
2022-12-03 16:00:00,2022-12-03 17:00:00,282,118,136,5,0,943,1484,22216
2022-12-03 17:00:00,2022-12-03 18:00:00,280,186,134,0,0,953,1553,21908
2022-12-03 18:00:00,2022-12-03 19:00:00,281,49,132,0,0,980,1442,21208
2022-12-03 19:00:00,2022-12-03 20:00:00,281,4,132,0,0,983,1400,20154
2022-12-03 20:00:00,2022-12-03 21:00:00,280,0,124,0,0,1058,1462,19116
2022-12-03 21:00:00,2022-12-03 22:00:00,268,0,111,0,0,1187,1566,17759
2022-12-03 22:00:00,2022-12-03 23:00:00,268,0,110,0,0,1237,1615,16682
2022-12-03 23:00:00,2022-12-04 00:00:00,267,0,110,0,0,1387,1764,16075
2022-12-04 00:00:00,2022-12-04 01:00:00,270,0,110,0,0,1532,1912,15596
2022-12-04 01:00:00,2022-12-04 02:00:00,270,0,110,0,0,1607,1987,15481
2022-12-04 02:00:00,2022-12-04 03:00:00,269,0,110,0,0,1772,2151,15494
2022-12-04 03:00:00,2022-12-04 04:00:00,268,0,110,0,0,1939,2317,15737
2022-12-04 04:00:00,2022-12-04 05:00:00,269,0,110,0,0,2032,2411,16158
2022-12-04 05:00:00,2022-12-04 06:00:00,281,0,110,0,25,2113,2529,16455
2022-12-04 06:00:00,2022-12-04 07:00:00,286,177,113,0,187,2228,2991,17452
2022-12-04 07:00:00,2022-12-04 08:00:00,286,275,122,0,541,2231,3455,18629
2022-12-04 08:00:00,2022-12-04 09:00:00,285,152,126,0,850,2178,3591,19301
2022-12-04 09:00:00,2022-12-04 10:00:00,285,18,123,0,990,2072,3488,19647
2022-12-04 10:00:00,2022-12-04 11:00:00,286,72,130,0,951,2027,3466,19834
2022-12-04 11:00:00,2022-12-04 12:00:00,285,167,131,0,704,2122,3409,19926
2022-12-04 12:00:00,2022-12-04 13:00:00,285,21,132,38,283,2336,3095,19698
2022-12-04 13:00:00,2022-12-04 14:00:00,283,0,136,43,84,2588,3134,19854
2022-12-04 14:00:00,2022-12-04 15:00:00,288,0,151,5,0,2836,3280,19991
2022-12-04 15:00:00,2022-12-04 16:00:00,286,12,153,0,0,2928,3379,19785
2022-12-04 16:00:00,2022-12-04 17:00:00,280,158,140,0,0,2923,3501,20174
2022-12-04 17:00:00,2022-12-04 18:00:00,281,263,134,0,0,2962,3640,20261
2022-12-04 18:00:00,2022-12-04 19:00:00,282,48,121,0,0,2960,3411,19778
2022-12-04 19:00:00,2022-12-04 20:00:00,280,1,117,0,0,3022,3420,19004
2022-12-04 20:00:00,2022-12-04 21:00:00,279,0,117,0,0,3088,3484,18313
2022-12-04 21:00:00,2022-12-04 22:00:00,266,0,117,0,0,3069,3452,17214
2022-12-04 22:00:00,2022-12-04 23:00:00,264,0,115,0,0,3013,3392,16340
2022-12-04 23:00:00,2022-12-05 00:00:00,263,0,114,0,0,3077,3454,15954
2022-12-05 00:00:00,2022-12-05 01:00:00,266,0,114,0,0,3098,3478,15691
2022-12-05 01:00:00,2022-12-05 02:00:00,268,0,114,0,0,3096,3478,15827
2022-12-05 02:00:00,2022-12-05 03:00:00,268,0,114,0,0,2979,3361,16204
2022-12-05 03:00:00,2022-12-05 04:00:00,267,0,114,0,0,2908,3289,17550
2022-12-05 04:00:00,2022-12-05 05:00:00,267,0,113,0,0,2678,3058,20834
2022-12-05 05:00:00,2022-12-05 06:00:00,283,0,113,0,25,2426,2847,23133
2022-12-05 06:00:00,2022-12-05 07:00:00,287,0,116,0,128,2354,2885,24373
2022-12-05 07:00:00,2022-12-05 08:00:00,279,0,129,0,312,2136,2856,24899
2022-12-05 08:00:00,2022-12-05 09:00:00,275,0,134,0,586,1878,2873,24819
2022-12-05 09:00:00,2022-12-05 10:00:00,279,0,132,0,762,1601,2774,25164
2022-12-05 10:00:00,2022-12-05 11:00:00,249,161,121,0,809,1344,2684,25396
2022-12-05 11:00:00,2022-12-05 12:00:00,247,168,123,0,478,1201,2217,25402
2022-12-05 12:00:00,2022-12-05 13:00:00,247,24,125,0,279,1074,1749,25087
2022-12-05 13:00:00,2022-12-05 14:00:00,245,244,128,0,71,947,1635,25195
2022-12-05 14:00:00,2022-12-05 15:00:00,245,583,139,38,0,890,1895,25674
2022-12-05 15:00:00,2022-12-05 16:00:00,238,555,144,43,0,803,1783,25432
2022-12-05 16:00:00,2022-12-05 17:00:00,234,273,133,5,0,710,1355,25052
2022-12-05 17:00:00,2022-12-05 18:00:00,232,225,120,0,0,687,1264,24917
2022-12-05 18:00:00,2022-12-05 19:00:00,234,177,117,0,0,615,1143,24337
2022-12-05 19:00:00,2022-12-05 20:00:00,235,14,117,0,0,534,900,22719
2022-12-05 20:00:00,2022-12-05 21:00:00,233,0,112,0,0,518,863,21147
2022-12-05 21:00:00,2022-12-05 22:00:00,225,0,111,0,0,488,824,19686
2022-12-05 22:00:00,2022-12-05 23:00:00,229,0,112,0,0,453,794,18564
2022-12-05 23:00:00,2022-12-06 00:00:00,232,0,112,0,0,397,741,18004
2022-12-06 00:00:00,2022-12-06 01:00:00,234,0,112,0,0,389,735,17724
2022-12-06 01:00:00,2022-12-06 02:00:00,231,0,112,0,0,361,704,17793
2022-12-06 02:00:00,2022-12-06 03:00:00,230,0,112,0,0,357,699,18140
2022-12-06 03:00:00,2022-12-06 04:00:00,232,0,112,0,0,328,672,19143
2022-12-06 04:00:00,2022-12-06 05:00:00,234,123,112,0,0,281,750,21951
2022-12-06 05:00:00,2022-12-06 06:00:00,259,109,113,0,27,311,819,23971
2022-12-06 06:00:00,2022-12-06 07:00:00,281,49,117,0,71,342,860,24944
2022-12-06 07:00:00,2022-12-06 08:00:00,293,165,118,0,191,338,1105,25306
2022-12-06 08:00:00,2022-12-06 09:00:00,298,369,126,0,267,290,1350,25249
2022-12-06 09:00:00,2022-12-06 10:00:00,298,458,128,0,304,308,1496,25553
2022-12-06 10:00:00,2022-12-06 11:00:00,290,131,129,0,311,362,1223,25758
2022-12-06 11:00:00,2022-12-06 12:00:00,285,263,129,0,276,348,1301,25876
2022-12-06 12:00:00,2022-12-06 13:00:00,284,384,124,0,106,396,1294,25371
2022-12-06 13:00:00,2022-12-06 14:00:00,285,343,131,38,49,449,1295,25391
2022-12-06 14:00:00,2022-12-06 15:00:00,285,182,142,43,0,544,1196,25765
2022-12-06 15:00:00,2022-12-06 16:00:00,283,14,151,5,0,618,1071,25505
2022-12-06 16:00:00,2022-12-06 17:00:00,286,0,136,0,0,699,1121,25032
2022-12-06 17:00:00,2022-12-06 18:00:00,284,0,131,0,0,832,1247,24851
2022-12-06 18:00:00,2022-12-06 19:00:00,285,0,111,0,0,925,1321,24240
2022-12-06 19:00:00,2022-12-06 20:00:00,284,0,108,0,0,1008,1400,22726
2022-12-06 20:00:00,2022-12-06 21:00:00,285,0,107,0,0,1016,1408,21185
2022-12-06 21:00:00,2022-12-06 22:00:00,282,1,105,0,0,1107,1495,19725
2022-12-06 22:00:00,2022-12-06 23:00:00,270,0,102,0,0,1290,1662,18683
2022-12-06 23:00:00,2022-12-07 00:00:00,267,0,101,0,0,1431,1799,18144
2022-12-07 00:00:00,2022-12-07 01:00:00,265,0,101,0,0,1632,1998,17799
2022-12-07 01:00:00,2022-12-07 02:00:00,266,0,101,0,0,1929,2296,17850
2022-12-07 02:00:00,2022-12-07 03:00:00,273,0,101,0,0,1935,2309,18073
2022-12-07 03:00:00,2022-12-07 04:00:00,280,0,101,0,0,2129,2510,19072
2022-12-07 04:00:00,2022-12-07 05:00:00,280,49,102,0,0,2323,2754,21787
2022-12-07 05:00:00,2022-12-07 06:00:00,280,7,103,0,29,2434,2853,23810
2022-12-07 06:00:00,2022-12-07 07:00:00,282,18,117,0,126,2629,3172,24804
2022-12-07 07:00:00,2022-12-07 08:00:00,281,20,126,0,323,2702,3452,25221
2022-12-07 08:00:00,2022-12-07 09:00:00,282,24,126,0,601,2812,3845,25179
2022-12-07 09:00:00,2022-12-07 10:00:00,279,116,125,0,682,3099,4301,25459
2022-12-07 10:00:00,2022-12-07 11:00:00,282,142,125,0,638,3261,4448,25427
2022-12-07 11:00:00,2022-12-07 12:00:00,281,25,129,0,473,3373,4281,25419
2022-12-07 12:00:00,2022-12-07 13:00:00,280,0,136,0,317,3451,4184,25023
2022-12-07 13:00:00,2022-12-07 14:00:00,278,50,138,0,104,3631,4201,24955
2022-12-07 14:00:00,2022-12-07 15:00:00,281,502,143,0,0,3823,4749,25343
2022-12-07 15:00:00,2022-12-07 16:00:00,281,628,120,0,0,4090,5119,25291
2022-12-07 16:00:00,2022-12-07 17:00:00,280,590,119,38,0,4299,5326,24923
2022-12-07 17:00:00,2022-12-07 18:00:00,279,116,119,43,0,4301,4858,24621
2022-12-07 18:00:00,2022-12-07 19:00:00,282,0,116,5,0,4418,4821,24045
2022-12-07 19:00:00,2022-12-07 20:00:00,281,33,107,0,0,4325,4746,22625
2022-12-07 20:00:00,2022-12-07 21:00:00,278,0,106,0,0,4233,4617,21130
2022-12-07 21:00:00,2022-12-07 22:00:00,281,14,106,0,0,4115,4516,19837
2022-12-07 22:00:00,2022-12-07 23:00:00,271,2,104,0,0,3881,4258,18642
2022-12-07 23:00:00,2022-12-08 00:00:00,267,0,105,0,0,3733,4105,18190
2022-12-08 00:00:00,2022-12-08 01:00:00,266,0,105,0,0,3526,3897,17952
2022-12-08 01:00:00,2022-12-08 02:00:00,267,0,105,0,0,3173,3545,17882
2022-12-08 02:00:00,2022-12-08 03:00:00,276,0,107,0,0,2910,3293,18288
2022-12-08 03:00:00,2022-12-08 04:00:00,280,0,105,0,0,2533,2918,19202
2022-12-08 04:00:00,2022-12-08 05:00:00,281,0,106,0,0,2330,2717,21914
2022-12-08 05:00:00,2022-12-08 06:00:00,280,0,106,0,30,2370,2786,23922
2022-12-08 06:00:00,2022-12-08 07:00:00,282,29,110,0,250,2164,2835,24586
2022-12-08 07:00:00,2022-12-08 08:00:00,281,270,111,0,804,2027,3493,24877
2022-12-08 08:00:00,2022-12-08 09:00:00,280,276,112,0,1360,1857,3885,24684
2022-12-08 09:00:00,2022-12-08 10:00:00,279,117,126,0,1357,1688,3567,24735
2022-12-08 10:00:00,2022-12-08 11:00:00,280,252,143,0,1263,1599,3537,25060
2022-12-08 11:00:00,2022-12-08 12:00:00,280,272,137,0,913,1632,3234,25347
2022-12-08 12:00:00,2022-12-08 13:00:00,282,251,137,0,449,1782,2901,25024
2022-12-08 13:00:00,2022-12-08 14:00:00,281,211,139,37,87,1885,2640,25065
2022-12-08 14:00:00,2022-12-08 15:00:00,280,409,142,43,0,2214,3088,25565
2022-12-08 15:00:00,2022-12-08 16:00:00,283,85,141,5,0,2409,2923,25268
2022-12-08 16:00:00,2022-12-08 17:00:00,281,107,137,0,0,2540,3065,24867
2022-12-08 17:00:00,2022-12-08 18:00:00,280,110,137,0,0,2463,2990,24692
2022-12-08 18:00:00,2022-12-08 19:00:00,281,0,135,0,0,2279,2695,24147
2022-12-08 19:00:00,2022-12-08 20:00:00,282,33,133,0,0,2066,2514,22765
2022-12-08 20:00:00,2022-12-08 21:00:00,281,21,115,0,0,1712,2129,21242
2022-12-08 21:00:00,2022-12-08 22:00:00,280,3,110,0,0,1306,1699,19908
2022-12-08 22:00:00,2022-12-08 23:00:00,268,24,110,0,0,1050,1452,18761
2022-12-08 23:00:00,2022-12-09 00:00:00,268,0,110,0,0,809,1187,18286
2022-12-09 00:00:00,2022-12-09 01:00:00,269,0,110,0,0,602,981,18172
2022-12-09 01:00:00,2022-12-09 02:00:00,268,0,110,0,0,463,841,18302
2022-12-09 02:00:00,2022-12-09 03:00:00,269,0,110,0,0,325,704,18601
2022-12-09 03:00:00,2022-12-09 04:00:00,280,0,110,0,0,250,640,19537
2022-12-09 04:00:00,2022-12-09 05:00:00,281,237,110,0,0,214,842,22302
2022-12-09 05:00:00,2022-12-09 06:00:00,281,460,121,0,23,188,1073,24300
2022-12-09 06:00:00,2022-12-09 07:00:00,281,341,123,0,262,147,1154,25156
2022-12-09 07:00:00,2022-12-09 08:00:00,280,217,129,11,721,115,1473,25305
2022-12-09 08:00:00,2022-12-09 09:00:00,280,47,137,11,1080,64,1619,24936
2022-12-09 09:00:00,2022-12-09 10:00:00,280,48,136,14,1253,51,1782,25176
2022-12-09 10:00:00,2022-12-09 11:00:00,282,183,144,14,1175,41,1839,25343
2022-12-09 11:00:00,2022-12-09 12:00:00,281,351,143,14,728,57,1574,25447
2022-12-09 12:00:00,2022-12-09 13:00:00,280,236,144,14,305,85,1064,25154
2022-12-09 13:00:00,2022-12-09 14:00:00,281,474,158,2,75,157,1147,25353
2022-12-09 14:00:00,2022-12-09 15:00:00,282,993,163,0,0,266,1704,26012
2022-12-09 15:00:00,2022-12-09 16:00:00,280,962,155,0,0,350,1747,25711
2022-12-09 16:00:00,2022-12-09 17:00:00,280,608,149,0,0,436,1473,25302
2022-12-09 17:00:00,2022-12-09 18:00:00,281,379,147,0,0,504,1311,25137
2022-12-09 18:00:00,2022-12-09 19:00:00,281,92,126,0,0,541,1040,24256
2022-12-09 19:00:00,2022-12-09 20:00:00,279,0,121,0,0,585,985,22745
2022-12-09 20:00:00,2022-12-09 21:00:00,281,0,114,0,0,632,1027,21346
2022-12-09 21:00:00,2022-12-09 22:00:00,280,0,113,0,0,634,1027,20071
2022-12-09 22:00:00,2022-12-09 23:00:00,271,0,109,0,0,524,904,18927
2022-12-09 23:00:00,2022-12-10 00:00:00,268,0,108,0,0,494,870,18209
2022-12-10 00:00:00,2022-12-10 01:00:00,268,0,108,0,0,521,897,17737
2022-12-10 01:00:00,2022-12-10 02:00:00,267,0,108,0,0,566,941,17701
2022-12-10 02:00:00,2022-12-10 03:00:00,267,0,108,0,0,576,951,17773
2022-12-10 03:00:00,2022-12-10 04:00:00,271,0,108,0,0,568,947,17884
2022-12-10 04:00:00,2022-12-10 05:00:00,281,0,108,0,0,587,976,18794
2022-12-10 05:00:00,2022-12-10 06:00:00,281,0,108,0,21,573,983,19745
2022-12-10 06:00:00,2022-12-10 07:00:00,281,0,109,0,67,556,1013,21051
2022-12-10 07:00:00,2022-12-10 08:00:00,282,85,119,0,143,504,1133,22278
2022-12-10 08:00:00,2022-12-10 09:00:00,281,472,136,0,300,407,1596,22768
2022-12-10 09:00:00,2022-12-10 10:00:00,280,505,138,0,402,364,1689,23023
2022-12-10 10:00:00,2022-12-10 11:00:00,280,327,137,0,359,342,1445,23032
2022-12-10 11:00:00,2022-12-10 12:00:00,281,318,137,0,221,331,1288,22929
2022-12-10 12:00:00,2022-12-10 13:00:00,282,134,144,50,112,345,1067,22506
2022-12-10 13:00:00,2022-12-10 14:00:00,281,146,158,57,64,351,1057,22557
2022-12-10 14:00:00,2022-12-10 15:00:00,280,438,160,7,0,342,1227,22891
2022-12-10 15:00:00,2022-12-10 16:00:00,279,487,151,0,0,341,1258,22552
2022-12-10 16:00:00,2022-12-10 17:00:00,281,387,146,0,0,361,1175,22302
2022-12-10 17:00:00,2022-12-10 18:00:00,280,294,146,0,0,393,1113,22092
2022-12-10 18:00:00,2022-12-10 19:00:00,281,30,129,0,0,426,866,21506
2022-12-10 19:00:00,2022-12-10 20:00:00,281,0,125,0,0,459,865,20279
2022-12-10 20:00:00,2022-12-10 21:00:00,280,0,117,0,0,491,888,19221
2022-12-10 21:00:00,2022-12-10 22:00:00,281,0,116,0,0,455,852,18036
2022-12-10 22:00:00,2022-12-10 23:00:00,272,0,109,0,0,474,855,17119
2022-12-10 23:00:00,2022-12-11 00:00:00,268,0,108,0,0,536,912,16454
2022-12-11 00:00:00,2022-12-11 01:00:00,267,0,108,0,0,645,1020,16096
2022-12-11 01:00:00,2022-12-11 02:00:00,269,0,108,0,0,710,1087,15898
2022-12-11 02:00:00,2022-12-11 03:00:00,280,0,108,0,0,765,1153,15924
2022-12-11 03:00:00,2022-12-11 04:00:00,282,0,108,0,0,810,1200,16118
2022-12-11 04:00:00,2022-12-11 05:00:00,280,0,111,0,0,932,1323,16738
2022-12-11 05:00:00,2022-12-11 06:00:00,280,0,113,0,21,998,1412,17281
2022-12-11 06:00:00,2022-12-11 07:00:00,281,0,119,0,70,990,1460,18298
2022-12-11 07:00:00,2022-12-11 08:00:00,281,129,124,0,177,917,1628,19576
2022-12-11 08:00:00,2022-12-11 09:00:00,279,197,134,0,309,1090,2009,20401
2022-12-11 09:00:00,2022-12-11 10:00:00,280,149,144,0,337,1161,2071,20710
2022-12-11 10:00:00,2022-12-11 11:00:00,281,280,147,0,385,1202,2295,21015
2022-12-11 11:00:00,2022-12-11 12:00:00,281,344,133,50,313,1381,2502,21117
2022-12-11 12:00:00,2022-12-11 13:00:00,282,45,132,57,200,1430,2146,20836
2022-12-11 13:00:00,2022-12-11 14:00:00,280,176,137,7,92,1520,2212,20772
2022-12-11 14:00:00,2022-12-11 15:00:00,281,693,136,0,0,1504,2614,21332
2022-12-11 15:00:00,2022-12-11 16:00:00,280,890,136,0,0,1542,2848,21322
2022-12-11 16:00:00,2022-12-11 17:00:00,279,700,136,0,0,1684,2799,21247
2022-12-11 17:00:00,2022-12-11 18:00:00,283,603,137,0,0,1773,2796,21148
2022-12-11 18:00:00,2022-12-11 19:00:00,283,126,126,0,0,1856,2391,20645
2022-12-11 19:00:00,2022-12-11 20:00:00,281,0,123,0,0,2047,2451,19722
2022-12-11 20:00:00,2022-12-11 21:00:00,282,0,114,0,0,2189,2585,18881
2022-12-11 21:00:00,2022-12-11 22:00:00,280,6,115,0,0,2183,2584,17850
2022-12-11 22:00:00,2022-12-11 23:00:00,273,173,115,0,0,2303,2864,17057
2022-12-11 23:00:00,2022-12-12 00:00:00,267,22,114,0,0,2285,2688,16638
2022-12-12 00:00:00,2022-12-12 01:00:00,269,0,114,0,0,2529,2912,16423
2022-12-12 01:00:00,2022-12-12 02:00:00,269,0,115,0,0,2868,3252,16521
2022-12-12 02:00:00,2022-12-12 03:00:00,281,0,115,0,0,3188,3584,16958
2022-12-12 03:00:00,2022-12-12 04:00:00,281,0,114,0,0,3505,3900,18176
2022-12-12 04:00:00,2022-12-12 05:00:00,281,0,114,0,0,3742,4137,21061
2022-12-12 05:00:00,2022-12-12 06:00:00,279,0,115,0,28,3910,4332,23271
2022-12-12 06:00:00,2022-12-12 07:00:00,279,84,121,0,144,3813,4441,24527
2022-12-12 07:00:00,2022-12-12 08:00:00,281,301,127,0,367,3831,4907,25315
2022-12-12 08:00:00,2022-12-12 09:00:00,280,312,128,0,543,3799,5062,25331
2022-12-12 09:00:00,2022-12-12 10:00:00,282,348,132,0,664,4064,5490,25675
2022-12-12 10:00:00,2022-12-12 11:00:00,282,355,143,0,749,4393,5922,25835
2022-12-12 11:00:00,2022-12-12 12:00:00,281,129,152,50,679,4727,6018,26030
2022-12-12 12:00:00,2022-12-12 13:00:00,280,0,149,57,380,4868,5734,25408
2022-12-12 13:00:00,2022-12-12 14:00:00,271,0,138,7,134,4899,5449,25331
2022-12-12 14:00:00,2022-12-12 15:00:00,271,53,132,0,0,5021,5477,25812
2022-12-12 15:00:00,2022-12-12 16:00:00,272,140,124,0,0,5119,5655,25528
2022-12-12 16:00:00,2022-12-12 17:00:00,276,0,123,0,0,5175,5574,25202
2022-12-12 17:00:00,2022-12-12 18:00:00,272,0,125,0,0,5129,5526,24913
2022-12-12 18:00:00,2022-12-12 19:00:00,280,0,123,0,0,5051,5454,24202
2022-12-12 19:00:00,2022-12-12 20:00:00,280,0,123,0,0,5096,5499,22651
2022-12-12 20:00:00,2022-12-12 21:00:00,279,0,121,0,0,5041,5441,21181
2022-12-12 21:00:00,2022-12-12 22:00:00,280,0,121,0,0,5118,5519,19878
2022-12-12 22:00:00,2022-12-12 23:00:00,271,0,122,0,0,5056,5449,18727
2022-12-12 23:00:00,2022-12-13 00:00:00,267,0,123,0,0,4835,5225,18160
2022-12-13 00:00:00,2022-12-13 01:00:00,268,0,123,0,0,4457,4848,17901
2022-12-13 01:00:00,2022-12-13 02:00:00,269,0,123,0,0,4336,4728,18009
2022-12-13 02:00:00,2022-12-13 03:00:00,279,0,123,0,0,4084,4486,18374
2022-12-13 03:00:00,2022-12-13 04:00:00,278,0,123,0,0,3928,4329,19405
2022-12-13 04:00:00,2022-12-13 05:00:00,275,0,125,0,0,3843,4243,22175
2022-12-13 05:00:00,2022-12-13 06:00:00,276,0,125,0,22,3781,4204,24222
2022-12-13 06:00:00,2022-12-13 07:00:00,283,0,128,0,149,3583,4143,25266
2022-12-13 07:00:00,2022-12-13 08:00:00,281,239,130,0,441,3305,4396,25962
2022-12-13 08:00:00,2022-12-13 09:00:00,269,294,130,0,773,3175,4641,26065
2022-12-13 09:00:00,2022-12-13 10:00:00,248,164,134,0,899,3041,4486,26330
2022-12-13 10:00:00,2022-12-13 11:00:00,170,202,145,0,909,2808,4234,26377
2022-12-13 11:00:00,2022-12-13 12:00:00,78,219,146,0,749,2457,3649,26465
2022-12-13 12:00:00,2022-12-13 13:00:00,78,98,149,0,435,2144,2904,26049
2022-12-13 13:00:00,2022-12-13 14:00:00,78,340,149,0,157,1849,2573,26044
2022-12-13 14:00:00,2022-12-13 15:00:00,78,716,157,50,0,1791,2792,26604
2022-12-13 15:00:00,2022-12-13 16:00:00,78,578,157,57,0,1923,2793,26275
2022-12-13 16:00:00,2022-12-13 17:00:00,78,241,159,57,0,2011,2546,25912
2022-12-13 17:00:00,2022-12-13 18:00:00,78,478,158,7,0,1987,2708,25768
2022-12-13 18:00:00,2022-12-13 19:00:00,80,398,135,0,0,1956,2569,25203
2022-12-13 19:00:00,2022-12-13 20:00:00,80,165,132,0,0,1938,2315,23740
2022-12-13 20:00:00,2022-12-13 21:00:00,80,0,127,0,0,2035,2242,22224
2022-12-13 21:00:00,2022-12-13 22:00:00,81,0,127,0,0,2030,2238,20859
2022-12-13 22:00:00,2022-12-13 23:00:00,81,0,121,0,0,1981,2183,19810
2022-12-13 23:00:00,2022-12-14 00:00:00,81,0,120,0,0,2158,2359,19243
2022-12-14 00:00:00,2022-12-14 01:00:00,82,0,120,0,0,2277,2479,19104
2022-12-14 01:00:00,2022-12-14 02:00:00,82,0,120,0,0,2435,2637,19162
2022-12-14 02:00:00,2022-12-14 03:00:00,82,0,120,0,0,2314,2516,19612
2022-12-14 03:00:00,2022-12-14 04:00:00,82,0,120,0,0,2396,2598,20540
2022-12-14 04:00:00,2022-12-14 05:00:00,82,0,120,0,0,2748,2950,23254
2022-12-14 05:00:00,2022-12-14 06:00:00,82,0,120,0,31,2913,3146,25260
2022-12-14 06:00:00,2022-12-14 07:00:00,82,155,125,0,197,2980,3539,26273
2022-12-14 07:00:00,2022-12-14 08:00:00,82,264,129,0,699,2720,3894,26843
2022-12-14 08:00:00,2022-12-14 09:00:00,80,62,131,1,1205,2412,3891,26824
2022-12-14 09:00:00,2022-12-14 10:00:00,79,188,132,0,1348,2088,3835,26843
2022-12-14 10:00:00,2022-12-14 11:00:00,79,429,135,0,1260,1912,3815,26627
2022-12-14 11:00:00,2022-12-14 12:00:00,79,422,141,0,938,1813,3393,26612
2022-12-14 12:00:00,2022-12-14 13:00:00,80,308,142,0,444,2030,3004,26215
2022-12-14 13:00:00,2022-12-14 14:00:00,79,471,143,0,119,2414,3226,26078
2022-12-14 14:00:00,2022-12-14 15:00:00,79,697,155,0,0,2874,3805,26570
2022-12-14 15:00:00,2022-12-14 16:00:00,79,252,158,0,0,3057,3546,26420
2022-12-14 16:00:00,2022-12-14 17:00:00,80,23,146,50,0,2977,3276,26137
2022-12-14 17:00:00,2022-12-14 18:00:00,80,65,130,57,0,2727,3059,25982
2022-12-14 18:00:00,2022-12-14 19:00:00,80,415,130,57,0,2376,3058,25354
2022-12-14 19:00:00,2022-12-14 20:00:00,80,182,126,7,0,2122,2517,23951
2022-12-14 20:00:00,2022-12-14 21:00:00,80,0,117,0,0,1752,1949,22438
2022-12-14 21:00:00,2022-12-14 22:00:00,80,0,118,0,0,1348,1546,21200
2022-12-14 22:00:00,2022-12-14 23:00:00,80,0,121,0,0,1003,1204,20086
2022-12-14 23:00:00,2022-12-15 00:00:00,80,0,120,0,0,778,978,19577
2022-12-15 00:00:00,2022-12-15 01:00:00,80,22,120,0,0,637,859,19245
2022-12-15 01:00:00,2022-12-15 02:00:00,81,16,120,0,0,575,792,19307
2022-12-15 02:00:00,2022-12-15 03:00:00,80,0,120,0,0,609,809,19542
2022-12-15 03:00:00,2022-12-15 04:00:00,80,0,120,0,0,600,800,20337
2022-12-15 04:00:00,2022-12-15 05:00:00,80,66,121,0,0,690,957,23039
2022-12-15 05:00:00,2022-12-15 06:00:00,80,189,128,0,28,880,1305,25058
2022-12-15 06:00:00,2022-12-15 07:00:00,80,191,130,0,156,994,1551,26238
2022-12-15 07:00:00,2022-12-15 08:00:00,79,155,131,0,391,1093,1849,26794
2022-12-15 08:00:00,2022-12-15 09:00:00,80,9,132,0,602,1202,2025,26628
2022-12-15 09:00:00,2022-12-15 10:00:00,79,91,132,0,774,976,2052,26911
2022-12-15 10:00:00,2022-12-15 11:00:00,79,63,149,0,790,850,1931,26869
2022-12-15 11:00:00,2022-12-15 12:00:00,79,55,153,0,659,821,1767,26850
2022-12-15 12:00:00,2022-12-15 13:00:00,79,116,157,0,394,883,1629,26410
2022-12-15 13:00:00,2022-12-15 14:00:00,79,335,168,50,151,924,1707,26413
2022-12-15 14:00:00,2022-12-15 15:00:00,79,638,171,57,0,968,1913,26942
2022-12-15 15:00:00,2022-12-15 16:00:00,79,540,163,57,0,1000,1839,26731
2022-12-15 16:00:00,2022-12-15 17:00:00,79,442,160,7,0,1095,1783,26492
2022-12-15 17:00:00,2022-12-15 18:00:00,79,376,158,0,0,1129,1742,26176
2022-12-15 18:00:00,2022-12-15 19:00:00,79,237,158,0,0,1007,1481,25611
2022-12-15 19:00:00,2022-12-15 20:00:00,79,203,158,0,0,738,1178,24030
2022-12-15 20:00:00,2022-12-15 21:00:00,79,50,141,0,0,588,858,22433
2022-12-15 21:00:00,2022-12-15 22:00:00,80,0,119,0,0,556,755,21116
2022-12-15 22:00:00,2022-12-15 23:00:00,80,0,114,0,0,502,696,19878
2022-12-15 23:00:00,2022-12-16 00:00:00,80,0,114,0,0,480,674,19250
2022-12-16 00:00:00,2022-12-16 01:00:00,80,0,114,0,0,586,780,19010
2022-12-16 01:00:00,2022-12-16 02:00:00,80,0,114,0,0,706,900,18984
2022-12-16 02:00:00,2022-12-16 03:00:00,80,0,113,0,0,800,993,19302
2022-12-16 03:00:00,2022-12-16 04:00:00,80,0,113,0,0,844,1037,20231
2022-12-16 04:00:00,2022-12-16 05:00:00,80,0,113,0,0,827,1020,22985
2022-12-16 05:00:00,2022-12-16 06:00:00,80,326,113,0,42,822,1383,25113
2022-12-16 06:00:00,2022-12-16 07:00:00,80,355,116,0,110,935,1596,26186
2022-12-16 07:00:00,2022-12-16 08:00:00,79,219,119,0,258,920,1595,26731
2022-12-16 08:00:00,2022-12-16 09:00:00,79,49,124,0,423,879,1554,26927
2022-12-16 09:00:00,2022-12-16 10:00:00,79,199,119,0,597,785,1779,27211
2022-12-16 10:00:00,2022-12-16 11:00:00,79,241,117,0,633,751,1821,27159
2022-12-16 11:00:00,2022-12-16 12:00:00,79,316,131,0,481,801,1808,26873
2022-12-16 12:00:00,2022-12-16 13:00:00,79,173,145,0,296,916,1609,26338
2022-12-16 13:00:00,2022-12-16 14:00:00,79,130,159,50,90,993,1501,26161
2022-12-16 14:00:00,2022-12-16 15:00:00,79,256,164,57,0,984,1540,26582
2022-12-16 15:00:00,2022-12-16 16:00:00,79,145,157,57,0,932,1370,26263
2022-12-16 16:00:00,2022-12-16 17:00:00,79,10,147,7,0,854,1097,25897
2022-12-16 17:00:00,2022-12-16 18:00:00,79,0,136,0,0,808,1023,25668
2022-12-16 18:00:00,2022-12-16 19:00:00,80,0,127,0,0,713,920,24980
2022-12-16 19:00:00,2022-12-16 20:00:00,79,0,112,0,0,600,791,23596
2022-12-16 20:00:00,2022-12-16 21:00:00,79,0,110,0,0,546,735,22182
2022-12-16 21:00:00,2022-12-16 22:00:00,79,2,110,0,0,491,682,20918
2022-12-16 22:00:00,2022-12-16 23:00:00,79,124,101,0,0,425,729,19819
2022-12-16 23:00:00,2022-12-17 00:00:00,79,33,100,0,0,397,609,19092
2022-12-17 00:00:00,2022-12-17 01:00:00,80,0,100,0,0,344,524,18703
2022-12-17 01:00:00,2022-12-17 02:00:00,79,0,100,0,0,389,568,18674
2022-12-17 02:00:00,2022-12-17 03:00:00,79,0,100,0,0,391,570,18818
2022-12-17 03:00:00,2022-12-17 04:00:00,80,0,100,0,0,364,544,19057
2022-12-17 04:00:00,2022-12-17 05:00:00,80,0,100,0,0,347,527,19991
2022-12-17 05:00:00,2022-12-17 06:00:00,79,0,102,0,22,382,585,20923
2022-12-17 06:00:00,2022-12-17 07:00:00,79,34,108,0,86,379,686,22179
2022-12-17 07:00:00,2022-12-17 08:00:00,80,284,111,0,249,376,1100,23334
2022-12-17 08:00:00,2022-12-17 09:00:00,79,794,117,0,413,374,1777,23986
2022-12-17 09:00:00,2022-12-17 10:00:00,80,967,118,50,546,436,2197,24208
2022-12-17 10:00:00,2022-12-17 11:00:00,79,391,122,57,511,457,1617,24136
2022-12-17 11:00:00,2022-12-17 12:00:00,79,125,122,57,418,450,1251,24058
2022-12-17 12:00:00,2022-12-17 13:00:00,79,149,136,7,260,453,1084,23548
2022-12-17 13:00:00,2022-12-17 14:00:00,79,339,149,0,92,506,1165,23458
2022-12-17 14:00:00,2022-12-17 15:00:00,79,598,147,0,0,600,1424,23983
2022-12-17 15:00:00,2022-12-17 16:00:00,79,607,132,0,0,688,1506,23790
2022-12-17 16:00:00,2022-12-17 17:00:00,79,227,128,0,0,751,1185,23589
2022-12-17 17:00:00,2022-12-17 18:00:00,79,105,128,0,0,775,1087,23186
2022-12-17 18:00:00,2022-12-17 19:00:00,79,37,107,0,0,812,1035,22570
2022-12-17 19:00:00,2022-12-17 20:00:00,79,0,104,0,0,806,989,21449
2022-12-17 20:00:00,2022-12-17 21:00:00,79,0,97,0,0,840,1016,20419
2022-12-17 21:00:00,2022-12-17 22:00:00,79,0,97,0,0,924,1100,19212
2022-12-17 22:00:00,2022-12-17 23:00:00,79,0,97,0,0,934,1110,18150
2022-12-17 23:00:00,2022-12-18 00:00:00,79,0,96,0,0,930,1105,17492
2022-12-18 00:00:00,2022-12-18 01:00:00,79,0,96,0,0,861,1036,17126
2022-12-18 01:00:00,2022-12-18 02:00:00,79,0,100,0,0,802,981,16979
2022-12-18 02:00:00,2022-12-18 03:00:00,79,0,103,0,0,785,967,17065
2022-12-18 03:00:00,2022-12-18 04:00:00,79,0,106,0,0,839,1024,17307
2022-12-18 04:00:00,2022-12-18 05:00:00,80,0,106,0,0,822,1008,17967
2022-12-18 05:00:00,2022-12-18 06:00:00,79,0,106,0,21,941,1147,18478
2022-12-18 06:00:00,2022-12-18 07:00:00,79,0,115,0,129,1148,1471,19606
2022-12-18 07:00:00,2022-12-18 08:00:00,79,0,120,0,431,1314,1944,21004
2022-12-18 08:00:00,2022-12-18 09:00:00,79,197,126,0,802,1245,2449,21862
2022-12-18 09:00:00,2022-12-18 10:00:00,79,152,133,50,1104,1081,2599,22274
2022-12-18 10:00:00,2022-12-18 11:00:00,79,711,144,57,1129,948,3068,22362
2022-12-18 11:00:00,2022-12-18 12:00:00,79,817,132,57,961,925,2971,22460
2022-12-18 12:00:00,2022-12-18 13:00:00,80,692,135,7,549,998,2461,22041
2022-12-18 13:00:00,2022-12-18 14:00:00,80,398,138,0,167,1221,2004,21800
2022-12-18 14:00:00,2022-12-18 15:00:00,80,327,135,0,0,1407,1949,22452
2022-12-18 15:00:00,2022-12-18 16:00:00,80,450,134,0,0,1580,2244,22519
2022-12-18 16:00:00,2022-12-18 17:00:00,80,360,132,0,0,1737,2309,22410
2022-12-18 17:00:00,2022-12-18 18:00:00,80,528,126,0,0,1786,2520,22556
2022-12-18 18:00:00,2022-12-18 19:00:00,80,399,118,0,0,2008,2605,22401
2022-12-18 19:00:00,2022-12-18 20:00:00,80,123,115,0,0,2158,2476,21387
2022-12-18 20:00:00,2022-12-18 21:00:00,80,51,108,0,0,2327,2566,20507
2022-12-18 21:00:00,2022-12-18 22:00:00,80,3,107,0,0,2616,2806,19449
2022-12-18 22:00:00,2022-12-18 23:00:00,80,0,110,0,0,2832,3022,18419
2022-12-18 23:00:00,2022-12-19 00:00:00,80,0,111,0,0,2970,3161,17941
2022-12-19 00:00:00,2022-12-19 01:00:00,80,0,111,0,0,3233,3424,17684
2022-12-19 01:00:00,2022-12-19 02:00:00,80,0,111,0,0,3505,3696,17674
2022-12-19 02:00:00,2022-12-19 03:00:00,81,0,111,0,0,3723,3915,18178
2022-12-19 03:00:00,2022-12-19 04:00:00,80,0,111,0,0,4010,4201,19501
2022-12-19 04:00:00,2022-12-19 05:00:00,81,82,111,0,0,4316,4590,22479
2022-12-19 05:00:00,2022-12-19 06:00:00,81,373,111,0,19,4674,5258,24783
2022-12-19 06:00:00,2022-12-19 07:00:00,80,279,119,0,282,4822,5582,25998
2022-12-19 07:00:00,2022-12-19 08:00:00,80,478,124,0,824,4826,6332,26764
2022-12-19 08:00:00,2022-12-19 09:00:00,80,27,121,0,1392,4903,6523,26749
2022-12-19 09:00:00,2022-12-19 10:00:00,80,0,125,0,1666,4895,6766,26709
2022-12-19 10:00:00,2022-12-19 11:00:00,79,14,135,38,1500,4926,6692,26472
2022-12-19 11:00:00,2022-12-19 12:00:00,80,32,141,43,1064,5059,6419,26359
2022-12-19 12:00:00,2022-12-19 13:00:00,79,0,128,43,547,5409,6206,25681
2022-12-19 13:00:00,2022-12-19 14:00:00,79,12,126,43,157,5563,5980,25580
2022-12-19 14:00:00,2022-12-19 15:00:00,78,266,129,5,0,5502,5980,26034
2022-12-19 15:00:00,2022-12-19 16:00:00,78,377,129,0,0,5384,5968,25862
2022-12-19 16:00:00,2022-12-19 17:00:00,79,701,128,0,0,5246,6154,25503
2022-12-19 17:00:00,2022-12-19 18:00:00,78,887,118,0,0,5199,6282,25153
2022-12-19 18:00:00,2022-12-19 19:00:00,79,837,116,0,0,5282,6314,24624
2022-12-19 19:00:00,2022-12-19 20:00:00,79,602,112,0,0,5283,6076,23064
2022-12-19 20:00:00,2022-12-19 21:00:00,79,212,106,0,0,5311,5708,21461
2022-12-19 21:00:00,2022-12-19 22:00:00,79,18,104,0,0,5249,5450,19884
2022-12-19 22:00:00,2022-12-19 23:00:00,78,0,105,0,0,5257,5440,18717
2022-12-19 23:00:00,2022-12-20 00:00:00,79,0,105,0,0,5257,5441,18074
2022-12-20 00:00:00,2022-12-20 01:00:00,79,0,105,0,0,5247,5431,17744
2022-12-20 01:00:00,2022-12-20 02:00:00,78,0,105,0,0,5119,5302,17793
2022-12-20 02:00:00,2022-12-20 03:00:00,78,0,105,0,0,5028,5211,18132
2022-12-20 03:00:00,2022-12-20 04:00:00,79,0,105,0,0,5078,5262,19081
2022-12-20 04:00:00,2022-12-20 05:00:00,78,0,106,0,0,5049,5233,21807
2022-12-20 05:00:00,2022-12-20 06:00:00,79,0,106,0,18,5036,5239,23748
2022-12-20 06:00:00,2022-12-20 07:00:00,78,0,115,0,147,4996,5336,24831
2022-12-20 07:00:00,2022-12-20 08:00:00,78,0,129,0,450,4779,5436,25245
2022-12-20 08:00:00,2022-12-20 09:00:00,78,0,128,0,704,4666,5576,25211
2022-12-20 09:00:00,2022-12-20 10:00:00,78,0,129,0,804,4515,5526,25403
2022-12-20 10:00:00,2022-12-20 11:00:00,78,0,130,0,827,4465,5500,25502
2022-12-20 11:00:00,2022-12-20 12:00:00,79,0,135,0,674,4215,5103,25508
2022-12-20 12:00:00,2022-12-20 13:00:00,78,0,145,0,395,4260,4878,24888
2022-12-20 13:00:00,2022-12-20 14:00:00,78,0,155,37,99,4573,4942,24743
2022-12-20 14:00:00,2022-12-20 15:00:00,78,328,160,43,0,4764,5373,25388
2022-12-20 15:00:00,2022-12-20 16:00:00,78,334,150,43,0,4803,5408,25274
2022-12-20 16:00:00,2022-12-20 17:00:00,78,480,149,5,0,4812,5524,24925
2022-12-20 17:00:00,2022-12-20 18:00:00,78,281,133,0,0,4902,5394,24707
2022-12-20 18:00:00,2022-12-20 19:00:00,78,32,121,0,0,4901,5132,24097
2022-12-20 19:00:00,2022-12-20 20:00:00,78,0,119,0,0,4787,4984,22588
2022-12-20 20:00:00,2022-12-20 21:00:00,78,0,109,0,0,4591,4778,20978
2022-12-20 21:00:00,2022-12-20 22:00:00,78,0,108,0,0,4528,4714,19535
2022-12-20 22:00:00,2022-12-20 23:00:00,78,0,100,0,0,4442,4620,18441
2022-12-20 23:00:00,2022-12-21 00:00:00,78,0,99,0,0,4410,4587,17866
2022-12-21 00:00:00,2022-12-21 01:00:00,78,0,99,0,0,4302,4479,17563
2022-12-21 01:00:00,2022-12-21 02:00:00,78,0,99,0,0,4223,4400,17590
2022-12-21 02:00:00,2022-12-21 03:00:00,78,0,99,0,0,4145,4322,17808
2022-12-21 03:00:00,2022-12-21 04:00:00,78,0,99,0,0,3954,4131,18680
2022-12-21 04:00:00,2022-12-21 05:00:00,78,0,99,0,0,3910,4087,21383
2022-12-21 05:00:00,2022-12-21 06:00:00,78,0,101,0,15,3668,3862,23347
2022-12-21 06:00:00,2022-12-21 07:00:00,78,27,109,0,131,3613,3958,24357
2022-12-21 07:00:00,2022-12-21 08:00:00,78,225,115,0,411,3390,4219,24845
2022-12-21 08:00:00,2022-12-21 09:00:00,78,229,115,0,637,3103,4162,24981
2022-12-21 09:00:00,2022-12-21 10:00:00,78,244,114,0,658,2805,3899,25262
2022-12-21 10:00:00,2022-12-21 11:00:00,78,232,115,0,617,2689,3731,25457
2022-12-21 11:00:00,2022-12-21 12:00:00,78,252,121,0,415,2563,3429,25507
2022-12-21 12:00:00,2022-12-21 13:00:00,78,230,133,0,209,2350,3000,25014
2022-12-21 13:00:00,2022-12-21 14:00:00,78,376,146,38,68,2279,2985,24898
2022-12-21 14:00:00,2022-12-21 15:00:00,78,434,150,43,0,2431,3136,25429
2022-12-21 15:00:00,2022-12-21 16:00:00,78,335,138,43,0,2563,3157,25225
2022-12-21 16:00:00,2022-12-21 17:00:00,78,254,151,5,0,2602,3090,24903
2022-12-21 17:00:00,2022-12-21 18:00:00,78,311,153,0,0,2697,3239,24610
2022-12-21 18:00:00,2022-12-21 19:00:00,78,282,140,0,0,2809,3309,24035
2022-12-21 19:00:00,2022-12-21 20:00:00,78,81,138,0,0,2857,3154,22460
2022-12-21 20:00:00,2022-12-21 21:00:00,41,0,127,0,0,2771,2939,20834
2022-12-21 21:00:00,2022-12-21 22:00:00,32,0,124,0,0,2921,3077,19396
2022-12-21 22:00:00,2022-12-21 23:00:00,32,0,125,0,0,2919,3076,18159
2022-12-21 23:00:00,2022-12-22 00:00:00,31,0,125,0,0,2882,3038,17391
2022-12-22 00:00:00,2022-12-22 01:00:00,36,0,125,0,0,2902,3063,17071
2022-12-22 01:00:00,2022-12-22 02:00:00,65,0,125,0,0,2895,3085,17064
2022-12-22 02:00:00,2022-12-22 03:00:00,78,0,125,0,0,2844,3047,17372
2022-12-22 03:00:00,2022-12-22 04:00:00,78,0,125,0,0,2800,3003,18118
2022-12-22 04:00:00,2022-12-22 05:00:00,78,0,125,0,0,2872,3075,20763
2022-12-22 05:00:00,2022-12-22 06:00:00,78,51,127,0,11,2886,3153,22661
2022-12-22 06:00:00,2022-12-22 07:00:00,78,164,126,0,136,2965,3469,23614
2022-12-22 07:00:00,2022-12-22 08:00:00,78,183,126,0,542,2911,3840,24208
2022-12-22 08:00:00,2022-12-22 09:00:00,78,56,128,0,916,2814,3992,24299
2022-12-22 09:00:00,2022-12-22 10:00:00,78,29,128,0,1169,2676,4080,24612
2022-12-22 10:00:00,2022-12-22 11:00:00,78,73,128,0,1089,2421,3789,24430
2022-12-22 11:00:00,2022-12-22 12:00:00,78,153,132,0,721,2569,3653,24496
2022-12-22 12:00:00,2022-12-22 13:00:00,78,82,144,0,351,2884,3539,24242
2022-12-22 13:00:00,2022-12-22 14:00:00,78,18,156,38,102,3107,3499,24251
2022-12-22 14:00:00,2022-12-22 15:00:00,78,242,157,43,0,3305,3825,24754
2022-12-22 15:00:00,2022-12-22 16:00:00,78,219,173,43,0,3382,3895,24663
2022-12-22 16:00:00,2022-12-22 17:00:00,79,342,175,5,0,3676,4277,24378
2022-12-22 17:00:00,2022-12-22 18:00:00,99,338,175,0,0,3813,4425,24094
2022-12-22 18:00:00,2022-12-22 19:00:00,152,338,167,0,0,3820,4477,23334
2022-12-22 19:00:00,2022-12-22 20:00:00,188,310,159,0,0,3685,4342,21808
2022-12-22 20:00:00,2022-12-22 21:00:00,227,309,155,0,0,3551,4242,20271
2022-12-22 21:00:00,2022-12-22 22:00:00,238,65,152,0,0,3523,3978,18820
2022-12-22 22:00:00,2022-12-22 23:00:00,269,0,134,0,0,3307,3710,17482
2022-12-22 23:00:00,2022-12-23 00:00:00,269,0,133,0,0,3148,3550,16738
2022-12-23 00:00:00,2022-12-23 01:00:00,269,0,133,0,0,2754,3156,16350
2022-12-23 01:00:00,2022-12-23 02:00:00,270,0,133,0,0,2645,3048,16228
2022-12-23 02:00:00,2022-12-23 03:00:00,269,0,133,0,0,2493,2895,16390
2022-12-23 03:00:00,2022-12-23 04:00:00,268,0,133,0,0,2355,2756,16988
2022-12-23 04:00:00,2022-12-23 05:00:00,270,0,133,0,0,2432,2835,19075
2022-12-23 05:00:00,2022-12-23 06:00:00,280,0,134,0,13,2523,2950,20641
2022-12-23 06:00:00,2022-12-23 07:00:00,281,0,150,0,129,2420,2980,21974
2022-12-23 07:00:00,2022-12-23 08:00:00,279,3,168,0,353,2279,3082,22884
2022-12-23 08:00:00,2022-12-23 09:00:00,278,39,185,0,706,2188,3396,23419
2022-12-23 09:00:00,2022-12-23 10:00:00,281,260,187,0,827,2212,3767,23873
2022-12-23 10:00:00,2022-12-23 11:00:00,279,287,186,0,760,2182,3694,23742
2022-12-23 11:00:00,2022-12-23 12:00:00,273,288,187,0,528,2066,3342,23656
2022-12-23 12:00:00,2022-12-23 13:00:00,267,254,198,0,265,2142,3126,23285
2022-12-23 13:00:00,2022-12-23 14:00:00,268,238,200,0,75,1941,2722,23325
2022-12-23 14:00:00,2022-12-23 15:00:00,269,413,205,38,0,1689,2614,23869
2022-12-23 15:00:00,2022-12-23 16:00:00,267,434,198,43,0,1466,2408,23820
2022-12-23 16:00:00,2022-12-23 17:00:00,264,365,202,43,0,1305,2179,23475
2022-12-23 17:00:00,2022-12-23 18:00:00,259,115,197,5,0,1176,1752,23040
2022-12-23 18:00:00,2022-12-23 19:00:00,265,0,186,0,0,947,1398,22187
2022-12-23 19:00:00,2022-12-23 20:00:00,270,0,183,0,0,714,1167,20648
2022-12-23 20:00:00,2022-12-23 21:00:00,272,0,168,0,0,677,1117,19254
2022-12-23 21:00:00,2022-12-23 22:00:00,268,0,166,0,0,701,1135,17482
2022-12-23 22:00:00,2022-12-23 23:00:00,264,0,174,0,0,711,1149,16122
2022-12-23 23:00:00,2022-12-24 00:00:00,264,0,176,0,0,758,1198,15225
2022-12-24 00:00:00,2022-12-24 01:00:00,262,0,176,0,0,931,1369,14681
2022-12-24 01:00:00,2022-12-24 02:00:00,268,0,176,0,0,1184,1628,14453
2022-12-24 02:00:00,2022-12-24 03:00:00,270,0,176,0,0,1333,1779,14413
2022-12-24 03:00:00,2022-12-24 04:00:00,276,0,176,0,0,1402,1854,14637
2022-12-24 04:00:00,2022-12-24 05:00:00,278,0,171,0,0,1446,1895,15365
2022-12-24 05:00:00,2022-12-24 06:00:00,275,0,182,0,6,1393,1856,16258
2022-12-24 06:00:00,2022-12-24 07:00:00,277,5,196,0,144,1332,1954,17573
2022-12-24 07:00:00,2022-12-24 08:00:00,277,8,205,0,518,1232,2240,18945
2022-12-24 08:00:00,2022-12-24 09:00:00,277,82,207,38,914,1046,2564,19617
2022-12-24 09:00:00,2022-12-24 10:00:00,275,191,207,43,1076,886,2678,19740
2022-12-24 10:00:00,2022-12-24 11:00:00,275,97,201,43,873,804,2293,19621
2022-12-24 11:00:00,2022-12-24 12:00:00,276,135,199,5,544,743,1902,19386
2022-12-24 12:00:00,2022-12-24 13:00:00,275,286,200,0,242,745,1748,19051
2022-12-24 13:00:00,2022-12-24 14:00:00,279,789,201,0,62,794,2125,19327
2022-12-24 14:00:00,2022-12-24 15:00:00,277,957,206,0,0,826,2266,19440
2022-12-24 15:00:00,2022-12-24 16:00:00,277,821,208,0,0,829,2135,17961
2022-12-24 16:00:00,2022-12-24 17:00:00,277,606,193,0,0,863,1939,17012
2022-12-24 17:00:00,2022-12-24 18:00:00,277,313,191,0,0,855,1636,16504
2022-12-24 18:00:00,2022-12-24 19:00:00,276,0,187,0,0,778,1241,16317
2022-12-24 19:00:00,2022-12-24 20:00:00,276,0,184,0,0,746,1206,16085
2022-12-24 20:00:00,2022-12-24 21:00:00,276,0,177,0,0,721,1174,15830
2022-12-24 21:00:00,2022-12-24 22:00:00,272,16,176,0,0,773,1237,15097
2022-12-24 22:00:00,2022-12-24 23:00:00,257,45,184,0,0,900,1386,14135
2022-12-24 23:00:00,2022-12-25 00:00:00,261,5,185,0,0,969,1420,13444
2022-12-25 00:00:00,2022-12-25 01:00:00,260,0,185,0,0,957,1402,12959
2022-12-25 01:00:00,2022-12-25 02:00:00,260,0,185,0,0,829,1274,12684
2022-12-25 02:00:00,2022-12-25 03:00:00,263,0,185,0,0,732,1180,12730
2022-12-25 03:00:00,2022-12-25 04:00:00,267,0,185,0,0,609,1061,12906
2022-12-25 04:00:00,2022-12-25 05:00:00,269,0,186,0,0,566,1021,13242
2022-12-25 05:00:00,2022-12-25 06:00:00,271,0,189,0,5,534,999,13521
2022-12-25 06:00:00,2022-12-25 07:00:00,270,0,201,0,133,406,1010,14051
2022-12-25 07:00:00,2022-12-25 08:00:00,271,0,211,0,574,383,1439,15007
2022-12-25 08:00:00,2022-12-25 09:00:00,266,53,210,0,1126,343,1998,15562
2022-12-25 09:00:00,2022-12-25 10:00:00,269,156,205,38,1472,357,2497,15693
2022-12-25 10:00:00,2022-12-25 11:00:00,268,238,206,43,1467,377,2599,15747
2022-12-25 11:00:00,2022-12-25 12:00:00,271,333,210,43,1112,421,2390,15860
2022-12-25 12:00:00,2022-12-25 13:00:00,269,340,210,43,550,533,1945,15583
2022-12-25 13:00:00,2022-12-25 14:00:00,269,340,212,43,114,711,1689,15603
2022-12-25 14:00:00,2022-12-25 15:00:00,269,340,213,43,0,1139,2004,16256
2022-12-25 15:00:00,2022-12-25 16:00:00,269,364,220,43,0,1567,2463,16266
2022-12-25 16:00:00,2022-12-25 17:00:00,270,344,202,43,0,2090,2949,16232
2022-12-25 17:00:00,2022-12-25 18:00:00,270,227,200,5,0,2686,3388,16198
2022-12-25 18:00:00,2022-12-25 19:00:00,270,251,187,0,0,3135,3843,16027
2022-12-25 19:00:00,2022-12-25 20:00:00,269,121,187,0,0,3747,4324,15628
2022-12-25 20:00:00,2022-12-25 21:00:00,269,6,183,0,0,3885,4343,15063
2022-12-25 21:00:00,2022-12-25 22:00:00,271,0,176,0,0,4086,4533,14176
2022-12-25 22:00:00,2022-12-25 23:00:00,262,0,175,0,0,3840,4277,13218
2022-12-25 23:00:00,2022-12-26 00:00:00,259,27,175,0,0,3886,4347,12583
2022-12-26 00:00:00,2022-12-26 01:00:00,259,11,175,0,0,3932,4377,12200
2022-12-26 01:00:00,2022-12-26 02:00:00,259,0,175,0,0,3576,4010,11824
2022-12-26 02:00:00,2022-12-26 03:00:00,265,0,175,0,0,4052,4492,11924
2022-12-26 03:00:00,2022-12-26 04:00:00,269,0,174,0,0,3692,4135,12073
2022-12-26 04:00:00,2022-12-26 05:00:00,270,0,173,0,0,3618,4061,12453
2022-12-26 05:00:00,2022-12-26 06:00:00,270,46,173,0,4,3756,4249,12759
2022-12-26 06:00:00,2022-12-26 07:00:00,270,9,176,0,152,3840,4447,13364
2022-12-26 07:00:00,2022-12-26 08:00:00,269,0,176,0,446,3807,4698,14327
2022-12-26 08:00:00,2022-12-26 09:00:00,269,0,196,0,844,5035,6344,15429
2022-12-26 09:00:00,2022-12-26 10:00:00,270,0,201,0,1015,5695,7181,15955
2022-12-26 10:00:00,2022-12-26 11:00:00,270,0,201,38,1055,5884,7448,16094
2022-12-26 11:00:00,2022-12-26 12:00:00,269,0,201,43,759,5604,6876,16119
2022-12-26 12:00:00,2022-12-26 13:00:00,269,13,209,43,350,5187,6071,15942
2022-12-26 13:00:00,2022-12-26 14:00:00,269,181,214,43,90,5064,5861,15920
2022-12-26 14:00:00,2022-12-26 15:00:00,269,752,214,43,0,4880,6158,16361
2022-12-26 15:00:00,2022-12-26 16:00:00,269,936,223,43,0,4768,6239,16451
2022-12-26 16:00:00,2022-12-26 17:00:00,270,1114,214,43,0,5152,6793,16694
2022-12-26 17:00:00,2022-12-26 18:00:00,270,870,207,43,0,5542,6932,16619
2022-12-26 18:00:00,2022-12-26 19:00:00,269,450,203,5,0,5800,6727,16414
2022-12-26 19:00:00,2022-12-26 20:00:00,270,53,193,0,0,5902,6418,15876
2022-12-26 20:00:00,2022-12-26 21:00:00,269,0,182,0,0,5360,5811,15090
2022-12-26 21:00:00,2022-12-26 22:00:00,268,0,176,0,0,4639,5083,13933
2022-12-26 22:00:00,2022-12-26 23:00:00,266,0,174,0,0,4451,4891,13097
2022-12-26 23:00:00,2022-12-27 00:00:00,267,0,173,0,0,4290,4730,12612
2022-12-27 00:00:00,2022-12-27 01:00:00,266,0,173,0,0,4256,4695,12319
2022-12-27 01:00:00,2022-12-27 02:00:00,263,0,173,0,0,4274,4710,12307
2022-12-27 02:00:00,2022-12-27 03:00:00,267,0,173,0,0,4370,4810,12704
2022-12-27 03:00:00,2022-12-27 04:00:00,269,0,174,0,0,5387,5830,13921
2022-12-27 04:00:00,2022-12-27 05:00:00,270,2,177,0,0,5734,6183,16157
2022-12-27 05:00:00,2022-12-27 06:00:00,271,10,177,0,10,5956,6424,17891
2022-12-27 06:00:00,2022-12-27 07:00:00,269,78,183,0,227,6278,7035,19218
2022-12-27 07:00:00,2022-12-27 08:00:00,269,96,202,0,820,6421,7808,20131
2022-12-27 08:00:00,2022-12-27 09:00:00,273,25,207,0,1338,6543,8386,20561
2022-12-27 09:00:00,2022-12-27 10:00:00,271,0,209,38,1537,6683,8738,20913
2022-12-27 10:00:00,2022-12-27 11:00:00,269,4,209,43,1465,6660,8650,21024
2022-12-27 11:00:00,2022-12-27 12:00:00,269,401,216,43,934,6568,8431,21504
2022-12-27 12:00:00,2022-12-27 13:00:00,266,504,219,43,384,6239,7655,21107
2022-12-27 13:00:00,2022-12-27 14:00:00,272,506,228,43,93,5969,7111,21011
2022-12-27 14:00:00,2022-12-27 15:00:00,273,626,235,43,0,5654,6831,21592
2022-12-27 15:00:00,2022-12-27 16:00:00,269,655,238,43,0,5555,6760,21457
2022-12-27 16:00:00,2022-12-27 17:00:00,268,541,248,43,0,5158,6258,21041
2022-12-27 17:00:00,2022-12-27 18:00:00,269,571,248,43,0,5203,6334,20946
2022-12-27 18:00:00,2022-12-27 19:00:00,270,350,247,43,0,5075,5985,20378
2022-12-27 19:00:00,2022-12-27 20:00:00,270,176,205,5,0,4787,5443,19219
2022-12-27 20:00:00,2022-12-27 21:00:00,270,257,194,0,0,4591,5312,17942
2022-12-27 21:00:00,2022-12-27 22:00:00,269,117,192,0,0,4451,5029,16712
2022-12-27 22:00:00,2022-12-27 23:00:00,267,0,190,0,0,4367,4824,15692
2022-12-27 23:00:00,2022-12-28 00:00:00,269,0,190,0,0,4188,4647,15049
2022-12-28 00:00:00,2022-12-28 01:00:00,268,0,189,0,0,4049,4506,14819
2022-12-28 01:00:00,2022-12-28 02:00:00,268,0,191,0,0,4239,4698,14799
2022-12-28 02:00:00,2022-12-28 03:00:00,269,0,195,0,0,4261,4725,15161
2022-12-28 03:00:00,2022-12-28 04:00:00,267,0,197,0,0,4302,4766,16074
2022-12-28 04:00:00,2022-12-28 05:00:00,269,14,201,0,0,4555,5039,18061
2022-12-28 05:00:00,2022-12-28 06:00:00,270,183,207,38,20,4862,5580,19597
2022-12-28 06:00:00,2022-12-28 07:00:00,266,468,210,43,320,5175,6482,20436
2022-12-28 07:00:00,2022-12-28 08:00:00,267,446,210,43,920,5370,7256,21018
2022-12-28 08:00:00,2022-12-28 09:00:00,274,237,215,5,1421,5403,7555,21319
2022-12-28 09:00:00,2022-12-28 10:00:00,270,340,214,0,1458,5433,7715,21481
2022-12-28 10:00:00,2022-12-28 11:00:00,269,430,239,0,1382,5594,7914,21703
2022-12-28 11:00:00,2022-12-28 12:00:00,269,212,241,38,868,5701,7329,21817
2022-12-28 12:00:00,2022-12-28 13:00:00,269,0,249,43,514,5650,6725,21388
2022-12-28 13:00:00,2022-12-28 14:00:00,272,13,249,43,119,5625,6321,21349
2022-12-28 14:00:00,2022-12-28 15:00:00,270,685,267,43,0,5739,7004,21868
2022-12-28 15:00:00,2022-12-28 16:00:00,275,930,270,43,0,5793,7311,21612
2022-12-28 16:00:00,2022-12-28 17:00:00,270,1045,273,43,0,5771,7402,21411
2022-12-28 17:00:00,2022-12-28 18:00:00,270,892,274,43,0,5772,7251,21039
2022-12-28 18:00:00,2022-12-28 19:00:00,270,778,267,5,0,5559,6879,20472
2022-12-28 19:00:00,2022-12-28 20:00:00,269,260,251,0,0,5570,6350,19286
2022-12-28 20:00:00,2022-12-28 21:00:00,270,28,241,0,0,5337,5876,18006
2022-12-28 21:00:00,2022-12-28 22:00:00,267,0,235,0,0,5238,5740,16746
2022-12-28 22:00:00,2022-12-28 23:00:00,266,0,245,0,0,4780,5291,15524
2022-12-28 23:00:00,2022-12-29 00:00:00,265,0,246,0,0,4740,5251,14977
2022-12-29 00:00:00,2022-12-29 01:00:00,268,0,246,0,0,4962,5476,14683
2022-12-29 01:00:00,2022-12-29 02:00:00,267,0,246,0,0,5256,5769,14692
2022-12-29 02:00:00,2022-12-29 03:00:00,267,0,246,0,0,5340,5853,14983
2022-12-29 03:00:00,2022-12-29 04:00:00,270,0,246,0,0,5746,6262,15695
2022-12-29 04:00:00,2022-12-29 05:00:00,271,0,246,0,0,5979,6496,17608
2022-12-29 05:00:00,2022-12-29 06:00:00,269,201,248,0,20,5812,6550,18992
2022-12-29 06:00:00,2022-12-29 07:00:00,270,465,247,38,176,5805,7001,19780
2022-12-29 07:00:00,2022-12-29 08:00:00,255,478,247,43,588,5888,7499,20414
2022-12-29 08:00:00,2022-12-29 09:00:00,253,157,247,43,1164,5809,7673,20465
2022-12-29 09:00:00,2022-12-29 10:00:00,254,216,247,5,1856,5847,8425,20836
2022-12-29 10:00:00,2022-12-29 11:00:00,253,92,247,0,1929,5813,8334,20884
2022-12-29 11:00:00,2022-12-29 12:00:00,252,122,247,38,1382,5631,7672,21075
2022-12-29 12:00:00,2022-12-29 13:00:00,252,19,246,43,671,5506,6737,20716
2022-12-29 13:00:00,2022-12-29 14:00:00,252,150,246,43,176,5483,6350,20775
2022-12-29 14:00:00,2022-12-29 15:00:00,252,591,249,43,0,5642,6777,21433
2022-12-29 15:00:00,2022-12-29 16:00:00,252,663,256,43,0,5851,7065,21211
2022-12-29 16:00:00,2022-12-29 17:00:00,252,857,273,43,0,5845,7270,20879
2022-12-29 17:00:00,2022-12-29 18:00:00,252,897,274,43,0,6219,7685,20604
2022-12-29 18:00:00,2022-12-29 19:00:00,252,1081,272,5,0,6080,7690,20226
2022-12-29 19:00:00,2022-12-29 20:00:00,252,637,265,0,0,5850,7004,19034
2022-12-29 20:00:00,2022-12-29 21:00:00,253,153,250,0,0,5459,6115,17814
2022-12-29 21:00:00,2022-12-29 22:00:00,251,0,248,0,0,5303,5802,16509
2022-12-29 22:00:00,2022-12-29 23:00:00,252,0,236,0,0,5192,5680,15526
2022-12-29 23:00:00,2022-12-30 00:00:00,251,0,232,0,0,5088,5571,14933
2022-12-30 00:00:00,2022-12-30 01:00:00,250,0,232,0,0,5180,5662,14543
2022-12-30 01:00:00,2022-12-30 02:00:00,252,0,232,0,0,5259,5743,14445
2022-12-30 02:00:00,2022-12-30 03:00:00,251,0,231,0,0,5443,5925,14768
2022-12-30 03:00:00,2022-12-30 04:00:00,251,0,231,0,0,5288,5770,15418
2022-12-30 04:00:00,2022-12-30 05:00:00,251,0,225,0,0,5419,5895,17217
2022-12-30 05:00:00,2022-12-30 06:00:00,252,24,223,0,16,5560,6075,18617
2022-12-30 06:00:00,2022-12-30 07:00:00,252,398,239,38,202,5495,6624,19407
2022-12-30 07:00:00,2022-12-30 08:00:00,251,469,246,43,1015,5346,7370,20159
2022-12-30 08:00:00,2022-12-30 09:00:00,252,196,255,43,2191,5021,7958,20279
2022-12-30 09:00:00,2022-12-30 10:00:00,253,8,261,43,2900,4569,8034,20300
2022-12-30 10:00:00,2022-12-30 11:00:00,252,0,256,43,3087,4034,7672,20208
2022-12-30 11:00:00,2022-12-30 12:00:00,252,121,254,43,2322,3249,6241,20287
2022-12-30 12:00:00,2022-12-30 13:00:00,252,640,266,43,1112,2588,4901,20114
2022-12-30 13:00:00,2022-12-30 14:00:00,252,986,268,43,191,2659,4399,20364
2022-12-30 14:00:00,2022-12-30 15:00:00,253,1528,278,43,0,3533,5635,21220
2022-12-30 15:00:00,2022-12-30 16:00:00,253,1123,275,43,0,4698,6392,21086
2022-12-30 16:00:00,2022-12-30 17:00:00,252,809,281,43,0,5540,6925,20831
2022-12-30 17:00:00,2022-12-30 18:00:00,251,520,281,43,0,5940,7035,20550
2022-12-30 18:00:00,2022-12-30 19:00:00,252,97,249,5,0,6262,6865,20129
2022-12-30 19:00:00,2022-12-30 20:00:00,252,46,227,0,0,6522,7047,18937
2022-12-30 20:00:00,2022-12-30 21:00:00,252,75,224,0,0,6676,7227,17703
2022-12-30 21:00:00,2022-12-30 22:00:00,253,73,224,0,0,6816,7366,16437
2022-12-30 22:00:00,2022-12-30 23:00:00,252,3,215,0,0,6327,6797,15093
2022-12-30 23:00:00,2022-12-31 00:00:00,252,0,215,0,0,6084,6551,14238
2022-12-31 00:00:00,2022-12-31 01:00:00,252,0,214,0,0,6697,7163,13940
2022-12-31 01:00:00,2022-12-31 02:00:00,251,0,213,0,0,6717,7181,13812
2022-12-31 02:00:00,2022-12-31 03:00:00,252,0,213,0,0,6557,7022,13810
2022-12-31 03:00:00,2022-12-31 04:00:00,252,0,213,0,0,6204,6669,13906
2022-12-31 04:00:00,2022-12-31 05:00:00,253,0,213,0,0,6207,6673,14583
2022-12-31 05:00:00,2022-12-31 06:00:00,253,7,211,0,6,6150,6627,15079
2022-12-31 06:00:00,2022-12-31 07:00:00,252,214,220,0,209,6060,6955,15911
2022-12-31 07:00:00,2022-12-31 08:00:00,250,778,226,0,722,5705,7681,17078
2022-12-31 08:00:00,2022-12-31 09:00:00,252,967,231,50,1096,5397,7993,17667
2022-12-31 09:00:00,2022-12-31 10:00:00,254,464,245,57,1454,5548,8022,17887
2022-12-31 10:00:00,2022-12-31 11:00:00,252,247,247,7,1549,5880,8182,18015
2022-12-31 11:00:00,2022-12-31 12:00:00,252,158,247,0,1067,6154,7878,18091
2022-12-31 12:00:00,2022-12-31 13:00:00,251,167,252,0,467,6403,7540,18026
2022-12-31 13:00:00,2022-12-31 14:00:00,252,298,253,0,137,6712,7652,18172
2022-12-31 14:00:00,2022-12-31 15:00:00,252,653,259,50,0,6985,8199,18805
2022-12-31 15:00:00,2022-12-31 16:00:00,252,474,260,57,0,7035,8078,18612
2022-12-31 16:00:00,2022-12-31 17:00:00,252,384,261,57,0,6899,7853,18131
2022-12-31 17:00:00,2022-12-31 18:00:00,251,138,261,57,0,6828,7535,17259
2022-12-31 18:00:00,2022-12-31 19:00:00,251,9,239,7,0,6834,7340,16138
2022-12-31 19:00:00,2022-12-31 20:00:00,252,0,223,0,0,6484,6959,15211
2022-12-31 20:00:00,2022-12-31 21:00:00,252,0,214,0,0,6444,6910,14641
2022-12-31 21:00:00,2022-12-31 22:00:00,251,0,210,0,0,6593,7054,13977
2022-12-31 22:00:00,2022-12-31 23:00:00,204,0,213,0,0,5529,5946,13272
2022-12-31 23:00:00,2023-01-01 00:00:00,179,123,214,0,0,4251,4767,12509
